sender,receiver,receiver_2,event_day,rec_pub_day,rec_pub_year,rec_pub_day_2,rec_pub_year_2,lag,lag_2,jac_sim,jac_sim_2,cumu_cit_rec,cumu_cit_rec_2,rec_outd,rec_outd_2,tfe,tfe_2,sim,sim_2
4153419,4033729,4017882,1223,551,1977,467,1977,672,756,1.0,0.0,2,2.0,1,1,70,273.0,0.5806677341461182,0.036364298313856125
4210924,3990090,4028149,1643,306,1976,523,1977,1337,1120,1.0,1.0,1,2.0,1,1,1337,189.0,0.9022809863090515,0.42994195222854614
4252494,4158541,3995416,1881,1265,1979,341,1976,616,1540,0.0,0.0,1,4.0,1,1,616,623.0,0.3560694754123688,0.31896260380744934
4255240,4176215,3977610,1895,1426,1979,243,1976,469,1652,0.5,0.0,1,4.0,1,1,469,280.0,1.0,0.2976728081703186
4266697,4121584,4146082,1958,1027,1978,1181,1979,931,777,1.0,0.0,14,1.0,1,2,14,777.0,0.647222101688385,0.36525020003318787
4267602,4128849,4060850,1958,1069,1978,698,1977,889,1260,0.0,0.0,4,4.0,9,2,35,70.0,0.5183958411216736,0.35419249534606934
4276586,4037271,4189773,2007,565,1977,1510,1980,1442,497,1.0,0.0,6,1.0,1,3,217,497.0,0.5595741868019104,0.3555855453014374
4296191,4187104,4023153,2119,1496,1980,495,1977,623,1624,0.5,0.0,1,2.0,2,2,623,798.0,0.6935051679611206,0.3290185332298279
4309304,4113647,4226947,2196,985,1978,1741,1980,1211,455,0.6666666666666666,0.0,11,1.0,9,2,91,455.0,0.5530833005905151,0.3146730959415436
4309630,4103189,4201720,2196,936,1978,1587,1980,1260,609,1.0,0.0,5,1.0,7,3,84,609.0,0.6353017687797546,0.07800900191068649
4310227,4004852,4126992,2203,390,1977,1062,1978,1813,1141,0.5,0.0,16,2.0,1,3,28,448.0,0.655722975730896,0.2497398406267166
4311016,4206013,4162637,2210,1615,1980,1307,1979,595,903,0.0,0.0,1,1.0,3,1,595,903.0,0.514177143573761,0.06371903419494629
4321791,4044554,4211747,2280,607,1977,1650,1980,1673,630,1.0,0.0,4,1.0,2,2,434,630.0,0.7496412396430969,0.30108392238616943
4328610,4230791,4185973,2322,1762,1980,1489,1980,560,833,1.0,0.0,1,1.0,6,2,560,833.0,0.3006646931171417,0.13870221376419067
4333225,4209716,4041232,2350,1636,1980,586,1977,714,1764,1.0,0.0,3,4.0,8,1,49,238.0,0.41644421219825745,0.011618674732744694
4338309,4283529,4274519,2378,2049,1981,2000,1981,329,378,1.0,0.0,3,1.0,3,1,0,378.0,0.8269754648208618,0.0797499343752861
4352906,4128537,4226790,2469,1069,1978,1741,1980,1400,728,1.0,0.0,2,1.0,2,5,252,728.0,0.2632971704006195,0.08940678834915161
4354746,4122461,4042783,2483,1027,1978,593,1977,1456,1890,1.0,0.0,3,2.0,3,1,504,133.0,0.44635626673698425,0.10800725221633911
4355887,4172660,4208760,2490,1398,1979,1636,1980,1092,854,0.5,0.0,1,1.0,1,2,1092,854.0,0.5601754784584045,0.36469152569770813
4359774,4116733,4301312,2511,999,1978,2147,1981,1512,364,1.0,0.0,5,1.0,1,2,28,364.0,0.38626977801322937,0.1887122541666031
4360890,4162488,4282661,2518,1300,1979,2049,1981,1218,469,0.0,0.0,4,1.0,4,2,28,469.0,0.5605198740959167,0.22516824305057526
4361449,4066478,4013929,2525,733,1978,446,1977,1792,2079,1.0,0.0,5,4.0,1,2,434,672.0,0.43824923038482666,0.2599460482597351
4385728,4195780,3984044,2707,1552,1980,278,1976,1155,2429,1.0,0.0,2,3.0,3,1,567,1715.0,0.681115448474884,0.43123069405555725
4388945,4262691,4110316,2728,1937,1981,971,1978,791,1757,1.0,0.0,2,1.0,2,1,322,1757.0,0.6096251010894775,0.4139081537723541
4391096,4237748,4011377,2742,1804,1980,432,1977,938,2310,1.0,0.0,1,2.0,1,2,938,2009.0,0.6843382716178894,0.2929832637310028
4393055,4334058,4068252,2749,2350,1982,740,1978,399,2009,1.0,0.0,1,7.0,3,2,399,686.0,0.8985416889190674,0.04049649089574814
4397450,4314695,4056766,2777,2231,1982,670,1977,546,2107,1.0,0.0,1,3.0,1,1,546,861.0,0.5245367288589478,0.32244443893432617
4400053,4220398,4066918,2791,1706,1980,733,1978,1085,2058,0.0,0.0,2,2.0,1,1,140,903.0,0.43155503273010254,0.1276339888572693
4399780,4335697,4023151,2791,2364,1982,495,1977,427,2296,1.0,0.0,2,3.0,1,1,35,1792.0,0.5140021443367004,0.2572692334651947
4424368,4234521,4177156,2924,1783,1980,1433,1979,1141,1491,1.0,0.0,2,3.0,4,1,560,826.0,0.8649954795837402,0.13752974569797516
4427343,4065225,4190153,2945,726,1977,1517,1980,2219,1428,1.0,0.0,2,4.0,1,1,1554,28.0,0.4427839517593384,0.1841922402381897
4439496,4336345,4338010,3008,2364,1982,2378,1982,644,630,0.3333333333333333,0.0,1,2.0,15,2,644,455.0,0.34996286034584045,0.4203258454799652
4450554,4316283,4209864,3064,2238,1982,1643,1980,826,1421,1.0,0.0,1,1.0,6,2,826,1421.0,0.4335162043571472,0.1443108767271042
4450625,4188721,3963369,3071,1510,1980,166,1976,1561,2905,1.0,0.0,5,3.0,2,1,56,770.0,0.6086791157722473,0.3872525095939636
4455605,4373181,3987771,3092,2595,1983,299,1976,497,2793,1.0,0.0,1,1.0,3,1,497,2793.0,0.5148840546607971,0.23394933342933655
4470774,4060098,4362874,3176,698,1977,2532,1982,2478,644,0.5,0.0,4,2.0,1,2,7,112.0,0.7029474973678589,0.15636023879051208
4470408,4232662,4021621,3176,1776,1980,488,1977,1400,2688,1.0,0.0,4,2.0,1,3,140,1918.0,0.5599583387374878,0.16848160326480865
4482543,4235771,4038954,3239,1790,1980,579,1977,1449,2660,0.5,0.0,7,1.0,2,1,133,2660.0,0.39433571696281433,0.21509584784507751
4483925,4351800,4331914,3246,2462,1982,2336,1982,784,910,1.0,0.0,1,2.0,1,7,784,70.0,0.4729747176170349,0.1677486151456833
4506904,4223741,4165011,3372,1727,1980,1328,1979,1645,2044,0.0,0.0,2,6.0,3,1,980,189.0,0.4999045729637146,0.10702770948410034
4508797,4326016,4181551,3379,2301,1982,1461,1980,1078,1918,1.0,0.0,4,2.0,2,1,14,203.0,0.46798011660575867,0.2308725118637085
4508052,4370049,4126780,3379,2581,1983,1055,1978,798,2324,1.0,0.0,3,2.0,5,2,84,63.0,0.750065267086029,0.3828946053981781
4510369,4087921,4169439,3386,859,1978,1370,1979,2527,2016,0.0,0.0,3,5.0,1,2,0,91.0,0.31443122029304504,0.19082584977149963
4518733,4324710,4021621,3428,2294,1982,488,1977,1134,2940,0.5,0.0,5,2.0,2,3,140,2170.0,0.39400380849838257,0.09398476034402847
4522671,4117588,4055818,3449,1006,1978,663,1977,2443,2786,0.25,0.0,3,6.0,1,1,1043,483.0,0.3927852511405945,0.15476298332214355
4526928,4404323,4441004,3470,2812,1983,3015,1984,658,455,1.0,0.0,2,1.0,1,2,35,455.0,0.5920040011405945,0.18555645644664764
4525904,4094483,4189201,3470,894,1978,1510,1980,2576,1960,1.0,0.0,8,3.0,1,2,532,112.0,0.4150294363498688,0.38050633668899536
4527888,4456360,4074003,3477,3099,1984,775,1978,378,2702,1.0,0.0,2,1.0,5,1,112,2702.0,0.615493655204773,0.25546693801879883
4531467,4369722,4406210,3498,2581,1983,2826,1983,917,672,1.0,0.0,1,1.0,2,4,917,672.0,0.4686847925186157,0.18126288056373596
4557508,4491345,4279779,3631,3288,1985,2028,1981,343,1603,1.0,0.0,1,1.0,1,5,343,1603.0,0.5439545512199402,0.13862569630146027
4563417,4423153,4057734,3659,2917,1983,677,1977,742,2982,0.5,0.5,1,5.0,2,1,742,84.0,0.48101139068603516,0.22975102066993713
4569604,4428691,4115518,3694,2952,1984,992,1978,742,2702,1.0,0.0,2,9.0,3,2,392,147.0,0.39291590452194214,0.13643166422843933
4578080,4204284,4331877,3736,1608,1980,2336,1982,2128,1400,1.0,0.5,4,2.0,2,5,315,84.0,0.5259098410606384,0.24492184817790985
4583224,4403333,3996079,3757,2805,1983,341,1976,952,3416,0.0,0.0,2,4.0,1,1,483,1925.0,0.34717902541160583,0.22614406049251556
4591845,4486746,4349243,3799,3260,1984,2448,1982,539,1351,1.0,0.0,1,2.0,3,5,539,56.0,0.538500189781189,0.14277523756027222
4593319,4472744,4383281,3806,3183,1984,2686,1983,623,1120,1.0,0.0,5,1.0,1,5,21,1120.0,0.49156883358955383,0.29997989535331726
4598202,4471223,4118722,3834,3176,1984,1006,1978,658,2828,1.0,0.0,2,2.0,3,1,91,2065.0,0.3505241870880127,0.3749881982803345
4598130,4349658,4201139,3834,2448,1982,1587,1980,1386,2247,1.0,0.0,1,4.0,3,1,1386,224.0,0.5546674728393555,0.0395100861787796
4599867,4478275,4433625,3848,3218,1984,2980,1984,630,868,0.0,0.0,1,1.0,2,5,630,868.0,0.4878341853618622,0.2637624740600586
4602794,4460149,4246730,3862,3120,1984,1853,1981,742,2009,0.5,0.0,1,1.0,2,3,742,2009.0,1.0,0.31772729754447937
4603392,4293913,4212229,3862,2105,1981,1657,1980,1757,2205,0.3333333333333333,0.0,9,1.0,5,5,70,2205.0,0.6618492603302002,0.22491395473480225
4604700,4492112,4324623,3869,3295,1985,2294,1982,574,1575,0.0,0.0,3,1.0,2,2,273,1575.0,0.5677165389060974,0.1389250010251999
4609516,4482588,4311738,3897,3239,1984,2210,1982,658,1687,0.0,0.0,1,6.0,8,6,658,833.0,0.2601500451564789,0.27038896083831787
4615403,4320855,4376606,3932,2273,1982,2630,1983,1659,1302,0.3333333333333333,0.0,9,1.0,3,1,7,1302.0,0.5389746427536011,0.30921223759651184
4618593,4391880,4260091,3946,2742,1983,1923,1981,1204,2023,1.0,0.0,1,1.0,3,1,1204,2023.0,0.3703344762325287,0.125618577003479
4620083,4379964,4518406,3953,2658,1983,3428,1985,1295,525,1.0,0.0,11,1.0,4,3,63,525.0,0.6564714908599854,0.23958317935466766
4619651,4121585,4325106,3953,1027,1978,2294,1982,2926,1659,1.0,0.0,5,1.0,1,2,126,1659.0,0.40012127161026,0.21135205030441284
4621255,4268820,4036810,3960,1965,1981,565,1977,1995,3395,1.0,0.0,3,1.0,1,1,7,3395.0,0.5254202485084534,0.11462865024805069
4626455,4111349,4471363,3988,978,1978,3176,1984,3010,812,0.5,0.0,7,2.0,2,9,217,7.0,0.47426319122314453,0.1663466840982437
4632528,4019813,4272388,4016,481,1977,1986,1981,3535,2030,0.5,0.0,6,1.0,1,2,133,2030.0,0.5472361445426941,0.09734921902418137
4632848,4366275,4365528,4016,2553,1982,2553,1982,1463,1463,0.3333333333333333,0.0,1,2.0,1,3,1463,896.0,0.4020463526248932,0.14155469834804535
4635868,4097726,3975059,4030,908,1978,229,1976,3122,3801,0.5,0.0,7,3.0,1,1,1204,1169.0,0.5626391768455505,0.24566875398159027
4637012,4534027,4193461,4030,3505,1985,1538,1980,525,2492,0.5,0.0,2,7.0,5,2,0,56.0,0.4261012375354767,0.051796332001686096
4638182,4499387,4243235,4037,3330,1985,1832,1981,707,2205,1.0,0.0,5,4.0,6,4,42,7.0,0.5103715658187866,0.13205832242965698
4639093,4222638,4013929,4044,1720,1980,446,1977,2324,3598,1.0,0.0,9,7.0,1,2,14,308.0,0.33831220865249634,0.3284331262111664
4641950,4469430,4170550,4058,3169,1984,1377,1979,889,2681,1.0,0.0,1,3.0,4,4,889,140.0,0.535073459148407,0.1096029132604599
4646171,4463387,4055797,4072,3134,1984,663,1977,938,3409,1.0,0.0,6,2.0,1,1,21,756.0,0.5066176056861877,0.2998783588409424
4647223,4251813,4569328,4079,1874,1981,3694,1986,2205,385,0.0,0.0,2,1.0,1,1,1323,385.0,0.26229044795036316,0.1696154922246933
4655575,4429980,4463288,4114,2959,1984,3134,1984,1155,980,1.0,0.0,3,1.0,9,1,616,980.0,0.5465087294578552,0.17119400203227997
4656825,4117656,4052677,4121,1006,1978,642,1977,3115,3479,0.5,0.0,3,2.0,2,1,378,987.0,0.4448326826095581,0.11034610122442245
4661899,4591989,4469079,4135,3799,1986,3169,1984,336,966,0.5,0.0,1,1.0,6,1,336,966.0,0.48382019996643066,0.23415571451187134
4664114,4340046,4219326,4149,2392,1982,1699,1980,1757,2450,1.0,0.0,7,1.0,2,1,126,2450.0,0.36491280794143677,0.30214211344718933
4664652,4372921,4595449,4149,2595,1983,3820,1986,1554,329,0.5,0.0,3,1.0,3,2,231,329.0,0.24749097228050232,0.2972581088542938
4669116,4464746,4315343,4163,3141,1984,2238,1982,1022,1925,1.0,0.0,4,1.0,3,2,203,1925.0,0.47628533840179443,0.17987796664237976
4668559,4421812,4244785,4163,2910,1983,1839,1981,1253,2324,1.0,0.0,1,1.0,1,3,1253,2324.0,0.26710426807403564,0.14291997253894806
4677514,4106173,4435983,4198,957,1978,2994,1984,3241,1204,1.0,0.0,1,2.0,2,2,3241,924.0,0.7027634978294373,0.18953433632850647
4678814,4622362,4381810,4205,3967,1986,2679,1983,238,1526,1.0,0.0,1,4.0,2,2,238,336.0,1.0000001192092896,0.03788250312209129
4681142,4341241,4396387,4219,2399,1982,2770,1983,1820,1449,1.0,0.0,5,2.0,7,2,154,574.0,0.3364075720310211,0.11562127619981766
4684607,4414306,4165536,4233,2868,1983,1328,1979,1365,2905,1.0,0.0,6,2.0,5,3,84,1960.0,0.49320489168167114,0.3489151895046234
4687775,4255431,4287847,4247,1895,1981,2077,1981,2352,2170,1.0,0.0,10,1.0,3,1,217,2170.0,0.39072269201278687,0.16758763790130615
4691245,4188638,4156845,4261,1503,1980,1244,1979,2758,3017,1.0,0.0,6,5.0,1,1,644,826.0,0.6281641721725464,0.27719780802726746
4699143,4431000,4007155,4303,2966,1984,404,1977,1337,3899,1.0,0.0,7,3.0,5,1,42,455.0,0.39608606696128845,0.138568714261055
4708460,4095886,4137221,4345,901,1978,1125,1979,3444,3220,1.0,0.0,9,4.0,1,1,525,2086.0,0.3460361957550049,0.19549235701560974
4710307,4104178,4463288,4352,943,1978,3134,1984,3409,1218,1.0,0.0,2,2.0,3,1,2282,175.0,0.3593272268772125,0.059740014374256134
4710388,4344971,4156905,4352,2420,1982,1244,1979,1932,3108,1.0,0.0,3,10.0,3,1,182,119.0,0.41314050555229187,0.120113804936409
4710181,4451256,4358099,4352,3071,1984,2504,1982,1281,1848,1.0,0.0,7,1.0,3,2,49,1848.0,0.6730502247810364,0.15822556614875793
4712903,4349255,4160625,4366,2448,1982,1286,1979,1918,3080,1.0,0.0,3,4.0,1,2,889,84.0,0.5395612716674805,0.07024086266756058
4714400,4422027,4404869,4373,2910,1983,2819,1983,1463,1554,0.0,0.0,5,4.0,5,6,105,14.0,0.45444729924201965,0.37701308727264404
4723068,4542283,4579588,4415,3547,1985,3743,1986,868,672,1.0,0.0,1,1.0,2,7,868,672.0,0.39536869525909424,0.19902077317237854
4722651,4298301,4094107,4415,2133,1981,894,1978,2282,3521,0.0,0.0,5,1.0,2,1,168,3521.0,0.5090059638023376,0.37306201457977295
4723221,4563094,4623013,4415,3659,1986,3974,1986,756,441,1.0,0.0,3,1.0,4,3,273,441.0,0.43542736768722534,0.26001954078674316
4724988,4149687,4438238,4429,1202,1979,3001,1984,3227,1428,1.0,0.0,8,10.0,2,3,1134,98.0,0.5839864611625671,0.11513310670852661
4729258,4233858,4316065,4450,1783,1980,2238,1982,2667,2212,0.5,0.0,6,3.0,1,1,665,126.0,0.3395901024341583,0.3630222976207733
4729139,4323358,4086917,4450,2287,1982,852,1978,2163,3598,0.3333333333333333,0.3333333333333333,6,1.0,2,1,364,3598.0,0.36104995012283325,0.2052987813949585
4729349,4559018,4130361,4450,3638,1985,1083,1978,812,3367,0.0,0.0,1,6.0,10,1,812,448.0,0.31616470217704773,0.18646898865699768
4731839,4443660,4291693,4457,3029,1984,2098,1981,1428,2359,1.0,0.0,6,3.0,9,3,357,1001.0,0.46684157848358154,0.27348393201828003
4734089,4425112,4152417,4471,2931,1984,1216,1979,1540,3255,1.0,0.0,2,1.0,1,3,931,3255.0,0.5186658501625061,0.06720776855945587
4735760,4407649,4297174,4478,2833,1983,2126,1981,1645,2352,1.0,0.0,1,2.0,1,4,1645,1092.0,0.7527722716331482,0.1141028180718422
4743295,4544401,4062007,4513,3561,1985,705,1977,952,3808,1.0,0.0,4,6.0,1,1,49,336.0,0.5080214142799377,0.03210083022713661
4745332,4649314,4468938,4520,4086,1987,3169,1984,434,1351,1.0,0.0,1,3.0,4,4,434,203.0,0.36472034454345703,0.13849827647209167
4748622,4320503,4523857,4534,2266,1982,3456,1985,2268,1078,1.0,0.0,4,2.0,1,4,693,105.0,0.5057299733161926,0.34729740023612976
4750308,4655014,4050868,4548,4114,1987,635,1977,434,3913,1.0,0.0,2,2.0,1,1,91,1526.0,0.6337409019470215,0.3698351979255676
4750598,4594669,4566002,4548,3813,1986,3673,1986,735,875,0.0,0.0,1,2.0,8,16,735,392.0,0.4645417630672455,0.4129381775856018
4752443,4288327,4166282,4555,2077,1981,1335,1979,2478,3220,0.5,0.0,9,3.0,2,2,56,910.0,0.4043439030647278,0.028827831149101257
4751993,4468207,4431197,4555,3162,1984,2966,1984,1393,1589,1.0,1.0,7,3.0,3,1,56,189.0,0.5722554326057434,0.30592069029808044
4754206,4185234,4219832,4562,1482,1980,1699,1980,3080,2863,1.0,1.0,5,2.0,4,2,350,343.0,0.6467034220695496,0.24362383782863617
4755068,4484170,4251632,4569,3246,1984,1874,1981,1323,2695,0.0,0.0,3,4.0,6,1,224,518.0,0.4567439556121826,0.21348711848258972
4756133,4205497,4021385,4576,1615,1980,488,1977,2961,4088,0.0,0.0,6,10.0,2,1,280,1001.0,0.550889253616333,0.08544710278511047
4756285,4210105,4153890,4576,1643,1980,1223,1979,2933,3353,1.0,0.0,4,4.0,4,1,287,840.0,0.670927107334137,0.2512246370315552
4767518,4490444,4393585,4625,3281,1984,2756,1983,1344,1869,0.0,0.0,14,1.0,1,1,77,1869.0,0.35383141040802,0.2564738690853119
4767654,4545781,4083715,4625,3568,1985,831,1978,1057,3794,0.0,0.0,2,4.0,4,5,189,1729.0,0.5662910342216492,0.22404953837394714
4768973,4511197,4007788,4632,3393,1985,411,1977,1239,4221,1.0,0.0,3,3.0,4,1,0,70.0,0.37286826968193054,0.12280900031328201
4773423,4562842,4159189,4653,3659,1986,1272,1979,994,3381,1.0,0.0,1,2.0,5,1,994,1897.0,0.7512954473495483,0.18543300032615662
4782447,4608656,4224510,4688,3890,1986,1727,1980,798,2961,0.5,0.0,6,1.0,10,1,84,2961.0,0.585504412651062,0.2719101011753082
4789495,4588514,4318980,4723,3785,1986,2259,1982,938,2464,1.0,0.0,4,12.0,1,2,63,91.0,0.39053604006767273,0.27023306488990784
4792226,4569080,4516864,4737,3687,1986,3421,1985,1050,1316,1.0,0.0,2,1.0,2,9,35,1316.0,0.6766906380653381,0.2372468113899231
4792989,4365348,4258803,4737,2546,1982,1916,1981,2191,2821,1.0,0.0,1,4.0,1,1,2191,672.0,0.5367277264595032,0.04822346568107605
4793812,4703186,4043802,4744,4317,1987,600,1977,427,4144,0.0,0.0,1,6.0,4,1,427,273.0,0.474848210811615,0.2765814960002899
4794862,4538687,4624981,4751,3533,1985,3981,1986,1218,770,1.0,0.0,4,2.0,2,1,91,266.0,0.4096348285675049,0.0512586273252964
4795387,4449473,4455922,4751,3064,1984,3099,1984,1687,1652,0.0,0.0,1,1.0,3,1,1687,1652.0,0.36425119638442993,0.2759833335876465
4798063,4324111,4342710,4765,2294,1982,2406,1982,2471,2359,1.0,0.0,10,5.0,1,2,70,861.0,0.4406066834926605,0.4847339987754822
4803659,4275316,3985481,4786,2000,1981,285,1976,2786,4501,0.0,0.0,4,4.0,3,1,84,2513.0,0.5518701076507568,0.11441896110773087
4803102,4572852,4654853,4786,3708,1986,4107,1987,1078,679,0.3333333333333333,0.0,4,1.0,7,1,112,679.0,0.31524214148521423,0.07821141183376312
4804011,4325403,4136612,4793,2301,1982,1125,1979,2492,3668,1.0,0.0,15,2.0,3,2,35,1827.0,0.603676438331604,0.3239450752735138
4807427,4255918,4215640,4807,1902,1981,1678,1980,2905,3129,1.0,0.0,4,5.0,3,1,238,119.0,0.5008935332298279,0.23059703409671783
4811857,4210251,4443807,4821,1643,1980,3029,1984,3178,1792,1.0,0.0,4,3.0,2,3,476,1358.0,0.47226500511169434,0.2717253863811493
4812283,4418031,4081007,4821,2889,1983,817,1978,1932,4004,0.0,0.0,8,4.0,1,2,203,140.0,0.43522363901138306,0.26645734906196594
4820802,4474978,4397690,4849,3197,1984,2777,1983,1652,2072,0.0,0.0,16,2.0,3,5,7,616.0,0.4375039339065552,0.08647336810827255
4820125,4401394,4527238,4849,2798,1983,3470,1985,2051,1379,1.0,0.0,10,6.0,2,9,84,105.0,0.7553296089172363,0.24415458738803864
4821798,4662437,3987926,4856,4142,1987,299,1976,714,4557,1.0,0.0,1,3.0,5,1,714,189.0,0.5546575784683228,0.23509302735328674
4821394,4238876,4006457,4856,1811,1980,397,1977,3045,4459,0.0,0.0,13,3.0,3,1,406,728.0,0.5419422388076782,0.11613060534000397
4825380,4493608,3987216,4863,3302,1985,292,1976,1561,4571,1.0,0.0,1,4.0,8,1,1561,1932.0,0.4393209218978882,0.25485673546791077
4827918,4658809,4404753,4877,4128,1987,2819,1983,749,2058,1.0,0.0,1,6.0,3,1,749,847.0,0.6463766098022461,0.317731112241745
4827631,4589216,4549452,4877,3792,1986,3589,1985,1085,1288,1.0,0.0,1,1.0,4,5,1085,1288.0,0.39807191491127014,0.2108989655971527
4830800,4264548,4406809,4884,1944,1981,2826,1983,2940,2058,1.0,0.0,11,1.0,5,6,371,2058.0,0.6985158324241638,0.2147122174501419
4833134,4521413,4192410,4891,3442,1985,1531,1980,1449,3360,1.0,0.0,1,10.0,5,1,1449,1050.0,0.7843979597091675,0.15246368944644928
4834913,4300840,4072812,4898,2147,1981,768,1978,2751,4130,0.0,0.0,4,3.0,4,1,147,2954.0,0.40376919507980347,0.19158628582954407
4834643,4361531,4008228,4898,2525,1982,411,1977,2373,4487,1.0,0.0,2,1.0,3,1,1176,4487.0,0.5410387516021729,0.08675332367420197
4834023,4529679,4540139,4898,3484,1985,3540,1985,1414,1358,0.0,0.0,3,2.0,2,3,42,616.0,0.37712615728378296,0.1256421059370041
4837634,4494151,4242704,4905,3302,1985,1825,1980,1603,3080,1.0,1.0,5,14.0,3,1,140,154.0,0.4872130751609802,0.3955143988132477
4836557,4704612,4094709,4905,4324,1987,894,1978,581,4011,0.0,0.0,1,11.0,1,2,581,791.0,0.5971336364746094,0.20731808245182037
4839632,4553134,4379362,4912,3603,1985,2658,1983,1309,2254,0.5,0.0,2,1.0,4,2,7,2254.0,0.48150742053985596,0.22539971768856049
4840882,4584267,4341345,4919,3764,1986,2399,1982,1155,2520,1.0,0.0,5,4.0,1,7,42,1162.0,0.6711211204528809,0.1847248375415802
4840112,4744004,3999204,4919,4513,1988,355,1976,406,4564,0.0,0.0,2,2.0,6,1,168,3108.0,0.44028210639953613,0.2668376564979553
4840698,4491492,4164436,4919,3288,1985,1321,1979,1631,3598,0.25,0.0,6,4.0,7,2,406,21.0,0.3863462507724762,0.3779457211494446
4850168,4496201,3979748,4954,3316,1985,250,1976,1638,4704,1.0,0.0,4,3.0,5,1,28,1498.0,0.4894082546234131,0.10214152187108994
4854210,4269103,4722197,4968,1972,1981,4415,1988,2996,553,1.0,0.0,2,1.0,3,4,2128,553.0,0.6430355310440063,0.09283635020256042
4857840,4454583,4595738,4975,3085,1984,3820,1986,1890,1155,0.3333333333333333,0.0,7,1.0,6,2,35,1155.0,0.3687207102775574,0.1087394580245018
4859978,4554730,4525965,4982,3617,1985,3470,1985,1365,1512,1.0,0.0,1,2.0,5,5,1365,791.0,0.4988035261631012,0.33311885595321655
4858948,4518171,4210102,4982,3428,1985,1643,1980,1554,3339,1.0,0.0,2,5.0,3,5,714,112.0,0.717099666595459,0.35355448722839355
4859944,4277751,4135066,4982,2014,1981,1111,1979,2968,3871,1.0,0.0,14,12.0,1,1,784,91.0,0.7418553233146667,0.17273622751235962
4860303,4150341,4723215,4982,1202,1979,4415,1988,3780,567,1.0,0.0,7,1.0,1,6,49,567.0,0.48141300678253174,0.13221478462219238
4861239,4611974,4257885,4989,3911,1986,1909,1981,1078,3080,1.0,0.0,1,18.0,5,1,1078,119.0,0.6925304532051086,0.022430039942264557
4863793,4275113,4152386,4996,2000,1981,1216,1979,2996,3780,0.0,0.0,18,4.0,2,2,63,938.0,0.7500735521316528,0.28274863958358765
4862585,4697319,4587722,4996,4296,1987,3785,1986,700,1211,0.3333333333333333,0.0,2,1.0,3,4,91,1211.0,0.39810892939567566,0.29511865973472595
4867137,4759346,4694319,5010,4590,1988,4275,1987,420,735,1.0,0.0,2,1.0,2,2,7,735.0,0.6814163327217102,0.3332609236240387
4870910,4013023,4166229,5024,446,1977,1335,1979,4578,3689,1.0,0.0,25,16.0,1,1,35,98.0,0.5517093539237976,0.19258281588554382
4872073,4180701,4129468,5024,1454,1979,1076,1978,3570,3948,0.0,0.0,5,10.0,1,3,1883,434.0,0.5159286856651306,0.1589805632829666
4877556,4801544,4179128,5052,4779,1989,1447,1979,273,3605,0.5,0.0,1,2.0,11,2,273,2338.0,0.5523319840431213,0.13424159586429596
4880697,4284674,4277907,5066,2056,1981,2021,1981,3010,3045,0.0,0.0,13,4.0,4,1,98,210.0,0.47470787167549133,0.10744214057922363
4883522,4433239,4012942,5080,2973,1984,446,1977,2107,4634,0.0,0.0,3,19.0,3,1,308,196.0,0.20802536606788635,0.04553438723087311
4883832,4501911,4643542,5080,3344,1985,4065,1987,1736,1015,0.0,0.0,2,2.0,1,2,665,280.0,0.3779278099536896,-0.006415490061044693
4891343,4507394,4239572,5115,3372,1985,1811,1980,1743,3304,1.0,0.0,5,4.0,3,1,21,203.0,0.45581483840942383,0.18695390224456787
4890641,4542852,4560996,5115,3554,1985,3645,1985,1561,1470,0.0,0.0,5,1.0,1,1,14,1470.0,0.6436077952384949,0.28231239318847656
4894342,4440853,4395918,5129,3015,1984,2770,1983,2114,2359,1.0,0.0,11,5.0,5,1,217,7.0,0.4731493592262268,0.4140850305557251
4900253,4592726,4357351,5157,3806,1986,2497,1982,1351,2660,1.0,0.0,2,2.0,5,3,672,1743.0,0.48044371604919434,0.11368286609649658
4903131,4513324,4450498,5164,3400,1985,3064,1984,1764,2100,1.0,0.0,6,2.0,5,1,714,1575.0,0.5006229281425476,-0.038660354912281036
4909852,4221606,4357085,5192,1713,1980,2497,1982,3479,2695,0.0,0.0,8,17.0,7,2,602,266.0,0.4196156859397888,0.21930931508541107
4909649,4549826,4182099,5192,3589,1985,1468,1980,1603,3724,1.0,0.0,4,7.0,8,1,91,693.0,0.42924603819847107,0.3030456006526947
4910745,4786951,4812499,5192,4709,1988,4821,1989,483,371,1.0,0.0,1,1.0,3,11,483,371.0,0.5269333720207214,0.07125680148601532
4914678,4244784,4448959,5206,1839,1981,3057,1984,3367,2149,1.0,0.0,6,2.0,2,2,77,1512.0,0.5584539175033569,0.13380490243434906
4916805,4312692,4612920,5220,2217,1982,3918,1986,3003,1302,0.0,0.0,6,2.0,1,9,637,749.0,0.5856418013572693,0.04437590017914772
4918310,4628205,4330500,5220,3995,1986,2329,1982,1225,2891,1.0,0.0,2,2.0,3,2,714,168.0,0.5318365693092346,0.20399713516235352
4927547,4810380,4643586,5255,4814,1989,4065,1987,441,1190,1.0,0.0,1,2.0,5,3,441,413.0,0.2353818118572235,0.1375994235277176
4929507,4267210,4359677,5262,1958,1981,2511,1982,3304,2751,0.0,0.0,5,3.0,1,3,147,1960.0,0.5371025204658508,-0.09139670431613922
4929706,4485227,4568012,5262,3253,1984,3687,1986,2009,1575,1.0,0.0,3,2.0,1,3,819,406.0,0.4405926465988159,0.24169467389583588
4934770,4409435,4059176,5283,2840,1983,691,1977,2443,4592,0.0,0.0,11,3.0,2,1,49,1218.0,0.5302268862724304,0.2150847166776657
4936920,4574819,4409082,5290,3722,1986,2840,1983,1568,2450,1.0,0.0,1,1.0,5,4,1568,2450.0,0.31386610865592957,0.2502823770046234
4939203,4336145,4643998,5297,2364,1982,4065,1987,2933,1232,0.0,0.0,19,4.0,3,2,35,357.0,0.5060796737670898,0.23906534910202026
4944804,4447269,4103184,5325,3050,1984,936,1978,2275,4389,1.0,0.0,9,1.0,5,1,273,4389.0,0.5984023809432983,0.19426150619983673
4945728,4524585,4660076,5332,3463,1985,4128,1987,1869,1204,1.0,0.0,2,2.0,3,2,1092,1036.0,0.6475222110748291,0.2862313985824585
4949748,4273151,4739308,5346,1993,1981,4492,1988,3353,854,0.0,0.0,3,2.0,1,2,448,133.0,0.3412622809410095,0.24497558176517487
4950629,4659682,4298312,5346,4128,1987,2133,1981,1218,3213,0.5,0.0,2,7.0,13,3,819,399.0,0.480853408575058,0.14172986149787903
4951903,4659045,4555018,5353,4128,1987,3617,1985,1225,1736,1.0,1.0,6,5.0,6,4,210,14.0,0.4861416220664978,0.4621013104915619
4953901,4869087,4065156,5360,5017,1989,726,1977,343,4634,1.0,0.0,1,3.0,2,2,343,3248.0,0.5037639737129211,0.2182544469833374
4959060,4683274,4804339,5381,4226,1987,4793,1989,1155,588,0.0,0.0,5,2.0,2,6,308,42.0,0.5946914553642273,0.23966971039772034
4958911,4506956,4482072,5381,3372,1985,3239,1984,2009,2142,0.5,0.0,8,3.0,6,1,189,567.0,0.6507318615913391,0.14621134102344513
4959791,4580134,4182262,5381,3743,1986,1468,1980,1638,3913,1.0,0.0,16,10.0,43,4,273,231.0,0.21846188604831696,0.2444712072610855
4962324,4712197,4321529,5395,4359,1987,2273,1982,1036,3122,0.0,0.0,4,7.0,3,1,231,273.0,0.11274641752243042,0.3166061341762543
4961618,4841778,4862430,5395,4926,1989,4989,1989,469,406,0.0,0.0,1,2.0,4,2,469,49.0,0.34856849908828735,0.242420956492424
4965793,4779267,4252915,5409,4674,1988,1881,1981,735,3528,1.0,0.0,2,2.0,4,2,196,1890.0,0.5558061003684998,0.06902372092008591
4968044,4311315,4052671,5423,2210,1982,642,1977,3213,4781,1.0,0.0,3,2.0,1,1,56,1785.0,0.7190583348274231,0.19339653849601746
4969439,4257377,4109249,5430,1909,1981,964,1978,3521,4466,1.0,0.0,34,1.0,3,1,280,4466.0,0.6591771245002747,0.2953026592731476
4971799,4769028,4801582,5437,4632,1988,4779,1989,805,658,1.0,1.0,2,2.0,5,2,259,49.0,0.5528286099433899,0.2720220386981964
4976412,4660813,4763101,5458,4135,1987,4604,1988,1323,854,1.0,0.0,5,1.0,5,2,98,854.0,0.43008947372436523,0.158365860581398
4980848,4617640,4008799,5472,3939,1986,418,1977,1533,5054,1.0,0.0,8,2.0,1,1,126,2520.0,0.5521115660667419,0.10093101859092712
4983376,4130715,4097890,5486,1083,1978,908,1978,4403,4578,0.5,0.0,2,9.0,1,2,1442,1351.0,0.2110862135887146,0.2125568836927414
4985518,4522997,4238661,5493,3449,1985,1804,1980,2044,3689,1.0,0.0,6,5.0,1,3,630,266.0,0.4364210367202759,0.37413689494132996
4992650,4125765,3986923,5521,1048,1978,292,1976,4473,5229,1.0,0.0,9,2.0,2,1,77,4634.0,0.5372931957244873,0.0932224914431572
4991675,4566552,4226874,5521,3680,1986,1741,1980,1841,3780,1.0,0.0,3,2.0,2,2,35,2114.0,0.7166894674301147,0.06077522039413452
4993921,4695230,4899098,5528,4282,1987,5150,1990,1246,378,1.0,0.0,1,1.0,3,4,1246,378.0,0.4437776207923889,0.22003169357776642
4997112,4726491,4883983,5542,4436,1988,5080,1989,1106,462,0.0,0.0,1,1.0,2,4,1106,462.0,0.46173718571662903,0.20363923907279968
5001480,4113997,4230778,5556,985,1978,1762,1980,4571,3794,0.3333333333333333,0.0,9,5.0,1,4,357,1645.0,0.4082639217376709,0.22207587957382202
5000771,4793897,4140017,5556,4744,1988,1146,1979,812,4410,0.5,0.0,2,2.0,3,1,91,2485.0,0.4424136281013489,0.06563600152730942
5005123,4399352,4049987,5570,2784,1983,628,1977,2786,4942,1.0,0.0,14,2.0,7,1,161,868.0,0.6102502942085266,0.33820950984954834
5006167,4507392,4699004,5577,3372,1985,4303,1987,2205,1274,0.0,0.0,3,1.0,6,3,889,1274.0,0.3672731816768646,0.14511264860630035
5008334,4657979,4004130,5584,4121,1987,383,1977,1463,5201,1.0,0.0,2,3.0,30,1,560,1561.0,0.5670506954193115,0.391571581363678
5010028,4764479,4406727,5591,4611,1988,2826,1983,980,2765,1.0,0.0,2,8.0,6,4,7,98.0,0.5016014575958252,0.1455898880958557
5009031,4414776,4749298,5591,2875,1983,4541,1988,2716,1050,1.0,0.0,4,2.0,2,1,882,742.0,0.5091835260391235,0.10708483308553696
5012168,4878004,4163023,5598,5052,1989,1307,1979,546,4291,0.0,0.0,1,5.0,3,1,546,532.0,0.30417874455451965,-0.03308242931962013
5018754,4435012,4045542,5626,2987,1984,607,1977,2639,5019,0.0,0.0,6,4.0,1,2,826,532.0,0.553807258605957,0.16180996596813202
5018401,4378578,4351285,5626,2644,1983,2462,1982,2982,3164,0.3333333333333333,0.0,5,3.0,8,7,1477,231.0,0.3222595751285553,0.1803118884563446
5019728,4733105,4743793,5626,4464,1988,4513,1988,1162,1113,1.0,0.0,3,1.0,2,3,819,1113.0,0.5158284306526184,0.0635838732123375
5021254,4470345,4095125,5633,3176,1984,894,1978,2457,4739,1.0,0.0,7,6.0,1,1,84,1813.0,0.4278969168663025,0.1850295066833496
5022720,4689726,4799585,5640,4254,1987,4772,1989,1386,868,1.0,0.0,2,1.0,4,3,539,868.0,0.601860523223877,0.08853954821825027
5025481,4903145,4820019,5647,5164,1990,4849,1989,483,798,0.0,0.0,1,1.0,12,1,483,798.0,0.5001401901245117,0.32611072063446045
5024460,4717173,4630604,5647,4387,1988,4009,1986,1260,1638,1.0,0.0,7,4.0,8,1,0,168.0,0.6946473717689514,0.3730180859565735
5024244,4289150,4827876,5647,2084,1981,4877,1989,3563,770,1.0,0.0,2,2.0,2,1,2625,308.0,0.6487424373626709,0.3574832081794739
5026375,4368734,4201096,5654,2574,1983,1587,1980,3080,4067,0.5,0.0,10,4.0,3,2,28,2149.0,0.46573010087013245,0.4172888398170471
5026744,4440829,4308108,5654,3015,1984,2189,1981,2639,3465,0.0,0.0,1,2.0,1,1,2639,2457.0,0.389514297246933,0.14296677708625793
5027087,4410860,4747497,5654,2847,1983,4534,1988,2807,1120,1.0,0.0,8,3.0,1,2,182,14.0,0.5891621112823486,0.2560567855834961
5029111,4809159,4621373,5661,4807,1989,3960,1986,854,1701,1.0,0.0,5,6.0,8,10,70,21.0,0.40641549229621887,0.2936834394931793
5030457,4405798,4176259,5668,2819,1983,1426,1979,2849,4242,0.0,0.0,2,2.0,1,4,1491,3388.0,0.5412916541099548,0.08001993596553802
5032605,4965268,4902072,5675,5409,1990,5164,1990,266,511,1.0,0.0,1,1.0,5,1,266,511.0,0.9913021326065063,0.04197606071829796
5033560,4505342,4558869,5682,3365,1985,3638,1985,2317,2044,1.0,0.0,19,11.0,8,4,28,28.0,0.6417732834815979,0.40079182386398315
5034732,4837551,4452535,5682,4905,1989,3078,1984,777,2604,0.0,0.0,10,1.0,4,1,21,2604.0,0.8887112140655518,0.22318992018699646
5042460,4721107,4318811,5717,4408,1988,2259,1982,1309,3458,1.0,0.0,2,2.0,2,1,203,2254.0,0.5725393295288086,0.2511320114135742
5043816,4691253,4427840,5717,4261,1987,2945,1984,1456,2772,1.0,0.0,12,2.0,22,6,14,686.0,0.6025142073631287,0.3270359933376312
5042993,4948400,4484942,5717,5339,1990,3253,1984,378,2464,1.0,0.0,2,3.0,8,3,112,1477.0,0.7782887816429138,0.18457162380218506
5045730,4656375,4143811,5724,4114,1987,1167,1979,1610,4557,1.0,0.0,7,5.0,7,2,7,42.0,0.5993224382400513,0.2594442367553711
5050967,4884867,4624291,5745,5087,1989,3981,1986,658,1764,0.0,0.0,2,6.0,9,1,168,224.0,0.6106516718864441,-0.010314197279512882
5052388,4890617,4883724,5752,5115,1990,5080,1989,637,672,1.0,0.0,1,2.0,6,6,637,112.0,0.7321541905403137,0.3354101777076721
5052386,4329987,3984044,5752,2329,1982,278,1976,3423,5474,1.0,0.0,3,9.0,5,1,1162,238.0,0.43528684973716736,0.28830045461654663
5054756,4616392,4310606,5759,3939,1986,2203,1982,1820,3556,1.0,0.0,5,2.0,2,2,595,1764.0,0.3897024989128113,0.08516223728656769
5055198,4631050,4011223,5759,4009,1986,432,1977,1750,5327,1.0,0.0,9,10.0,5,1,140,1036.0,0.7235741019248962,0.12789621949195862
5060255,4232199,4605189,5773,1769,1980,3876,1986,4004,1897,1.0,0.0,14,3.0,2,3,175,966.0,0.6005537509918213,0.28457140922546387
5060233,4879722,4386919,5773,5059,1989,2714,1983,714,3059,1.0,0.0,2,3.0,1,1,154,1771.0,0.6190217137336731,0.10968019813299179
5062130,4539696,4542198,5780,3533,1985,3547,1985,2247,2233,1.0,0.0,7,1.0,2,1,42,2233.0,0.6024834513664246,0.2717081606388092
5070286,4430022,4474334,5815,2959,1984,3197,1984,2856,2618,1.0,0.0,2,3.0,2,3,672,567.0,0.2908073961734772,0.22345595061779022
5071041,4632274,4592095,5822,4016,1986,3799,1986,1806,2023,0.0,0.0,2,3.0,1,1,308,112.0,0.3666072487831116,0.0608077272772789
5072705,4826410,4105757,5829,4870,1989,950,1978,959,4879,0.0,0.0,1,6.0,2,1,959,1267.0,0.6684848666191101,0.1680389791727066
5072503,4914798,4316699,5829,5213,1990,2245,1982,616,3584,1.0,0.0,1,3.0,3,7,616,1533.0,0.2428087294101715,0.20719482004642487
5075256,4664938,4425659,5836,4149,1987,2931,1984,1687,2905,0.0,0.0,5,4.0,7,3,434,1932.0,0.5914066433906555,0.42016732692718506
5075767,4700399,4046745,5836,4303,1987,614,1977,1533,5222,0.0,0.0,9,3.0,6,2,105,252.0,0.6255435943603516,0.0729232057929039
5076903,4664771,4188461,5843,4149,1987,1503,1980,1694,4340,1.0,0.0,1,2.0,5,1,1694,2639.0,0.6637688279151917,0.32813209295272827
5084645,4760302,4560388,5871,4590,1988,3645,1985,1281,2226,1.0,0.0,2,3.0,1,1,315,231.0,0.4386846423149109,0.19013184309005737
5083929,4963104,4061174,5871,5402,1990,705,1977,469,5166,1.0,0.0,1,2.0,5,1,469,714.0,0.5618261098861694,0.21969860792160034
5085935,4356523,4318980,5878,2490,1982,2259,1982,3388,3619,0.5,0.0,20,15.0,5,2,14,119.0,0.4473375976085663,0.14997625350952148
5089932,4610969,4450498,5892,3904,1986,3064,1984,1988,2828,1.0,0.0,20,2.0,7,1,49,2303.0,0.7379266619682312,0.20766288042068481
5092616,4958843,4164940,5906,5381,1990,1328,1979,525,4578,1.0,0.0,1,3.0,2,2,525,903.0,0.45352640748023987,0.18315590918064117
5094107,4116050,4654827,5913,999,1978,4107,1987,4914,1806,1.0,0.0,11,6.0,1,3,301,70.0,0.5463773012161255,0.1613943874835968
5095747,4114441,4730594,5920,992,1978,4457,1988,4928,1463,1.0,0.0,13,5.0,2,6,231,434.0,0.5327073335647583,0.19684939086437225
5097564,4498213,4005518,5927,3330,1985,397,1977,2597,5530,1.0,0.0,2,10.0,1,2,28,966.0,0.5862088203430176,0.24992573261260986
5099529,4675929,4129488,5934,4198,1987,1076,1978,1736,4858,1.0,0.0,3,5.0,4,3,1288,1561.0,0.3515935242176056,0.13318169116973877
5102381,4919417,4621732,5941,5227,1990,3967,1986,714,1974,1.0,0.0,4,4.0,3,2,35,35.0,0.6189382076263428,0.4490296542644501
5102960,4859722,4007539,5941,4982,1989,411,1977,959,5530,1.0,0.0,3,3.0,1,3,259,448.0,0.6090887188911438,0.23103594779968262
5104436,4693982,4827557,5948,4275,1987,4877,1989,1673,1071,0.0,0.0,2,2.0,1,1,273,819.0,0.5498074889183044,0.16201408207416534
5105827,4858624,4327236,5955,4982,1989,2308,1982,973,3647,1.0,0.0,1,3.0,2,2,973,84.0,0.47577470541000366,-0.0037754683289676905
5107829,4456223,4271387,5962,3099,1984,1979,1981,2863,3983,0.0,0.0,13,7.0,1,3,161,595.0,0.4511301517486572,0.23207831382751465
5108681,4154893,4494841,5962,1230,1979,3309,1985,4732,2653,0.0,0.0,9,4.0,1,5,224,322.0,0.38591811060905457,0.3766744136810303
5109925,5024273,4600903,5969,5647,1991,3848,1986,322,2121,1.0,0.0,1,2.0,2,2,322,1183.0,0.5260074734687805,0.08252489566802979
5109821,4905649,4750463,5969,5178,1990,4548,1988,791,1421,0.5,0.0,5,3.0,3,2,112,1015.0,0.4281359314918518,0.455221951007843
5113764,4393779,4940411,5983,2756,1983,5304,1990,3227,679,1.0,0.0,7,4.0,3,10,70,224.0,0.3288029134273529,0.14449502527713776
5113956,4945997,3996079,5983,5332,1990,341,1976,651,5642,1.0,0.0,1,11.0,9,1,651,147.0,0.6053638458251953,0.19758182764053345
5113889,4405458,4042403,5983,2819,1983,593,1977,3164,5390,0.0,0.0,10,3.0,2,2,21,4823.0,0.5335617661476135,0.02864140458405018
5113771,4644878,4065819,5983,4072,1987,733,1978,1911,5250,1.0,0.0,3,2.0,6,1,1281,4137.0,0.4116629958152771,0.24707487225532532
5116008,4564164,4771817,5990,3666,1986,4646,1988,2324,1344,0.0,0.0,4,2.0,1,4,224,7.0,0.6482917070388794,0.49969229102134705
5119264,4771356,4078199,5997,4639,1988,796,1978,1358,5201,0.5,0.0,1,7.0,2,3,1358,315.0,0.4749773442745209,0.37267351150512695
5126616,4758228,4577619,6025,4583,1988,3736,1986,1442,2289,0.0,0.0,14,5.0,6,10,21,126.0,0.1986779272556305,0.20947769284248352
5125906,4160451,4783925,6025,1286,1979,4702,1988,4739,1323,1.0,0.0,8,3.0,1,1,567,476.0,0.3540824055671692,0.2947635352611542
5125974,4954537,4452056,6025,5360,1990,3078,1984,665,2947,0.5,0.0,4,6.0,11,2,0,462.0,0.6071418523788452,0.3552272915840149
5130958,4569881,3996512,6039,3694,1986,341,1976,2345,5698,1.0,0.0,26,2.0,13,1,77,3178.0,0.3990585207939148,0.003109406214207411
5130265,4878015,4366127,6039,5052,1989,2553,1982,987,3486,0.5,0.0,3,3.0,2,2,98,189.0,0.4137880206108093,0.2441302090883255
5129816,4850841,4769206,6039,4954,1989,4632,1988,1085,1407,1.0,1.0,2,4.0,2,3,455,28.0,0.6886746287345886,0.32744094729423523
5132574,4604731,4636910,6046,3869,1986,4030,1987,2177,2016,0.5,0.0,7,2.0,7,2,280,644.0,0.5659513473510742,0.44831621646881104
5131918,4934009,4619941,6046,5283,1990,3953,1986,763,2093,0.5,0.0,2,6.0,7,1,189,63.0,0.5789851546287537,0.09141600877046585
5136312,4415247,4216495,6060,2875,1983,1678,1980,3185,4382,1.0,0.5,7,3.0,5,3,434,119.0,0.5397316813468933,0.3623094856739044
5135269,h439,4721772,6060,4443,1988,4408,1988,1617,1652,1.0,0.0,1,3.0,5,1,1617,448.0,0.45379120111465454,0.15479175746440887
5140058,4431699,4936754,6074,2966,1984,5290,1990,3108,784,0.3333333333333333,0.0,3,1.0,1,4,98,784.0,0.574860692024231,0.22421672940254211
5139472,4627618,4751260,6074,3995,1986,4548,1988,2079,1526,1.0,0.0,15,10.0,2,9,14,7.0,0.57538241147995,0.15666405856609344
5142699,4743864,4372383,6081,4513,1988,2595,1983,1568,3486,0.0,0.0,5,1.0,1,3,7,3486.0,0.4689123034477234,0.1440565586090088
5147063,4875361,4532713,6102,5045,1989,3505,1985,1057,2597,0.0,0.0,8,6.0,2,1,14,476.0,0.3567713797092438,0.04783545061945915
5150850,4811915,4715102,6116,4821,1989,4380,1987,1295,1736,1.0,0.0,2,2.0,1,5,693,1085.0,0.6810733675956726,0.2728710472583771
5153806,4584622,4744521,6123,3764,1986,4520,1988,2359,1603,1.0,0.0,14,2.0,2,4,140,343.0,0.5384130477905273,0.10253014415502548
5154658,4932913,5063693,6130,5276,1990,5794,1991,854,336,1.0,0.0,3,1.0,16,10,98,336.0,0.42798054218292236,0.14545553922653198
5154831,4792413,4192838,6130,4737,1988,1531,1980,1393,4599,0.0,0.0,4,5.0,3,1,119,119.0,0.3619794249534607,0.27937233448028564
5156313,4183239,4012541,6137,1475,1980,439,1977,4662,5698,0.0,0.0,5,4.0,1,1,210,3640.0,0.4281949996948242,0.05156548321247101
5157327,5034683,5052873,6137,5682,1991,5752,1991,455,385,1.0,0.0,2,1.0,4,4,119,385.0,0.6313636898994446,0.18706926703453064
5156659,4936871,4162319,6137,5290,1990,1300,1979,847,4837,0.0,0.0,2,4.0,5,2,49,1449.0,0.5183067321777344,0.13491635024547577
5156338,4646971,4201333,6137,4079,1987,1587,1980,2058,4550,0.5,0.0,3,9.0,6,1,63,770.0,0.7277857065200806,0.24275298416614532
5159690,4862347,4275129,6144,4989,1989,2000,1981,1155,4144,1.0,0.0,2,2.0,11,3,7,3626.0,0.4541795253753662,0.044334616512060165
5157829,4636726,4330127,6144,4030,1987,2329,1982,2114,3815,0.0,0.0,7,4.0,3,3,567,868.0,0.678803563117981,0.20538219809532166
5159238,4249105,4252766,6144,1860,1981,1881,1981,4284,4263,1.0,0.0,1,3.0,2,3,4284,3059.0,0.6976003646850586,0.20830674469470978
5165957,4871619,5032897,6172,5024,1989,5675,1991,1148,497,0.0,0.0,2,2.0,7,16,231,217.0,0.43259939551353455,0.18181174993515015
5166951,5056109,4640245,6172,5759,1991,4051,1987,413,2121,1.0,0.0,6,3.0,10,4,7,861.0,0.3505348861217499,0.15416841208934784
5168418,4485366,4757354,6179,3253,1984,4576,1988,2926,1603,0.5,0.0,1,3.0,1,2,2926,616.0,0.3855651617050171,0.09293778985738754
5170248,4677483,4277503,6186,4198,1987,2014,1981,1988,4172,1.0,0.0,10,4.0,3,1,196,329.0,0.5974816679954529,0.243062362074852
5170073,5036232,4930447,6186,5689,1991,5269,1990,497,917,1.0,0.0,2,1.0,11,9,217,917.0,0.4428090751171112,0.16012424230575562
5171121,4579496,4025625,6193,3743,1986,509,1977,2450,5684,0.0,0.0,3,2.0,9,1,973,3563.0,0.7458080649375916,0.03898174688220024
5173068,4837859,4948117,6200,4912,1989,5339,1990,1288,861,0.0,0.0,2,2.0,5,2,315,21.0,0.3358081579208374,0.4613725244998932
5173604,4736101,4995648,6200,4478,1988,5535,1991,1722,665,0.5,0.0,7,1.0,2,4,147,665.0,0.7148582339286804,0.18567031621932983
5173463,4356338,4121022,6200,2490,1982,1020,1978,3710,5180,0.0,0.0,15,3.0,7,1,7,595.0,0.47790855169296265,0.20125223696231842
5175068,4803137,4055647,6207,4786,1989,663,1977,1421,5544,1.0,0.0,4,2.0,3,1,224,840.0,0.5714059472084045,0.13975705206394196
5174987,4675173,4862812,6207,4191,1987,4996,1989,2016,1211,0.5,0.0,18,1.0,3,2,112,1211.0,0.5671994090080261,-0.054174717515707016
5176110,4422411,3999509,6214,2917,1983,362,1976,3297,5852,1.0,0.0,3,3.0,3,1,637,2660.0,0.4649702310562134,0.1882062405347824
5179184,4319032,4445603,6221,2259,1982,3043,1984,3962,3178,0.5,0.0,11,12.0,3,1,553,56.0,0.5852069854736328,0.08718161284923553
5179742,4668562,4911681,6228,4163,1987,5199,1990,2065,1029,0.0,0.0,9,2.0,15,3,98,147.0,0.3240504562854767,0.3234074115753174
5182571,4528242,4479168,6235,3477,1985,3218,1984,2758,3017,0.0,0.0,9,3.0,4,1,1071,679.0,0.6024444103240967,0.2712859809398651
5181625,4186845,4010432,6235,1496,1980,425,1977,4739,5810,1.0,0.0,12,11.0,1,1,441,938.0,0.390919953584671,0.3235413432121277
5181747,4576671,4669888,6235,3729,1986,4170,1987,2506,2065,0.0,0.0,6,1.0,2,2,105,2065.0,0.48336467146873474,0.1809448003768921
5183186,4473185,4781014,6242,3190,1984,4688,1988,3052,1554,0.0,0.0,5,2.0,2,5,231,1162.0,0.5132918357849121,0.09555988013744354
5185758,4636611,4088276,6249,4030,1987,859,1978,2219,5390,0.0,0.0,3,9.0,7,1,511,196.0,0.3366892635822296,0.14521725475788116
5184977,4091641,4511992,6249,880,1978,3393,1985,5369,2856,1.0,0.0,9,2.0,1,2,1540,1519.0,0.6489001512527466,0.0916200503706932
5186093,4744389,4423666,6256,4520,1988,2924,1984,1736,3332,1.0,0.0,4,4.0,6,1,511,1155.0,0.4774170517921448,0.1556892842054367
5186638,5015946,4407087,6256,5612,1991,2833,1983,644,3423,0.0,0.0,2,5.0,2,3,245,2170.0,0.4330229163169861,0.29924723505973816
5187664,4847769,4290038,6256,4940,1989,2084,1981,1316,4172,1.0,0.0,6,2.0,3,2,49,2716.0,0.5286293625831604,0.4974060654640198
5193254,4788752,4469079,6284,4723,1988,3169,1984,1561,3115,0.0,0.0,4,1.0,4,1,154,3115.0,0.547281801700592,0.13107411563396454
5199409,5040513,4513675,6305,5710,1991,3407,1985,595,2898,1.0,0.0,2,2.0,5,3,301,1918.0,0.5903279185295105,0.17140163481235504
5203015,4768220,4349779,6312,4625,1988,2448,1982,1687,3864,1.0,0.0,13,5.0,6,2,21,721.0,0.639882504940033,0.3477945625782013
5204960,4558413,4210688,6319,3631,1985,1643,1980,2688,4676,1.0,0.0,58,9.0,1,2,7,420.0,0.49041178822517395,0.14449843764305115
5204248,4622301,4974716,6319,3967,1986,5451,1990,2352,868,0.5,0.0,1,3.0,3,6,2352,56.0,0.29124656319618225,0.2966119647026062
5207971,4834924,4258803,6333,4898,1989,1916,1981,1435,4417,1.0,0.0,1,4.0,7,1,1435,2268.0,0.6437397003173828,0.311665803194046
5209348,4174035,4157325,6340,1412,1979,1251,1979,4928,5089,0.0,0.0,2,7.0,2,5,1435,2156.0,0.34604424238204956,0.09694306552410126
5211874,4501681,4585258,6347,3344,1985,3771,1986,3003,2576,0.0,0.0,11,4.0,1,1,42,1015.0,0.4418589770793915,0.13905858993530273
5212723,5003592,4343444,6347,5563,1991,2413,1982,784,3934,1.0,0.0,2,4.0,3,5,196,882.0,0.6868741512298584,0.19813615083694458
5213938,4789617,4255369,6354,4723,1988,1895,1981,1631,4459,0.5,0.0,4,2.0,6,2,336,2905.0,0.5863230228424072,0.15065118670463562
5214433,5113193,4153661,6354,5976,1992,1223,1979,378,5131,1.0,0.0,1,18.0,6,1,378,14.0,0.45473143458366394,0.2122163474559784
5213366,4610463,4396786,6354,3904,1986,2770,1983,2450,3584,0.5,0.0,7,7.0,1,2,133,560.0,0.6387802958488464,0.22333914041519165
5216091,4460736,4205773,6361,3120,1984,1615,1980,3241,4746,1.0,0.0,8,5.0,1,1,42,1673.0,0.4579165279865265,0.1387646496295929
5221401,4778548,4364755,6382,4674,1988,2546,1982,1708,3836,0.3333333333333333,0.0,7,3.0,3,1,399,399.0,0.4758676588535309,0.21479396522045135
5223907,5131740,4057724,6389,6046,1992,677,1977,343,5712,1.0,1.0,1,4.0,3,1,343,4424.0,0.45817849040031433,0.1172921359539032
5228286,5022225,5023250,6410,5640,1991,5640,1991,770,770,0.0,0.0,1,2.0,12,1,770,77.0,0.7548417448997498,0.03290760889649391
5229991,4991168,4576652,6410,5514,1991,3729,1986,896,2681,1.0,0.0,4,13.0,5,6,28,35.0,0.32034313678741455,0.15183159708976746
5230333,5027440,5026680,6417,5661,1991,5654,1991,756,763,0.0,0.0,2,1.0,3,2,273,763.0,0.6581286191940308,0.13592228293418884
5233679,4422719,4247668,6424,2917,1983,1853,1981,3507,4571,1.0,0.0,50,2.0,6,1,91,3948.0,0.46670642495155334,0.11550441384315491
5233450,5084777,4054164,6424,5871,1992,656,1977,553,5768,1.0,0.0,4,7.0,4,1,28,1008.0,0.5532355308532715,0.22016441822052002
5233602,4985886,4082756,6424,5493,1991,824,1978,931,5600,0.5,0.0,1,2.0,6,1,931,3458.0,0.35590025782585144,0.08470592647790909
5236173,5114077,4911038,6438,5983,1992,5199,1990,455,1239,0.0,0.0,2,4.0,4,3,161,266.0,0.27733638882637024,0.2768184244632721
5239247,4174237,4470190,6445,1412,1979,3176,1984,5033,3269,0.0,0.0,19,9.0,4,4,231,21.0,0.5371888279914856,0.15756778419017792
5242183,4154452,4178098,6459,1230,1979,1440,1979,5229,5019,1.0,0.0,7,7.0,3,2,952,77.0,0.7735705971717834,0.19950351119041443
5242595,4876100,3988775,6459,5045,1989,299,1976,1414,6160,0.0,0.0,1,4.0,3,1,1414,3948.0,0.29754018783569336,0.12544666230678558
5244464,4574798,4598913,6466,3722,1986,3841,1986,2744,2625,1.0,0.0,4,2.0,5,2,35,511.0,0.32708343863487244,0.27418139576911926
5244984,5135991,5074245,6466,6060,1992,5836,1991,406,630,1.0,0.0,1,1.0,1,2,406,630.0,0.9800654053688049,0.1713627129793167
5247349,4558340,4921245,6473,3631,1985,5234,1990,2842,1239,1.0,0.0,10,2.0,2,6,56,616.0,0.5463900566101074,0.008281773887574673
5246723,4609560,4446600,6473,3897,1986,3050,1984,2576,3423,1.0,0.0,4,10.0,6,2,868,441.0,0.41253361105918884,0.2210497409105301
5247754,4568287,4066353,6480,3687,1986,733,1978,2793,5747,1.0,0.0,2,4.0,4,2,2044,14.0,0.22360223531723022,0.263542503118515
5251323,4757444,4498169,6487,4576,1988,3323,1985,1911,3164,1.0,0.0,8,10.0,7,3,301,602.0,0.7073385715484619,0.3197782635688782
5249404,4665672,4646251,6487,4156,1987,4072,1987,2331,2415,0.5,0.0,8,2.0,3,1,231,329.0,0.7741085290908813,0.2902259826660156
5252080,4955819,4561056,6494,5367,1990,3645,1985,1127,2849,1.0,0.0,4,5.0,4,8,238,861.0,0.5737369060516357,0.26176953315734863
5256389,4301037,4909476,6508,2147,1981,5192,1990,4361,1316,0.5,0.0,13,2.0,29,3,91,35.0,0.3525817394256592,0.25339892506599426
5257409,4218657,4612214,6508,1692,1980,3911,1986,4816,2597,0.5,0.0,4,1.0,6,4,2408,2597.0,0.4735826849937439,0.1029624491930008
5259632,4549742,4822248,6522,3589,1985,4856,1989,2933,1666,1.0,0.0,3,6.0,4,4,1246,210.0,0.6775418519973755,0.40891537070274353
5265587,4840130,4835047,6543,4919,1989,4898,1989,1624,1645,1.0,0.0,6,3.0,8,11,616,21.0,0.5754061341285706,0.19189490377902985
5265689,4809804,4858418,6543,4814,1989,4982,1989,1729,1561,0.5,0.0,6,5.0,6,5,84,238.0,0.5763940215110779,0.3195038437843323
5273698,4513518,4744460,6571,3407,1985,4520,1988,3164,2051,0.0,0.0,19,5.0,2,4,322,189.0,0.512910008430481,0.2625686526298523
5274480,4693557,4011828,6571,4275,1987,439,1977,2296,6132,1.0,0.0,17,3.0,13,1,105,1596.0,0.5466277003288269,0.2851628363132477
5276071,4737553,4089669,6578,4485,1988,866,1978,2093,5712,0.0,0.0,10,3.0,3,1,98,2674.0,0.576404333114624,0.2754583954811096
5276580,4671469,4491883,6578,4177,1987,3288,1985,2401,3290,0.5,0.5,5,2.0,4,2,35,1848.0,0.6531035900115967,0.5057116746902466
5279646,4582515,5122227,6592,3757,1986,6011,1992,2835,581,1.0,0.0,5,2.0,5,2,532,49.0,0.584412693977356,0.14630955457687378
5281419,5004602,4260004,6599,5570,1991,1923,1981,1029,4676,1.0,0.0,1,19.0,2,1,1029,49.0,0.45047813653945923,0.18035772442817688
5283876,4464712,4844047,6606,3141,1984,4933,1989,3465,1673,1.0,0.0,39,3.0,10,3,84,399.0,0.5101640224456787,0.2523934841156006
5283516,4654806,4718090,6606,4107,1987,4387,1988,2499,2219,0.0,0.0,7,3.0,8,5,210,91.0,0.510323166847229,0.195174902677536
5284935,4199565,4039114,6613,1573,1980,579,1977,5040,6034,0.0,0.0,9,5.0,3,1,91,896.0,0.3821479082107544,0.3107609450817108
5286780,4906707,4770144,6620,5178,1990,4639,1988,1442,1981,1.0,0.0,5,6.0,3,3,742,259.0,0.765485405921936,0.09964533895254135
5288311,4685938,4374724,6627,4240,1987,2609,1983,2387,4018,1.0,0.5,1,3.0,9,2,2387,2310.0,0.444336473941803,0.28513583540916443
5291330,h423,4285034,6634,4415,1988,2056,1981,2219,4578,1.0,0.0,1,5.0,1,1,2219,14.0,0.41192829608917236,0.3973694145679474
5291767,4272974,4341304,6641,1993,1981,2399,1982,4648,4242,1.0,0.0,10,3.0,3,2,868,868.0,0.5542585253715515,0.19020000100135803
5297222,4550437,4298808,6655,3589,1985,2133,1981,3066,4522,1.0,0.0,45,2.0,4,1,84,1967.0,0.4725639224052429,0.33859094977378845
5295453,4551244,4137995,6655,3596,1985,1132,1979,3059,5523,0.0,0.0,7,13.0,3,2,763,224.0,0.5831636786460876,0.20758935809135437
5300741,5049708,4011414,6669,5738,1991,432,1977,931,6237,1.0,0.0,4,8.0,4,1,70,343.0,0.7643404006958008,0.39099329710006714
5307036,4703291,4831020,6690,4317,1987,4884,1989,2373,1806,1.0,0.0,16,2.0,3,3,28,798.0,0.3898513615131378,0.1428796499967575
5306548,4936936,4202632,6690,5290,1990,1594,1980,1400,5096,1.0,0.0,6,2.0,5,1,7,2590.0,0.5287348031997681,0.1894276887178421
5309701,4587800,4122350,6704,3785,1986,1027,1978,2919,5677,1.0,0.0,7,6.0,4,1,112,1162.0,0.5997747182846069,0.2121858447790146
5311838,5026954,4425853,6711,5654,1991,2938,1984,1057,3773,0.0,0.0,3,1.0,7,1,203,3773.0,0.3912093937397003,0.17804718017578125
5316899,4737427,5223414,6725,4485,1988,6389,1993,2240,336,0.25,0.0,7,1.0,5,4,224,336.0,0.7737908959388733,0.06215173751115799
5316219,4872417,4292567,6725,5031,1989,2098,1981,1694,4627,1.0,0.0,8,3.0,7,2,644,567.0,0.5186684131622314,0.0573841892182827
5317584,5068868,4750490,6725,5808,1991,4548,1988,917,2177,1.0,0.0,12,4.0,2,2,77,770.0,0.4775877594947815,0.16225549578666687
5316666,5067938,4351243,6725,5808,1991,2462,1982,917,4263,0.0,0.0,2,2.0,3,1,126,2471.0,0.379794716835022,0.28211548924446106
5320909,4645716,4083715,6739,4072,1987,831,1978,2667,5908,0.0,0.0,11,5.0,1,5,49,294.0,0.3896574079990387,0.28538408875465393
5322076,4674519,4176526,6746,4191,1987,1433,1979,2555,5313,1.0,0.0,11,3.0,2,1,399,1491.0,0.5826072692871094,0.20778971910476685
5322841,5032401,4716832,6746,5675,1991,4387,1988,1071,2359,1.0,0.0,2,7.0,6,4,511,553.0,0.45965683460235596,0.22138312458992004
5324327,4643201,4836697,6753,4065,1987,4905,1989,2688,1848,1.0,0.0,1,5.0,5,12,2688,98.0,0.5062233805656433,0.1104402020573616
5325340,4995018,4956023,6753,5528,1991,5367,1990,1225,1386,1.0,0.0,3,4.0,5,3,294,203.0,0.4825131297111511,0.3466776907444
5323577,4483122,5102530,6753,3246,1984,5941,1992,3507,812,1.0,0.0,15,1.0,2,13,616,812.0,0.3931831419467926,0.08337762951850891
5325941,4618049,4022870,6760,3946,1986,495,1977,2814,6265,0.5,0.0,6,5.0,4,1,812,2520.0,0.46879109740257263,0.06666592508554459
5328156,4995591,4186635,6767,5535,1991,1496,1980,1232,5271,0.0,0.0,5,3.0,3,2,189,3962.0,0.5666636228561401,0.11999095976352692
5330358,4525148,5162041,6774,3463,1985,6158,1992,3311,616,0.5,0.0,2,1.0,5,4,1855,616.0,0.5926322340965271,0.28280404210090637
5337443,4930178,4134058,6802,5269,1990,1104,1979,1533,5698,1.0,0.0,5,10.0,8,2,91,623.0,0.6706445813179016,0.033656638115644455
5341021,4882290,5064120,6809,5073,1989,5794,1991,1736,1015,1.0,0.0,1,3.0,9,4,1736,553.0,0.6216515898704529,0.25801756978034973
5342662,4904723,4161269,6816,5171,1990,1293,1979,1645,5523,0.0,0.0,10,5.0,2,1,112,903.0,0.5193337798118591,0.06667765974998474
5345451,5230002,4653280,6823,6410,1993,4107,1987,413,2716,1.0,0.0,1,6.0,2,8,413,805.0,0.4122714102268219,0.2936224639415741
5345313,4694329,4890013,6823,4275,1987,5108,1989,2548,1715,1.0,0.0,16,1.0,9,4,91,1715.0,0.4769338369369507,0.3280189037322998
5346628,4444667,4164034,6830,3036,1984,1314,1979,3794,5516,1.0,0.0,14,8.0,1,2,77,392.0,0.3852391242980957,0.01228092797100544
5348388,5129729,4877696,6837,6039,1992,5052,1989,798,1785,0.5,0.0,2,4.0,3,1,56,588.0,0.7617745995521545,0.30366599559783936
5352254,4951427,4806099,6851,5353,1990,4800,1989,1498,2051,1.0,0.0,8,4.0,4,3,161,280.0,0.748711884021759,0.17110377550125122
5353998,4770708,4658833,6858,4639,1988,4128,1987,2219,2730,0.0,0.0,4,4.0,1,5,1197,777.0,0.38155242800712585,0.20407117903232574
5356903,4623650,4916052,6865,3974,1986,5213,1990,2891,1652,0.5,0.0,19,2.0,2,2,91,413.0,0.505891740322113,0.14939934015274048
5355920,5219010,4126706,6865,6375,1993,1055,1978,490,5810,0.0,0.0,1,21.0,6,1,490,126.0,0.5787674784660339,0.4262901544570923
5360122,4394910,4401506,6879,2763,1983,2798,1983,4116,4081,1.0,0.0,5,4.0,1,1,357,434.0,0.4906946122646332,0.2943418622016907
5360530,4963303,4115518,6879,5402,1990,992,1978,1477,5887,0.3333333333333333,0.2,3,13.0,9,2,7,1008.0,0.323932021856308,0.44969823956489563
5360897,4663160,4090261,6879,4142,1987,866,1978,2737,6013,0.5,0.0,8,5.0,8,1,189,3668.0,0.5348474979400635,0.33071190118789673
5362799,4824500,5144946,6886,4863,1989,6095,1992,2023,791,0.0,0.0,6,2.0,5,9,42,427.0,0.4209020733833313,0.13712045550346375
5362085,4974867,4211529,6886,5451,1990,1650,1980,1435,5236,1.0,0.0,8,2.0,8,3,70,4445.0,0.5565792322158813,0.09925072640180588
5361954,4470528,4342844,6886,3176,1984,2406,1982,3710,4480,0.0,0.0,16,5.0,5,3,280,350.0,0.6528295278549194,0.1657423973083496
5365570,4724538,4813759,6893,4422,1988,4828,1989,2471,2065,0.0,0.0,13,1.0,3,3,70,2065.0,0.60141921043396,0.2777331471443176
5366986,4404221,4746686,6900,2812,1983,4527,1988,4088,2373,1.0,0.0,5,16.0,4,3,700,14.0,0.5184133648872375,0.1681460589170456
5369679,4856036,4769359,6907,4968,1989,4632,1988,1939,2275,0.0,0.0,7,2.0,7,1,784,1113.0,0.44714850187301636,0.16274823248386383
5369841,4596062,4221336,6914,3827,1986,1713,1980,3087,5201,1.0,0.0,2,16.0,3,2,1323,350.0,0.6120139360427856,0.3323545455932617
5370328,4768731,4579537,6914,4632,1988,3743,1986,2282,3171,1.0,0.0,1,8.0,4,14,2282,490.0,0.5008444786071777,0.20827993750572205
5372777,4828008,4528445,6921,4877,1989,3477,1985,2044,3444,1.0,0.0,39,5.0,5,1,35,91.0,0.5314874053001404,0.17291417717933655
5372297,4491001,4606311,6921,3288,1985,3883,1986,3633,3038,0.0,0.0,3,8.0,2,8,336,119.0,0.364824503660202,0.0707567110657692
5373377,5159477,4664810,6921,6144,1992,4149,1987,777,2772,0.5,0.0,1,4.0,4,4,777,448.0,0.7443857789039612,0.22118645906448364
5372522,4767359,4122044,6921,4625,1988,1027,1978,2296,5894,1.0,0.0,3,2.0,1,4,413,4158.0,0.42469459772109985,0.05092449486255646
5374824,4823016,5208717,6928,4856,1989,6333,1993,2072,595,1.0,0.0,9,3.0,25,8,91,91.0,0.4875154495239258,0.12646621465682983
5377331,4817037,4781928,6935,4835,1989,4688,1988,2100,2247,1.0,0.0,4,1.0,11,5,427,2247.0,0.5438383221626282,0.008146457374095917
5378998,4910455,4671852,6942,5192,1990,4177,1987,1750,2765,1.0,0.0,7,6.0,3,4,42,357.0,0.6503364443778992,0.45615920424461365
5377899,4423120,5109109,6942,2917,1983,5962,1992,4025,980,0.5,0.0,12,2.0,7,1,658,350.0,0.3244123160839081,0.1386469304561615
5379747,4625422,4402646,6949,3988,1986,2805,1983,2961,4144,1.0,0.0,8,3.0,2,2,189,693.0,0.7567379474639893,0.19584152102470398
5380271,4731926,4420051,6949,4464,1988,2903,1983,2485,4046,0.0,0.0,21,8.0,8,4,21,189.0,0.4746062755584717,0.18443216383457184
5382605,4939185,4893019,6956,5297,1990,5122,1990,1659,1834,1.0,0.0,2,4.0,14,6,602,973.0,0.4198778569698334,0.20081420242786407
5387909,5235317,4530482,6977,6431,1993,3491,1985,546,3486,0.0,0.0,1,5.0,9,1,546,287.0,0.5852025151252747,0.3721725642681122
5391624,4830803,4424262,6991,4884,1989,2924,1984,2107,4067,0.0,0.0,4,7.0,20,4,826,399.0,0.40698960423469543,0.26553571224212646
5392433,5287521,4828549,6991,6620,1994,4877,1989,371,2114,1.0,0.0,1,6.0,7,6,371,245.0,0.5546086430549622,0.2092939019203186
5394005,4739383,4754695,6998,4492,1988,4569,1988,2506,2429,1.0,0.0,3,2.0,2,1,126,1239.0,0.49515774846076965,0.11417609453201294
5396769,4887430,4055133,7012,5101,1989,663,1977,1911,6349,1.0,0.0,2,6.0,16,1,980,2310.0,0.658781111240387,0.3054729104042053
5397177,4106114,4635191,7012,950,1978,4023,1987,6062,2989,0.0,0.0,1,1.0,1,6,6062,2989.0,0.3616099953651428,0.2995162308216095
5397107,4688708,4792184,7012,4254,1987,4737,1988,2758,2275,0.5,0.0,16,9.0,5,6,28,490.0,0.4854888617992401,0.27271851897239685
5402835,5033637,4711905,7033,5682,1991,4359,1987,1351,2674,0.0,0.0,4,6.0,15,4,14,973.0,0.20563052594661713,0.037156619131565094
5405148,4696477,4435064,7040,4289,1987,2987,1984,2751,4053,1.0,0.0,1,2.0,4,7,2751,182.0,0.5922570824623108,0.1829701066017151
5410360,4688097,5307514,7054,4247,1987,6690,1994,2807,364,1.0,0.0,6,1.0,1,2,77,364.0,0.4589642882347107,0.35089272260665894
5411484,4447238,4463378,7061,3050,1984,3134,1984,4011,3927,1.0,0.0,3,9.0,3,2,959,259.0,0.7118533253669739,0.37725287675857544
5415816,4946923,4683767,7075,5332,1990,4233,1987,1743,2842,0.0,0.0,3,6.0,5,1,182,525.0,0.47008806467056274,0.11681266874074936
5421961,4623429,4735207,7096,3974,1986,4478,1988,3122,2618,1.0,0.0,10,2.0,5,4,616,966.0,0.30744248628616333,0.28248536586761475
5426074,4869778,5086928,7110,5017,1989,5885,1992,2093,1225,0.0,0.0,5,2.0,4,4,259,91.0,0.29761940240859985,0.14180393517017365
5425615,4124096,4469825,7110,1041,1978,3169,1984,6069,3941,1.0,0.0,9,11.0,4,1,714,567.0,0.7475035190582275,0.05584961175918579
5427447,4792174,4655665,7117,4737,1988,4114,1987,2380,3003,0.0,0.0,8,7.0,2,3,154,546.0,0.40370532870292664,0.39296138286590576
5428080,5202366,4392374,7117,6312,1993,2749,1983,805,4368,0.5,0.0,3,4.0,15,5,112,910.0,0.38995110988616943,0.30586469173431396
5426883,4866874,5133985,7117,5010,1989,6053,1992,2107,1064,1.0,0.0,1,1.0,4,2,2107,1064.0,0.6175894737243652,0.2927950322628021
5427291,4856689,5177569,7117,4975,1989,6214,1993,2142,903,0.0,0.0,5,2.0,3,2,126,168.0,0.38559937477111816,0.28171244263648987
5436574,4229803,4303573,7145,1755,1980,2161,1981,5390,4984,0.5,0.0,7,5.0,1,1,2422,560.0,0.5033614635467529,0.1412704885005951
5437759,4844760,4210769,7152,4933,1989,1643,1980,2219,5509,1.0,0.0,9,3.0,4,2,112,4151.0,0.5922120213508606,0.35163751244544983
5438854,5065603,4799900,7159,5801,1991,4772,1989,1358,2387,0.5,0.0,4,5.0,4,7,315,1379.0,0.6652013063430786,0.32027846574783325
5450602,4692894,4044091,7194,4268,1987,600,1977,2926,6594,0.5,0.0,17,3.0,5,1,112,3108.0,0.31780847907066345,0.229147270321846
5456932,5110614,4782845,7222,5969,1992,4695,1988,1253,2527,1.0,0.0,4,1.0,14,1,42,2527.0,0.3091448247432709,0.13399021327495575
5456508,4326742,4367092,7222,2308,1982,2560,1983,4914,4662,1.0,0.0,2,3.0,2,1,2898,609.0,0.4725733697414398,0.26238465309143066
5456404,4814040,4054639,7222,4828,1989,656,1977,2394,6566,0.0,0.0,29,2.0,2,1,91,3213.0,0.3809228241443634,0.08465579897165298
5456267,5019080,4608897,7222,5626,1991,3897,1986,1596,3325,0.5,0.0,9,2.0,2,1,49,1491.0,0.28172311186790466,0.2013607770204544
5457906,4682431,4479053,7229,4226,1987,3218,1984,3003,4011,0.0,0.0,4,18.0,5,2,518,63.0,0.6662417650222778,0.2298695594072342
5463305,4862013,4441338,7243,4989,1989,3022,1984,2254,4221,0.0,0.0,5,2.0,6,2,224,2947.0,0.532497763633728,0.10928581655025482
5463294,5294871,4211747,7243,6648,1994,1650,1980,595,5593,1.0,0.0,2,2.0,3,2,35,4445.0,0.6714670062065125,0.15181836485862732
5464309,4730672,4525173,7250,4457,1988,3463,1985,2793,3787,0.5,0.0,37,4.0,13,1,28,2842.0,0.5150701403617859,0.26727983355522156
5464737,4451561,3995333,7250,3071,1984,341,1976,4179,6909,1.0,0.0,23,6.0,3,1,49,245.0,0.47094136476516724,0.20354929566383362
5464183,5054732,4173509,7250,5759,1991,1405,1979,1491,5845,1.0,0.0,1,3.0,11,2,1491,455.0,0.6397750377655029,0.34284496307373047
5469927,5011515,4297455,7271,5598,1991,2126,1981,1673,5145,1.0,0.0,12,20.0,6,7,35,98.0,0.5021657347679138,0.17896993458271027
5477397,5122875,4693156,7292,6011,1992,4275,1987,1281,3017,1.0,0.0,28,6.0,13,7,42,644.0,0.6104455590248108,0.02411886863410473
5476654,4639370,5184250,7292,4044,1987,6242,1993,3248,1050,1.0,0.0,3,1.0,2,10,98,1050.0,0.5306646227836609,0.09325501322746277
5476878,4806290,4533558,7292,4800,1989,3505,1985,2492,3787,0.0,0.0,10,2.0,3,5,266,588.0,0.5501204133033752,0.0980413407087326
5481501,5062086,4677346,7306,5780,1991,4198,1987,1526,3108,1.0,0.0,2,4.0,4,3,308,532.0,0.41913145780563354,0.15389497578144073
5487076,5014273,4585258,7327,5605,1991,3771,1986,1722,3556,0.0,0.0,2,4.0,10,1,385,1995.0,0.6549000144004822,0.1667449176311493
5485921,4969558,4985239,7327,5430,1990,5493,1991,1897,1834,1.0,0.0,3,7.0,6,1,196,98.0,0.6172428131103516,0.17767858505249023
5486121,4249789,5272099,7327,1867,1981,6564,1993,5460,763,1.0,1.0,3,6.0,1,7,2394,175.0,0.5998467803001404,0.2158277928829193
5487018,5164911,5243986,7327,6165,1992,6466,1993,1162,861,1.0,0.0,5,1.0,6,16,49,861.0,0.32747310400009155,0.09882187843322754
5488265,5091673,4611292,7334,5899,1992,3904,1986,1435,3430,1.0,0.0,4,22.0,5,8,168,385.0,0.6787747144699097,0.39469003677368164
5492006,4562728,4463430,7355,3659,1986,3134,1984,3696,4221,1.0,0.0,9,19.0,3,10,350,77.0,0.5343846678733826,0.25311020016670227
5493487,5111381,4867303,7355,5969,1992,5010,1989,1386,2345,1.0,0.0,3,2.0,7,13,413,189.0,0.4825859069824219,0.22818289697170258
5499951,5271479,4597916,7383,6564,1993,3834,1986,819,3549,0.0,0.0,2,12.0,1,4,595,175.0,0.6072133183479309,0.1536480337381363
5502638,5220508,4792965,7390,6375,1993,4737,1988,1015,2653,1.0,0.0,3,3.0,9,2,315,14.0,0.22760234773159027,0.15719150006771088
5506060,4060515,4520095,7404,698,1977,3435,1985,6706,3969,0.5,0.0,14,3.0,1,2,2380,1708.0,0.5202724933624268,0.07567523419857025
5506117,4988443,5372540,7404,5507,1991,6921,1994,1897,483,0.0,0.0,2,1.0,10,14,336,483.0,0.45982035994529724,0.12660641968250275
5506487,5233275,4207771,7404,6424,1993,1629,1980,980,5775,1.0,0.0,5,5.0,7,2,49,1190.0,0.48788169026374817,0.2635715901851654
5508649,5349559,4397909,7411,6837,1994,2777,1983,574,4634,0.0,0.0,1,5.0,9,2,574,266.0,0.36119914054870605,0.01387076172977686
5508372,5189096,4357190,7411,6263,1993,2497,1982,1148,4914,0.5,0.0,2,5.0,3,10,7,1701.0,0.4512901306152344,0.37356656789779663
5507720,4497070,4509474,7411,3323,1985,3386,1985,4088,4025,0.0,0.0,8,4.0,9,2,735,147.0,0.49225011467933655,0.12537766993045807
5508072,5043196,5063399,7411,5717,1991,5787,1991,1694,1624,0.3333333333333333,0.0,29,4.0,17,9,7,70.0,0.3482462763786316,0.27207979559898376
5507289,4381011,4325830,7411,2672,1983,2301,1982,4739,5110,1.0,0.0,24,15.0,2,10,105,1463.0,0.3709218502044678,-0.009047274477779865
5509783,5102299,4759798,7418,5941,1992,4590,1988,1477,2828,1.0,0.0,5,2.0,11,3,21,287.0,0.4256100356578827,0.1466374397277832
5509486,4937878,4753080,7418,5290,1990,4562,1988,2128,2856,0.0,0.0,9,8.0,2,4,448,7.0,0.3875269889831543,0.031901344656944275
5509760,5076727,4829952,7418,5843,1991,4884,1989,1575,2534,0.0,0.0,21,1.0,8,2,84,2534.0,0.5981426239013672,0.1662389039993286
5510345,5099019,4286288,7418,5927,1992,2063,1981,1491,5355,0.5,0.0,7,4.0,21,4,637,644.0,0.38521480560302734,0.05455879494547844
5511792,4093235,4290585,7425,887,1978,2091,1981,6538,5334,1.0,0.0,9,11.0,1,1,280,175.0,0.3215888738632202,0.1049974337220192
5513928,5080528,4498169,7432,5857,1992,3323,1985,1575,4109,0.5,0.0,3,13.0,7,3,1127,224.0,0.4501175880432129,0.33916527032852173
5513924,5354143,4789444,7432,6858,1994,4723,1988,574,2709,1.0,0.0,2,2.0,2,4,161,1064.0,0.6928471326828003,0.1184542179107666
5515724,4670092,4813008,7439,4170,1987,4821,1989,3269,2618,0.0,0.0,59,6.0,2,3,28,686.0,0.30865463614463806,0.18588700890541077
5519500,4905022,4229381,7446,5171,1990,1755,1980,2275,5691,0.3333333333333333,0.0,15,8.0,3,5,84,1792.0,0.5815982818603516,0.2678287625312805
5520738,4826703,4323627,7453,4870,1989,2287,1982,2583,5166,1.0,0.0,7,7.0,1,3,658,147.0,0.43893706798553467,0.2615078091621399
5521343,4470385,4133697,7453,3176,1984,1104,1979,4277,6349,0.5,0.5,3,3.0,1,2,378,1820.0,0.46807175874710083,0.23327748477458954
5520290,5090576,4547252,7453,5899,1992,3575,1985,1554,3878,0.3333333333333333,0.0,5,6.0,5,1,42,56.0,0.4217941462993622,0.4399433434009552
5522911,5089039,4776329,7460,5892,1992,4667,1988,1568,2793,0.3333333333333333,0.0,2,15.0,4,3,1141,448.0,0.7073023915290833,0.17479345202445984
5522140,4897923,5369448,7460,5150,1990,6907,1994,2310,553,0.0,0.0,7,1.0,3,5,805,553.0,0.45454245805740356,0.298605740070343
5524776,5316157,5177842,7467,6725,1994,6221,1993,742,1246,1.0,0.0,2,2.0,7,4,392,252.0,0.6689553260803223,0.2828085422515869
5525291,5238386,4656412,7467,6445,1993,4114,1987,1022,3353,0.0,0.0,1,7.0,12,1,1022,35.0,0.6319043040275574,0.07915922999382019
5528126,5367247,4399338,7474,6900,1994,2784,1983,574,4690,0.5,0.0,4,8.0,28,1,84,875.0,0.5149017572402954,0.20374956727027893
5528835,5070618,4160117,7481,5822,1991,1279,1979,1659,6202,0.0,0.0,1,5.0,3,1,1659,3444.0,0.6689687371253967,0.20382238924503326
5530173,5055634,4157578,7481,5759,1991,1251,1979,1722,6230,1.0,0.0,1,2.0,9,1,1722,4963.0,0.599031388759613,0.20180726051330566
5529822,4774111,4737137,7481,4653,1988,4485,1988,2828,2996,0.0,0.0,9,12.0,8,2,42,378.0,0.5139920711517334,0.1953420490026474
5529492,5240414,4183000,7481,6452,1993,1468,1980,1029,6013,1.0,0.0,3,2.0,6,1,168,567.0,0.5296891331672668,0.01195494458079338
5531697,5098262,5193054,7488,5927,1992,6277,1993,1561,1211,0.0,0.0,7,1.0,4,13,203,1211.0,0.560020923614502,0.21521899104118347
5534483,4701208,5099883,7495,4310,1987,5934,1992,3185,1561,1.0,0.0,4,6.0,2,3,7,91.0,0.5681272745132446,0.05746420845389366
5533512,5199877,4501403,7495,6305,1993,3344,1985,1190,4151,0.0,0.0,2,3.0,3,1,511,70.0,0.2426060438156128,0.06757381558418274
5534129,5149566,4394114,7495,6109,1992,2756,1983,1386,4739,0.0,0.0,1,1.0,5,1,1386,4739.0,0.29782065749168396,0.029680822044610977
5537141,4786967,4772060,7502,4709,1988,4646,1988,2793,2856,1.0,0.0,10,2.0,21,4,154,756.0,0.457987517118454,0.21317213773727417
5540288,5259461,4080278,7516,6522,1993,810,1978,994,6706,1.0,0.0,3,8.0,7,2,133,2464.0,0.39863327145576477,0.16647005081176758
5542751,4438979,5200672,7523,3008,1984,6305,1993,4515,1218,1.0,0.0,3,5.0,1,7,952,7.0,0.5355427265167236,0.3093743324279785
5542987,4382873,4207356,7523,2686,1983,1622,1980,4837,5901,0.0,0.0,8,10.0,2,5,91,784.0,0.2834930717945099,0.27722880244255066
5552052,5228997,4609722,7551,6410,1993,3897,1986,1141,3654,1.0,0.0,4,2.0,2,1,42,2968.0,0.37095919251441956,0.0590689517557621
5558335,5126717,4384315,7572,6025,1992,2693,1983,1547,4879,1.0,0.0,2,3.0,4,2,525,742.0,0.4082719385623932,0.2501310408115387
5560079,4110867,4321762,7579,978,1978,2280,1982,6601,5299,1.0,0.0,5,5.0,1,3,1883,182.0,0.6453430652618408,0.24616728723049164
5561901,5303850,5056437,7586,6683,1994,5766,1991,903,1820,0.0,0.0,5,2.0,7,25,140,1379.0,0.2273620218038559,0.20294837653636932
5563787,5323152,4157360,7586,6746,1994,1251,1979,840,6335,0.0,0.0,2,43.0,1,4,252,217.0,0.6455322504043579,-0.0034986662212759256
5562161,5407010,5020271,7586,7047,1995,5633,1991,539,1953,1.0,0.0,1,2.0,4,1,539,910.0,0.603951096534729,0.3027969002723694
5562415,4778340,4662022,7586,4674,1988,4142,1987,2912,3444,1.0,0.0,1,3.0,3,3,2912,1687.0,0.5343664884567261,0.41495150327682495
5562825,4925561,5122781,7586,5248,1990,6011,1992,2338,1575,1.0,0.0,3,3.0,6,2,1008,966.0,0.5652315616607666,0.15949897468090057
5566342,5331642,5302977,7593,6774,1994,6676,1994,819,917,1.0,0.0,8,2.0,7,5,147,525.0,0.22786201536655426,0.13433276116847992
5566720,4243724,5327002,7600,1832,1981,6760,1994,5768,840,0.0,0.0,13,1.0,1,3,133,840.0,0.45144158601760864,0.295653373003006
5567372,4644045,4310438,7600,4065,1987,2203,1982,3535,5397,0.0,0.0,38,5.0,3,1,56,1421.0,0.4589420258998871,0.3628236949443817
5569189,4913699,5310191,7607,5206,1990,6704,1994,2401,903,1.0,0.0,8,2.0,22,1,154,329.0,0.7147047519683838,0.19313541054725647
5570377,5230002,3997907,7607,6410,1993,348,1976,1197,7259,0.0,0.0,7,5.0,2,2,42,1491.0,0.6926254630088806,0.20558562874794006
5569575,5405732,4398934,7607,7040,1995,2784,1983,567,4823,1.0,0.0,3,1.0,2,1,21,4823.0,0.7394426465034485,0.3295416235923767
5569698,5171773,4055647,7607,6193,1992,663,1977,1414,6944,1.0,0.0,1,2.0,6,1,1414,2240.0,0.6892967820167542,0.16276231408119202
5571642,4946761,4464668,7614,5332,1990,3141,1984,2282,4473,1.0,0.0,4,9.0,6,2,609,98.0,0.3088706135749817,0.1770407110452652
5571415,4434250,5142371,7614,2980,1984,6081,1992,4634,1533,0.0,0.0,8,2.0,4,18,63,672.0,0.5290414094924927,0.012453140690922737
5574928,5155820,4796112,7621,6130,1992,4751,1989,1491,2870,1.0,0.0,7,5.0,22,1,49,903.0,0.5114234685897827,0.2038429230451584
5574342,4484114,4081973,7621,3246,1984,824,1978,4375,6797,1.0,0.0,7,5.0,5,2,7,4480.0,0.42548125982284546,0.24031707644462585
5578488,5314821,4066600,7635,6718,1994,733,1978,917,6902,0.0,0.0,6,14.0,17,2,0,210.0,0.4755362570285797,0.04504721239209175
5579449,5256863,4162607,7635,6508,1993,1307,1979,1127,6328,0.5,0.0,7,2.0,20,2,7,1190.0,0.20855508744716644,0.2565387785434723
5578330,5202072,4791381,7635,6312,1993,4730,1988,1323,2905,0.0,0.0,2,4.0,16,2,483,371.0,1.0000001192092896,-0.023136576637625694
5578502,4532372,4503202,7635,3498,1985,3351,1985,4137,4284,1.0,0.0,8,2.0,4,1,245,1743.0,0.4714595675468445,0.28258413076400757
5579919,4439810,4027325,7642,3008,1984,516,1977,4634,7126,0.5,0.0,3,12.0,4,1,609,112.0,0.378815233707428,0.25063201785087585
5580770,5057221,3997491,7642,5766,1991,348,1976,1876,7294,0.3333333333333333,0.0,7,3.0,17,1,7,4312.0,0.560312032699585,0.3468745946884155
5583543,5260697,5323815,7649,6522,1993,6753,1994,1127,896,1.0,0.0,7,3.0,10,4,35,133.0,0.6621707081794739,0.011245866306126118
5585779,5396216,4599719,7656,7005,1995,3841,1986,651,3815,1.0,0.0,3,12.0,3,3,119,238.0,0.45221850275993347,0.24759206175804138
5585872,4697895,4888975,7656,4296,1987,5108,1989,3360,2548,1.0,0.0,9,2.0,2,2,196,700.0,0.5491338968276978,0.21374447643756866
5587105,4400613,4418411,7663,2791,1983,2889,1983,4872,4774,0.0,0.0,12,9.0,6,4,42,147.0,0.13149385154247284,0.11220481246709824
5589799,5027080,4361609,7670,5654,1991,2525,1982,2016,5145,0.5,0.0,1,6.0,2,3,2016,175.0,0.3240531086921692,0.14352884888648987
5593794,5250905,4191959,7684,6487,1993,1524,1980,1197,6160,0.0,1.0,11,12.0,7,1,49,98.0,0.41000136733055115,0.23459869623184204
5596386,5056914,4498423,7691,5766,1991,3330,1985,1925,4361,0.0,0.0,6,7.0,13,5,497,651.0,0.5208988785743713,0.28905656933784485
5595046,5335477,5069428,7691,6795,1994,5815,1991,896,1876,1.0,0.0,7,1.0,12,3,21,1876.0,0.9045992493629456,0.3139446973800659
5601756,5239406,4059176,7712,6445,1993,691,1977,1267,7021,0.0,0.0,6,4.0,34,1,49,1813.0,0.37154603004455566,0.17642134428024292
5604300,5321974,4136593,7719,6746,1994,1125,1979,973,6594,1.0,0.0,1,2.0,5,1,973,4172.0,0.49152445793151855,0.17407380044460297
5603726,4931795,5051358,7719,5269,1990,5745,1991,2450,1974,0.0,0.0,2,1.0,1,6,812,1974.0,0.28613147139549255,0.20480886101722717
5604364,4518863,4375109,7719,3428,1985,2616,1983,4291,5103,1.0,0.0,22,8.0,4,10,630,3227.0,0.4893806278705597,0.11077844351530075
5611139,4873605,4558869,7747,5031,1989,3638,1985,2716,4109,0.0,0.0,4,20.0,17,4,91,287.0,0.43660905957221985,0.22577659785747528
5612167,4665005,4424218,7747,4149,1987,2924,1984,3598,4823,1.0,0.0,11,3.0,4,2,322,70.0,0.5786553025245667,0.19030921161174774
5612045,4406884,4094545,7747,2826,1983,894,1978,4921,6853,0.0,0.0,13,2.0,2,1,112,5257.0,0.40208303928375244,0.13647860288619995
5612884,4481604,4370749,7747,3232,1984,2581,1983,4515,5166,1.0,0.0,29,7.0,9,2,182,1029.0,0.3692111074924469,0.22598689794540405
5615235,4348768,4344170,7754,2441,1982,2413,1982,5313,5341,0.0,1.0,12,5.0,5,1,14,2940.0,0.6280485987663269,0.37028035521507263
5615282,4496989,4538581,7754,3316,1985,3533,1985,4438,4221,0.0,0.0,29,4.0,6,1,483,203.0,0.6032204627990723,0.07190245389938354
5616908,4825057,4372227,7761,4863,1989,2595,1983,2898,5166,1.0,0.0,31,8.0,5,1,7,868.0,0.45237040519714355,0.07126279920339584
5616994,5036264,5484663,7761,5689,1991,7320,1996,2072,441,1.0,0.0,13,1.0,6,17,497,441.0,0.6505056619644165,0.08320999145507812
5616418,5140065,4965279,7761,6074,1992,5409,1990,1687,2352,0.0,0.0,3,3.0,2,1,7,847.0,0.591501772403717,0.3120684325695038
5616879,4788896,4699063,7761,4723,1988,4303,1987,3038,3458,0.5,0.0,17,4.0,2,1,70,910.0,0.4378567934036255,0.03269464895129204
5623675,4858171,5168440,7782,4975,1989,6179,1992,2807,1603,1.0,0.0,3,1.0,11,1,763,1603.0,0.5116164088249207,0.18776673078536987
5629978,5481542,5084495,7803,7306,1996,5871,1992,497,1932,1.0,0.0,4,1.0,15,4,105,1932.0,0.5692564249038696,0.06699062138795853
5630485,4782925,4282182,7810,4695,1988,2042,1981,3115,5768,1.0,0.0,7,5.0,3,1,742,238.0,0.5781462788581848,0.21297693252563477
5633460,4479864,4847293,7817,3225,1984,4940,1989,4592,2877,0.0,0.0,1,3.0,2,3,4592,1694.0,0.5148876309394836,0.10844747722148895
5633806,5253181,4534866,7817,6494,1993,3512,1985,1323,4305,1.0,0.0,8,8.0,13,7,14,224.0,0.4319796562194824,0.037103522568941116
5633274,5385938,4218590,7817,6970,1995,1692,1980,847,6125,1.0,0.0,26,6.0,20,7,21,749.0,0.26853305101394653,0.0758974626660347
5635063,4749481,4006014,7824,4541,1988,397,1977,3283,7427,1.0,0.0,16,5.0,1,1,154,1169.0,0.5034339427947998,0.3296923339366913
5635634,5293741,4727554,7824,6648,1994,4436,1988,1176,3388,0.0,0.0,14,20.0,7,4,42,280.0,0.368777334690094,0.1398131549358368
5637248,4438324,4727488,7831,3001,1984,4436,1988,4830,3395,0.0,0.0,3,3.0,5,1,805,1344.0,0.4366374611854553,0.2833350896835327
5640542,5539901,5015627,7838,7509,1996,5612,1991,329,2226,1.0,0.0,1,6.0,18,4,329,189.0,0.6506959795951843,0.09072763472795486
5638643,5216852,4575752,7838,6368,1993,3722,1986,1470,4116,1.0,0.0,2,3.0,11,5,147,2156.0,0.5360010266304016,0.18537095189094543
5640823,4570400,4905941,7845,3701,1986,5178,1990,4144,2667,1.0,0.0,4,1.0,2,1,581,2667.0,0.5706092715263367,0.3638555109500885
5641548,4390683,4464668,7845,2735,1983,3141,1984,5110,4704,0.0,0.0,12,9.0,2,2,133,329.0,0.39047130942344666,0.039860259741544724
5640955,5564440,4130535,7845,7593,1996,1083,1978,252,6762,1.0,0.0,1,41.0,18,2,252,77.0,0.5492063164710999,0.14796820282936096
5643397,4784919,4729163,7852,4702,1988,4450,1988,3150,3402,1.0,0.0,8,2.0,5,6,91,1645.0,0.32649651169776917,0.26040762662887573
5644476,5018005,4900271,7852,5619,1991,5157,1990,2233,2695,0.0,0.0,27,17.0,5,3,0,63.0,0.4305857717990875,0.2799186110496521
5645366,4667530,4782292,7859,4163,1987,4688,1988,3696,3171,0.0,0.0,24,3.0,2,1,49,77.0,0.5255531668663025,0.26660606265068054
5646348,4699006,4058261,7859,4303,1987,684,1977,3556,7175,0.0,0.0,38,10.0,5,1,35,1428.0,0.4164496064186096,0.10787448287010193
5648812,4523752,4349620,7866,3456,1985,2448,1982,4410,5418,0.0,0.0,11,15.0,2,4,1057,14.0,0.4743373692035675,0.33340999484062195
5647100,5154086,5016977,7866,6130,1992,5619,1991,1736,2247,0.0,0.0,1,7.0,2,7,1736,259.0,0.5308024883270264,0.12438247352838516
5652743,4768180,4359645,7880,4625,1988,2511,1982,3255,5369,1.0,0.0,6,2.0,18,1,287,350.0,0.5706490278244019,0.10723759979009628
5653759,5474557,5231526,7887,7285,1995,6417,1993,602,1470,1.0,0.0,1,2.0,5,6,602,287.0,0.3256297707557678,0.16186149418354034
5653596,5451168,4424678,7887,7201,1995,2931,1984,686,4956,1.0,0.0,5,4.0,17,2,7,2884.0,0.4924757480621338,0.16976630687713623
5655667,4697689,4612113,7894,4296,1987,3911,1986,3598,3983,0.5,0.0,11,1.0,4,1,70,3983.0,0.6220253705978394,0.21025881171226501
5658533,4934827,4471987,7901,5283,1990,3183,1984,2618,4718,0.5,0.0,12,6.0,2,1,182,413.0,0.3276268541812897,0.28387558460235596
5657786,4793380,4453448,7901,4744,1988,3085,1984,3157,4816,0.5,0.0,3,3.0,1,4,189,420.0,0.4913278818130493,0.1507740318775177
5657490,5287561,4691096,7901,6627,1994,4261,1987,1274,3640,1.0,0.0,1,2.0,3,3,1274,2940.0,0.49140676856040955,0.1279461830854416
5662813,5173164,5405481,7915,6200,1992,7040,1995,1715,875,1.0,0.0,5,1.0,3,6,399,875.0,0.43175217509269714,0.17186881601810455
5665496,5385795,4099121,7922,6970,1995,915,1978,952,7007,1.0,0.0,5,9.0,4,1,77,420.0,0.8761032223701477,0.023448243737220764
5665442,4084980,5277364,7922,838,1978,6585,1994,7084,1337,0.0,0.0,29,2.0,2,2,0,819.0,0.4240438938140869,0.15920892357826233
5665208,4846935,4057724,7922,4940,1989,677,1977,2982,7245,1.0,0.0,1,4.0,7,1,2982,5957.0,0.7483833432197571,0.26252731680870056
5666497,5280590,4305164,7922,6592,1994,2175,1981,1330,5747,0.5,0.0,3,12.0,7,2,140,70.0,0.39167216420173645,0.18275834619998932
5668837,5084669,4129468,7929,5871,1992,1076,1978,2058,6853,0.0,0.0,12,26.0,12,3,21,595.0,0.4670097231864929,0.17421041429042816
5669949,4233042,4021481,7936,1776,1980,488,1977,6160,7448,1.0,0.0,18,9.0,3,2,154,1071.0,0.46429866552352905,0.07832331210374832
5672364,4605170,4800293,7943,3876,1986,4772,1989,4067,3171,0.0,0.0,9,4.0,3,10,105,266.0,0.3719572424888611,0.14289477467536926
5677854,4990877,5352614,7957,5514,1991,6851,1994,2443,1106,0.0,0.0,8,2.0,1,7,175,588.0,0.6705345511436462,0.13531441986560822
5679754,4558149,4093038,7964,3631,1985,887,1978,4333,7077,0.0,0.0,9,3.0,4,2,133,3318.0,0.5051566362380981,0.13391821086406708
5678425,5006137,4001806,7964,5577,1991,369,1977,2387,7595,1.0,0.0,10,11.0,15,1,28,2233.0,0.71052086353302,0.17808906733989716
5679210,5370654,4237937,7964,6914,1994,1804,1980,1050,6160,0.0,0.0,3,9.0,10,3,434,1554.0,0.3223402500152588,0.3996073007583618
5680910,4553634,5177842,7971,3610,1985,6221,1993,4361,1750,0.3333333333333333,0.0,7,3.0,7,4,1190,35.0,0.5965138673782349,0.2929438352584839
5683531,5226992,4618351,7978,6403,1993,3946,1986,1575,4032,0.0,0.0,24,4.0,19,1,7,2401.0,0.4854687750339508,0.28933367133140564
5683397,4467801,3982686,7978,3162,1984,271,1976,4816,7707,1.0,0.0,57,4.0,7,2,77,658.0,0.45998701453208923,0.3992745578289032
5682897,5558093,4555524,7978,7572,1996,3617,1985,406,4361,1.0,1.0,1,14.0,5,2,406,532.0,1.0,0.19048818945884705
5683843,4254195,4065924,7978,1888,1981,733,1978,6090,7245,1.0,0.0,7,8.0,1,1,7,609.0,0.372928649187088,0.05955108627676964
5684350,4947069,4871381,7978,5332,1990,5024,1989,2646,2954,1.0,0.0,2,4.0,1,2,1428,749.0,0.45624926686286926,0.36251863837242126
5685562,5431103,5349844,7985,7131,1995,6844,1994,854,1141,0.0,0.0,11,1.0,9,4,7,1141.0,0.1994861364364624,0.12849761545658112
5686747,5582971,4026501,7985,7649,1996,516,1977,336,7469,1.0,0.0,1,3.0,16,1,336,4718.0,0.5387417078018188,0.2911861538887024
5689313,5293229,4308292,7992,6641,1994,2189,1981,1351,5803,0.0,0.0,17,5.0,7,3,63,2744.0,0.5352746844291687,0.23855213820934296
5692206,5140650,4097491,7999,6074,1992,908,1978,1925,7091,1.0,0.0,27,2.0,5,1,0,5635.0,0.2245919555425644,0.15607641637325287
5696528,5216413,4908147,8013,6361,1993,5185,1990,1652,2828,1.0,0.0,12,3.0,46,12,133,952.0,0.43292784690856934,0.2578285336494446
5694968,5028244,4425306,8013,5661,1991,2931,1984,2352,5082,0.0,0.0,24,2.0,11,2,21,3640.0,0.5484916567802429,0.2718561291694641
5696863,4223226,4321944,8013,1720,1980,2280,1982,6293,5733,0.2,0.0,41,2.0,1,1,637,3731.0,0.5560187101364136,0.18905285000801086
5697641,4262931,5138377,8020,1937,1981,6067,1992,6083,1953,1.0,0.0,33,8.0,1,12,14,532.0,0.5246344804763794,-0.015290745534002781
5697861,4976671,4765596,8020,5458,1990,4618,1988,2562,3402,0.5,0.0,3,3.0,4,1,28,987.0,0.3218572437763214,0.2737630009651184
5704182,5617688,5588099,8041,7768,1997,7663,1996,273,378,1.0,0.0,1,1.0,8,3,273,378.0,0.6279574036598206,0.15911976993083954
5708507,4204770,4869359,8048,1608,1980,5017,1989,6440,3031,1.0,0.0,2,6.0,2,4,4536,798.0,0.4355059564113617,0.11374346911907196
5706998,4480640,4991860,8048,3232,1984,5521,1991,4816,2527,1.0,0.0,20,3.0,1,1,21,490.0,0.5644224882125854,0.3414451777935028
5710551,4911327,5341325,8055,5199,1990,6809,1994,2856,1246,0.0,0.0,14,3.0,6,5,196,364.0,0.6178472638130188,0.16039696335792542
5710111,4971709,4274342,8055,5437,1990,2000,1981,2618,6055,0.5,0.0,5,7.0,1,2,42,798.0,0.15099918842315674,0.07100005447864532
5709171,4836141,4681121,8055,4905,1989,4219,1987,3150,3836,1.0,0.0,3,1.0,3,4,1197,3836.0,0.5298219323158264,0.23696696758270264
5710682,5491605,4682349,8055,7348,1996,4219,1987,707,3836,1.0,0.0,3,6.0,6,5,35,553.0,0.5394290089607239,0.20372793078422546
5716502,4895739,5210506,8076,5136,1990,6340,1993,2940,1736,1.0,0.0,21,3.0,4,6,91,119.0,0.4056907594203949,0.30315718054771423
5717541,5212679,4150060,8076,6347,1993,1202,1979,1729,6874,1.0,0.0,6,1.0,4,1,385,6874.0,0.5119988322257996,0.17830759286880493
5718027,5364661,4544132,8083,6893,1994,3561,1985,1190,4522,0.5,0.0,1,1.0,6,1,1190,4522.0,0.4712706208229065,0.3115811049938202
5718682,5137529,5488297,8083,6067,1992,7334,1996,2016,749,1.0,0.0,11,2.0,22,16,14,105.0,0.654421865940094,0.0906720831990242
5718976,5064801,4641980,8083,5794,1991,4058,1987,2289,4025,0.0,0.0,6,26.0,1,4,252,119.0,0.04903921112418175,0.26356691122055054
5721316,5149895,4274191,8090,6109,1992,2000,1981,1981,6090,0.5,0.0,33,2.0,27,2,56,2891.0,0.3566376268863678,0.1719599813222885
5724206,5434727,4245545,8097,7138,1995,1846,1981,959,6251,1.0,0.0,2,22.0,5,3,147,63.0,0.5180226564407349,0.20491927862167358
5724588,5517645,4049999,8097,7439,1996,628,1977,658,7469,1.0,0.0,1,2.0,3,1,658,5138.0,0.5043152570724487,0.29168251156806946
5724822,5152152,5185151,8104,6123,1992,6249,1993,1981,1855,1.0,0.0,8,2.0,9,20,147,1372.0,0.44258102774620056,0.13445226848125458
5724790,4725009,4058014,8104,4429,1988,684,1977,3675,7420,0.0,0.0,17,5.0,1,1,315,2555.0,0.09032411873340607,0.21581028401851654
5729742,5519861,5462972,8111,7446,1996,7243,1995,665,868,1.0,0.0,2,2.0,4,11,413,168.0,0.517132043838501,0.041086141020059586
5731671,4804892,4061352,8118,4793,1989,705,1977,3325,7413,0.5,0.0,12,4.0,9,1,147,196.0,0.22547264397144318,-0.027171717956662178
5731823,4835551,4089246,8118,4898,1989,866,1978,3220,7252,0.0,0.0,12,14.0,7,1,154,637.0,0.4712226390838623,0.26925134658813477
5730700,4991564,5130579,8118,5521,1991,6039,1992,2597,2079,1.0,0.0,48,6.0,9,1,21,7.0,0.3684174418449402,0.27832916378974915
5730122,5301667,4443154,8118,6676,1994,3029,1984,1442,5089,0.3333333333333333,0.0,6,1.0,3,9,112,5089.0,0.49713754653930664,0.0988398939371109
5731281,5593958,4058175,8118,7684,1997,684,1977,434,7434,1.0,0.0,2,6.0,10,1,42,1708.0,0.9258973002433777,0.1837826818227768
5732896,4206881,4750849,8125,1622,1980,4548,1988,6503,3577,1.0,0.0,4,2.0,1,2,252,1659.0,0.5053600668907166,0.28738027811050415
5737550,5119485,3978357,8132,5997,1992,243,1976,2135,7889,1.0,0.0,65,8.0,13,2,56,1617.0,0.6385992765426636,0.14667674899101257
5738016,4503778,4523467,8139,3358,1985,3456,1985,4781,4683,0.0,0.0,16,3.0,2,2,273,567.0,0.5455479025840759,0.14407071471214294
5739881,5594568,4648031,8139,7684,1997,4079,1987,455,4060,1.0,0.0,1,21.0,41,2,455,28.0,0.8633143305778503,0.16274921596050262
5741322,4291707,4035077,8146,2098,1981,558,1977,6048,7588,1.0,0.0,66,5.0,3,3,98,4473.0,0.662916362285614,0.20392495393753052
5742680,4796032,4436255,8146,4751,1989,2994,1984,3395,5152,0.0,0.0,16,15.0,5,3,483,777.0,0.45971453189849854,0.20511633157730103
5741462,5311039,3978201,8146,6704,1994,243,1976,1442,7903,0.0,0.3333333333333333,5,9.0,8,1,49,693.0,0.5309735536575317,0.2529502213001251
5743196,5237938,4535235,8153,6445,1993,3512,1985,1708,4641,1.0,0.0,6,18.0,3,2,42,273.0,0.5808457136154175,0.31986817717552185
5743841,4376673,5465731,8153,2630,1983,7257,1995,5523,896,0.0,0.0,10,2.0,1,21,7,287.0,0.2129836529493332,0.2780500650405884
5748677,5469452,4037313,8160,7264,1995,572,1977,896,7588,0.0,0.0,3,3.0,7,1,21,5600.0,0.44543251395225525,0.10890290886163712
5748467,4441151,4378021,8160,3015,1984,2644,1983,5145,5516,1.0,0.0,13,9.0,1,1,161,560.0,0.5406690835952759,0.3152315616607666
5747728,5051786,5391057,8160,5745,1991,6991,1995,2415,1169,1.0,0.0,6,1.0,16,2,420,1169.0,0.3298892080783844,0.03088776022195816
5748240,5420643,5093822,8160,7089,1995,5906,1992,1071,2254,1.0,0.0,2,14.0,9,3,7,126.0,0.44223183393478394,0.26850804686546326
5747170,5496643,4386919,8160,7369,1996,2714,1983,791,5446,0.3333333333333333,0.0,1,6.0,6,1,791,98.0,0.8065168857574463,-7.974264008225873e-05
5745917,5465428,4973014,8160,7257,1995,5444,1990,903,2716,0.5,0.0,7,4.0,13,8,7,1666.0,0.4645193815231323,0.18618400394916534
5751301,4313124,4111825,8167,2217,1982,978,1978,5950,7189,0.0,0.0,409,10.0,2,2,7,1974.0,0.5489469766616821,0.25798499584198
5752015,4521858,5365681,8167,3442,1985,6900,1994,4725,1267,1.0,0.0,13,1.0,33,1,252,1267.0,0.503397524356842,0.27285414934158325
5751945,5367705,5460353,8167,6900,1994,7236,1995,1267,931,1.0,0.0,8,3.0,14,6,7,371.0,0.27609872817993164,0.2924421429634094
5751958,4931944,4501467,8167,5269,1990,3344,1985,2898,4823,0.0,0.0,12,2.0,5,3,14,735.0,0.0792548730969429,0.26294058561325073
5752492,5694910,4529607,8174,8013,1997,3484,1985,161,4690,1.0,0.0,1,12.0,9,3,161,7.0,0.8063904643058777,0.033590998500585556
5752511,5172688,5404264,8174,6200,1992,7033,1995,1974,1141,1.0,0.0,5,1.0,7,4,42,1141.0,0.35011786222457886,0.12009171396493912
5755070,4373314,4353435,8181,2602,1983,2476,1982,5579,5705,1.0,0.0,13,3.0,2,2,238,2051.0,0.6904076337814331,0.28193411231040955
5757584,5204793,4317021,8181,6319,1993,2245,1982,1862,5936,1.0,0.0,14,16.0,1,5,0,28.0,0.529098391532898,0.25810322165489197
5761723,5163140,4352524,8188,6158,1992,2469,1982,2030,5719,1.0,0.0,27,11.0,21,2,28,28.0,0.5896854996681213,0.14041775465011597
5760477,5506450,4388159,8188,7404,1996,2721,1983,784,5467,1.0,0.0,1,5.0,4,1,784,245.0,0.4076519012451172,0.3206190764904022
5761525,5526018,4393199,8188,7467,1996,2749,1983,721,5439,0.0,0.0,1,41.0,8,1,721,28.0,0.20503588020801544,0.10052276402711868
5758616,5481461,5533282,8188,7306,1996,7495,1996,882,693,1.0,0.0,5,2.0,22,6,77,77.0,0.5470947027206421,0.23218564689159393
5761391,5347459,4343441,8188,6830,1994,2413,1982,1358,5775,0.0,0.0,3,5.0,10,1,448,133.0,0.4099865257740021,0.21701472997665405
5763848,4553002,4887397,8195,3603,1985,5101,1989,4592,3094,1.0,0.0,6,5.0,3,5,21,889.0,0.5280094146728516,0.3937877118587494
5764574,5455798,5432125,8195,7215,1995,7131,1995,980,1064,1.0,0.0,6,2.0,4,2,42,189.0,0.6552110910415649,0.45953619480133057
5763086,5662738,4872057,8195,7915,1997,5024,1989,280,3171,0.0,0.0,1,5.0,9,2,280,301.0,0.845485270023346,0.19002604484558105
5769508,5452948,5035664,8209,7208,1995,5689,1991,1001,2520,1.0,0.0,4,1.0,5,9,7,2520.0,0.47713586688041687,0.22878533601760864
5769374,4693443,4146186,8209,4275,1987,1181,1979,3934,7028,1.0,0.0,25,3.0,3,2,49,133.0,0.3983662724494934,0.42736274003982544
5775367,5197508,5099883,8223,6298,1993,5934,1992,1925,2289,1.0,1.0,4,6.0,3,3,287,819.0,0.5141149163246155,0.1282016932964325
5777696,5621486,5464554,8223,7775,1997,7250,1995,448,973,1.0,0.0,2,1.0,14,7,70,973.0,0.6731622815132141,0.17251579463481903
5777925,5717635,5020617,8223,8076,1998,5633,1991,147,2590,0.0,0.0,1,4.0,12,1,147,56.0,0.6412240266799927,0.0656002014875412
5776190,5147388,4415892,8223,6102,1992,2875,1983,2121,5348,1.0,0.0,6,8.0,7,3,42,3563.0,0.5571615695953369,0.08350695669651031
5775491,5379890,5223414,8223,6949,1995,6389,1993,1274,1834,1.0,0.0,2,3.0,3,4,413,805.0,0.5010941028594971,-0.00780165521427989
5777354,4988636,4374821,8223,5507,1991,2609,1983,2716,5614,1.0,0.0,6,15.0,7,2,35,1554.0,0.6107862591743469,0.25098493695259094
5775858,5454672,4079616,8223,7215,1995,810,1978,1008,7413,0.5,0.0,2,3.0,18,1,14,2051.0,0.5881786942481995,0.3512643277645111
5779910,5653886,4949859,8230,7887,1997,5346,1990,343,2884,0.0,0.0,1,2.0,19,3,343,2163.0,0.45071253180503845,0.21657468378543854
5782715,4987985,5270988,8237,5507,1991,6557,1993,2730,1680,1.0,0.0,1,3.0,7,14,2730,672.0,0.6503854393959045,0.0164919625967741
5785485,5040814,4142534,8244,5710,1991,1160,1979,2534,7084,0.0,0.0,1,11.0,7,1,2534,245.0,0.4327598214149475,0.14255885779857635
5790697,4913295,4764314,8251,5206,1990,4611,1988,3045,3640,0.0,0.0,5,9.0,8,5,301,210.0,0.28355440497398376,0.17835822701454163
5790418,4821137,4790442,8251,4849,1989,4730,1988,3402,3521,1.0,0.0,5,6.0,4,11,217,602.0,0.4383920729160309,0.01764618046581745
5790304,4591514,5523883,8251,3799,1986,7460,1996,4452,791,0.0,0.5,3,1.0,2,1,511,791.0,0.39586225152015686,0.1971098780632019
5787933,5368075,5505912,8251,6907,1994,7404,1996,1344,847,0.0,0.0,1,1.0,1,18,1344,847.0,0.6866327524185181,0.14681385457515717
5793921,4988834,4157981,8258,5507,1991,1258,1979,2751,7000,0.0,0.0,9,7.0,8,2,0,665.0,0.4166463017463684,-3.4183263778686523e-05
5793300,4881148,5163933,8258,5066,1989,6165,1992,3192,2093,0.0,0.0,42,2.0,4,17,7,1302.0,0.5634753108024597,0.006812272127717733
5795877,5449761,4091787,8265,7194,1995,880,1978,1071,7385,1.0,0.0,7,12.0,14,1,14,973.0,0.29421159625053406,0.09774579107761383
5796708,5155719,4027593,8265,6130,1992,523,1977,2135,7742,1.0,0.0,3,5.0,3,2,854,3304.0,0.6107518076896667,0.24224291741847992
5795792,4326332,4157560,8265,2308,1982,1251,1979,5957,7014,1.0,1.0,20,1.0,6,2,196,7014.0,0.4764416813850403,0.42474013566970825
5797877,4581390,4591652,8272,3750,1986,3799,1986,4522,4473,0.5,0.0,22,6.0,3,1,224,1232.0,0.44689661264419556,0.236031174659729
5798786,5526045,4745154,8272,7467,1996,4520,1988,805,3752,1.0,0.0,1,6.0,12,25,805,42.0,0.4100397825241089,0.05869557708501816
5797395,5156154,5548783,8272,6137,1992,7537,1996,2135,735,1.0,0.0,4,3.0,8,4,1043,196.0,0.3774065673351288,0.12579531967639923
5801368,5179504,5568447,8279,6221,1993,7600,1996,2058,679,0.0,0.0,6,1.0,4,3,133,679.0,0.5069189071655273,0.38898351788520813
5800874,5492722,4219782,8279,7355,1996,1699,1980,924,6580,1.0,0.0,7,4.0,7,1,49,4774.0,0.6511356830596924,0.21563459932804108
5802100,5030101,5237489,8279,5668,1991,6438,1993,2611,1841,0.0,0.0,4,2.0,7,1,315,707.0,0.514925479888916,0.26420649886131287
5803453,5511784,5536942,8286,7425,1996,7502,1996,861,784,1.0,0.0,5,1.0,15,3,42,784.0,0.30178022384643555,0.20094138383865356
5804422,5474957,5409407,8286,7285,1995,7054,1995,1001,1232,1.0,1.0,9,1.0,8,12,7,1232.0,0.5413196682929993,0.2397339642047882
5802974,5270769,4037065,8286,6557,1993,565,1977,1729,7721,0.0,0.0,4,8.0,8,1,147,3647.0,0.3287123143672943,0.16719402372837067
5806055,5471119,4068923,8286,7271,1995,747,1978,1015,7539,0.5,0.0,3,15.0,11,3,182,175.0,0.3940173089504242,0.15938915312290192
5806057,5261091,4961817,8286,6522,1993,5395,1990,1764,2891,1.0,0.0,7,6.0,3,2,0,385.0,0.3023229241371155,0.26953598856925964
5803955,4334897,5585947,8286,2357,1982,7656,1996,5929,630,1.0,0.0,11,3.0,1,20,217,49.0,0.5116642713546753,0.3654036819934845
5808352,4165517,4671616,8293,1328,1979,4177,1987,6965,4116,1.0,0.0,10,5.0,2,5,1561,1372.0,0.4289281666278839,0.40575698018074036
5809405,5261121,4375507,8293,6522,1993,2616,1983,1771,5677,0.0,0.0,12,3.0,6,2,28,756.0,0.5317457318305969,0.32420673966407776
5809204,4908713,4070008,8293,5185,1990,754,1978,3108,7539,1.0,0.0,47,17.0,11,1,0,777.0,0.39699506759643555,0.11480215191841125
5807430,5316855,4380426,8293,6725,1994,2665,1983,1568,5628,0.0,0.0,4,7.0,2,2,42,2996.0,0.41246187686920166,0.1937853991985321
5813861,4646350,4556779,8307,4072,1987,3624,1985,4235,4683,0.0,0.0,15,13.0,2,1,553,1337.0,0.41890761256217957,0.2772010564804077
5813062,4592099,4672978,8307,3806,1986,4184,1987,4501,4123,1.0,0.0,6,1.0,7,3,1120,4123.0,0.5420196056365967,0.2769218385219574
5818229,5361028,5520187,8314,6879,1994,7453,1996,1435,861,1.0,0.0,11,1.0,5,4,14,861.0,0.6401638984680176,0.31731313467025757
5819285,5572643,4768017,8314,7614,1996,4625,1988,700,3689,1.0,0.0,53,9.0,19,2,0,161.0,0.3853960335254669,0.21815632283687592
5817255,5618872,5333765,8314,7768,1997,6788,1994,546,1526,0.0,0.0,2,1.0,8,4,98,1526.0,0.3597564101219177,0.039226233959198
5818192,5363032,5152023,8314,6886,1994,6123,1992,1428,2191,0.0,0.0,4,11.0,45,6,147,350.0,0.5809915661811829,0.13652126491069794
5815949,4619055,4100150,8314,3953,1986,922,1978,4361,7392,1.0,0.0,6,4.0,8,1,14,469.0,0.37594783306121826,0.08981114625930786
5818432,4772883,4167861,8314,4646,1988,1356,1979,3668,6958,1.0,0.0,5,9.0,4,1,140,1309.0,0.29093992710113525,0.2527819275856018
5817901,4883846,4394946,8314,5080,1989,2763,1983,3234,5551,0.0,0.0,3,3.0,1,2,1323,2191.0,0.22208409011363983,0.28666195273399353
5825519,5307428,4836308,8328,6690,1994,4905,1989,1638,3423,0.0,0.0,7,11.0,4,2,252,490.0,0.49091827869415283,0.1971033662557602
5828734,4763191,4708597,8335,4604,1988,4345,1987,3731,3990,1.0,0.0,92,2.0,10,2,7,609.0,0.5559501647949219,0.15277011692523956
5826776,4700693,4333172,8335,4310,1987,2343,1982,4025,5992,1.0,0.0,21,2.0,1,1,161,679.0,0.4717458486557007,0.2608116567134857
5828262,4612462,5309000,8335,3911,1986,6697,1994,4424,1638,1.0,0.0,12,3.0,11,4,14,112.0,0.5624899864196777,0.23198164999485016
5831111,5136077,4496948,8342,6060,1992,3316,1985,2282,5026,1.0,0.0,3,1.0,4,3,476,5026.0,0.6358039379119873,0.2542453408241272
5830314,4878535,4992885,8342,5059,1989,5521,1991,3283,2821,0.3333333333333333,0.0,4,11.0,5,7,770,63.0,0.34898412227630615,0.18368303775787354
5835934,4816700,5053674,8349,4835,1989,5752,1991,3514,2597,0.0,0.0,24,4.0,4,7,49,665.0,0.09381724894046783,0.16774381697177887
5833562,4964842,5541931,8349,5409,1990,7516,1996,2940,833,1.0,0.0,5,2.0,7,10,49,287.0,0.3953898549079895,0.16956007480621338
5835009,4562421,4835186,8349,3652,1985,4898,1989,4697,3451,1.0,0.0,8,3.0,7,4,777,42.0,0.38675305247306824,0.06647207587957382
5833564,5711736,4785333,8349,8062,1998,4702,1988,287,3647,1.0,0.0,1,1.0,1,2,287,3647.0,0.43104350566864014,0.10371512919664383
5832666,5448856,4826365,8349,7194,1995,4870,1989,1155,3479,1.0,0.0,2,3.0,1,15,679,644.0,0.3931262195110321,0.13432307541370392
5834037,5038468,4697365,8349,5703,1991,4296,1987,2646,4053,0.5,0.0,7,6.0,5,1,518,1645.0,0.5140348076820374,0.40173691511154175
5832625,4625430,4693840,8349,3988,1986,4275,1987,4361,4074,0.0,0.0,28,7.0,3,9,126,1407.0,0.6219683885574341,0.22204753756523132
5836204,4913281,4783773,8356,5206,1990,4695,1988,3150,3661,0.5,0.0,4,9.0,1,6,49,693.0,0.3681494891643524,0.18816877901554108
5836498,4940347,4345055,8356,5304,1990,2420,1982,3052,5936,0.0,0.0,10,5.0,4,4,245,1414.0,0.25843387842178345,0.025454290211200714
5841873,5363448,4378762,8363,6886,1994,2651,1983,1477,5712,1.0,0.0,20,1.0,10,1,91,5712.0,0.4001903235912323,0.10082152485847473
5841239,4503363,4069031,8363,3351,1985,747,1978,5012,7616,0.0,0.0,20,2.0,2,1,126,6776.0,0.5340376496315002,0.12220942974090576
5841886,4943973,4694350,8363,5318,1990,4275,1987,3045,4088,0.0,0.0,40,8.0,7,6,21,259.0,0.3282835781574249,0.21785257756710052
5843182,4798611,4207216,8370,4765,1989,1622,1980,3605,6748,1.0,0.0,12,2.0,4,1,0,6391.0,0.4750726819038391,0.20789329707622528
5843590,4605600,4261727,8370,3876,1986,1930,1981,4494,6440,1.0,0.0,2,4.0,1,5,1232,728.0,0.48807206749916077,-0.030839111655950546
5843041,5197953,4319260,8370,6298,1993,2259,1982,2072,6111,1.0,0.0,14,9.0,12,1,14,98.0,0.7229791879653931,0.22241394221782684
5845504,5669221,5488004,8377,7936,1997,7334,1996,441,1043,1.0,0.0,1,2.0,2,9,441,455.0,0.8203737735748291,0.06047440320253372
5850616,5742917,5602559,8384,8146,1998,7712,1997,238,672,1.0,0.0,1,2.0,6,11,238,406.0,0.6562492251396179,0.18403840065002441
5850400,5425027,4433853,8384,7103,1995,2980,1984,1281,5404,1.0,0.0,29,6.0,57,2,56,399.0,0.5834529399871826,0.13763990998268127
5849000,5350370,4184662,8384,6844,1994,1482,1980,1540,6902,1.0,0.0,16,4.0,24,1,14,1260.0,0.4658215343952179,0.3089318871498108
5849881,5155037,4109387,8384,6130,1992,971,1978,2254,7413,1.0,0.0,10,7.0,3,1,182,3192.0,0.3589652180671692,-0.005311999935656786
5849655,4724255,4769597,8384,4422,1988,4632,1988,3962,3752,0.5,0.0,4,8.0,5,5,70,133.0,0.7719698548316956,0.053673096001148224
5851585,4968454,4700081,8391,5423,1990,4303,1987,2968,4088,0.0,0.0,15,7.0,8,13,105,735.0,0.45490193367004395,0.0634208470582962
5851935,5246772,4399993,8391,6473,1993,2791,1983,1918,5600,0.5,0.0,7,4.0,6,2,21,1141.0,0.5966112017631531,0.11612756550312042
5851246,4385905,4190476,8391,2707,1983,1517,1980,5684,6874,1.0,0.0,4,1.0,2,1,497,6874.0,0.6798831820487976,0.3631892204284668
5856839,5159348,4373278,8405,6144,1992,2602,1983,2261,5803,1.0,0.0,14,3.0,16,4,28,49.0,0.689696729183197,0.14694719016551971
5855934,4917593,4799046,8405,5220,1990,4765,1989,3185,3640,1.0,0.0,3,1.0,4,7,140,3640.0,0.7212396264076233,0.18036149442195892
5855901,4673574,4292159,8405,4184,1987,2098,1981,4221,6307,0.5,0.0,30,8.0,7,1,28,2758.0,0.48846134543418884,0.2157907485961914
5856280,4786424,4324464,8405,4709,1988,2294,1982,3696,6111,1.0,0.0,2,3.0,5,1,847,28.0,0.31652718782424927,-0.03851466625928879
5857698,5098123,4215271,8412,5927,1992,1671,1980,2485,6741,1.0,0.0,6,6.0,9,1,504,1638.0,0.5004859566688538,0.11619636416435242
5859891,5239591,5490417,8412,6445,1993,7348,1996,1967,1064,0.0,1.0,11,1.0,6,3,448,1064.0,0.58649742603302,0.17184849083423615
5859073,5747606,4006107,8412,8160,1998,397,1977,252,8015,1.0,0.0,1,4.0,13,1,252,2702.0,0.5458946824073792,0.2688738703727722
5859372,4876524,5560354,8412,5045,1989,7579,1996,3367,833,1.0,0.0,6,2.0,3,13,168,308.0,0.4641264081001282,0.24417027831077576
5861818,5396229,4403717,8419,7005,1995,2812,1983,1414,5607,1.0,0.0,1,3.0,8,4,1414,357.0,0.6356011033058167,0.13123610615730286
5864490,5339213,4026280,8426,6802,1994,516,1977,1624,7910,0.5,0.0,5,1.0,4,1,56,7910.0,0.5936808586120605,0.1104804277420044
5863876,4861511,5334018,8426,4989,1989,6788,1994,3437,1638,0.3333333333333333,0.0,7,1.0,1,4,189,1638.0,0.6187193393707275,0.2322019785642624
5863460,4476870,5047954,8426,3211,1984,5731,1991,5215,2695,0.0,0.0,100,3.0,5,5,14,357.0,0.4504722058773041,0.18063917756080627
5862582,5106429,5357446,8426,5955,1992,6865,1994,2471,1561,0.0,0.0,8,1.0,9,2,77,1561.0,0.3705771267414093,0.37521153688430786
5870538,5448621,4858197,8440,7187,1995,4975,1989,1253,3465,1.0,0.0,15,11.0,22,3,7,28.0,0.19230668246746063,0.39027512073516846
5868531,4606679,4375393,8440,3883,1986,2616,1983,4557,5824,0.5,0.0,5,4.0,5,1,1953,224.0,0.5026545524597168,0.22786115109920502
5871250,4777445,4655579,8447,4667,1988,4114,1987,3780,4333,0.0,0.0,8,12.0,1,4,35,1407.0,0.39787378907203674,0.245705708861351
5873895,4872459,4426392,8454,5031,1989,2938,1984,3423,5516,1.0,1.0,11,3.0,3,1,147,273.0,0.6090457439422607,0.08763717859983444
5873481,5683030,5389104,8454,7978,1997,6984,1995,476,1470,1.0,0.0,1,5.0,5,8,476,420.0,0.3894437551498413,0.27114126086235046
5874644,5284981,4880387,8454,6613,1994,5066,1989,1841,3388,1.0,0.0,5,7.0,3,1,413,336.0,0.550017237663269,0.09962664544582367
5876859,4603474,4343132,8461,3869,1986,2413,1982,4592,6048,0.0,0.0,5,7.0,3,1,1918,133.0,0.4871545433998108,0.401063472032547
5876653,4293609,4727488,8461,2105,1981,4436,1988,6356,4025,0.0,0.0,16,4.0,2,1,1057,329.0,0.4683334529399872,0.1524588018655777
5877140,5252770,4199952,8461,6494,1993,1580,1980,1967,6881,0.5,0.0,1,9.0,5,3,1967,4067.0,0.3431328237056732,0.1262558251619339
5877040,5479049,4507733,8461,7299,1995,3372,1985,1162,5089,1.0,0.0,6,4.0,3,7,91,455.0,0.2188415229320526,0.22696565091609955
5878715,5188078,5373423,8468,6263,1993,6921,1994,2205,1547,1.0,0.0,7,3.0,5,2,476,749.0,0.5259203314781189,0.12933751940727234
5878753,4303084,4066600,8468,2161,1981,733,1978,6307,7735,1.0,0.0,5,18.0,2,2,2191,133.0,0.5313381552696228,0.1935501992702484
5879106,5326189,4971904,8468,6760,1994,5437,1990,1708,3031,0.5,0.0,10,6.0,9,6,168,231.0,0.5626212954521179,0.03628115355968475
5879708,5045321,5000060,8468,5724,1991,5556,1991,2744,2912,1.0,0.0,7,20.0,5,8,140,14.0,0.9978886842727661,0.3240320384502411
5881866,4839474,4500324,8475,4912,1989,3337,1985,3563,5138,1.0,0.0,10,9.0,10,7,721,84.0,0.6220713257789612,-0.07174619287252426
5884642,4747544,5095203,8482,4534,1988,5913,1992,3948,2569,0.0,0.0,14,7.0,2,6,777,28.0,0.23141567409038544,0.1467006653547287
5886606,5252933,4086917,8482,6494,1993,852,1978,1988,7630,1.0,0.0,1,7.0,2,1,1988,315.0,0.45737335085868835,0.20198358595371246
5889506,5184115,5622191,8489,6242,1993,7782,1997,2247,707,1.0,0.0,6,1.0,4,4,49,707.0,0.3605862557888031,0.23908433318138123
5888161,4876920,5634584,8489,5052,1989,7824,1997,3437,665,1.0,0.0,5,1.0,9,127,1057,665.0,0.6404297947883606,0.264289915561676
5892222,4701394,5598148,8496,4310,1987,7698,1997,4186,798,0.0,0.0,8,4.0,10,5,364,210.0,0.5149685740470886,0.13208508491516113
5890595,4076123,5060656,8496,789,1978,5780,1991,7707,2716,1.0,0.0,9,5.0,2,7,35,140.0,0.3333480954170227,0.11592382937669754
5894494,4691326,5659612,8503,4261,1987,7901,1997,4242,602,1.0,1.0,75,2.0,4,3,35,147.0,0.5950265526771545,0.16256755590438843
5893786,5114369,5478435,8503,5983,1992,7299,1995,2520,1204,1.0,0.0,4,6.0,6,2,623,14.0,0.4972885251045227,0.0206056609749794
5894889,5113938,4107369,8510,5983,1992,957,1978,2527,7553,1.0,0.0,48,3.0,7,1,63,6482.0,0.46669280529022217,0.2850283086299896
5898154,4767920,4085775,8517,4625,1988,845,1978,3892,7672,1.0,0.0,17,6.0,1,4,245,1491.0,0.30045491456985474,0.1518395096063614
5900757,5473767,4755396,8524,7278,1995,4569,1988,1246,3955,0.0,0.0,10,10.0,7,5,161,630.0,0.597383439540863,0.14240361750125885
5901359,5469496,4441631,8524,7264,1995,3022,1984,1260,5502,1.0,0.0,17,1.0,77,2,0,5502.0,0.618833065032959,0.20215244591236115
5900062,5684669,5050672,8524,7978,1997,5745,1991,546,2779,0.5,0.0,1,4.0,8,11,546,805.0,0.5237899422645569,0.2508207857608795
5899203,5255685,5651064,8524,6508,1993,7873,1997,2016,651,0.0,0.0,2,2.0,4,19,441,56.0,0.36176154017448425,0.15663380920886993
5901739,4746147,4531434,8531,4527,1988,3498,1985,4004,5033,1.0,0.0,9,2.0,4,2,497,1869.0,0.3852944076061249,0.24437470734119415
5903722,5109434,5660541,8531,5962,1992,7908,1997,2569,623,1.0,0.0,7,1.0,11,16,84,623.0,0.45561307668685913,0.27939778566360474
5904298,4955547,4955312,8538,5367,1990,5367,1990,3171,3171,1.0,0.0,6,5.0,5,1,7,462.0,0.41768941283226013,0.21252495050430298
5905433,5090779,5012622,8538,5899,1992,5605,1991,2639,2933,0.0,0.0,3,6.0,2,4,140,574.0,0.38344550132751465,0.07366038858890533
5906569,5340638,4450883,8545,6809,1994,3071,1984,1736,5474,0.5,0.0,6,2.0,1,4,28,4809.0,0.5640566945075989,0.33703139424324036
5907959,4704148,5472706,8552,4324,1987,7278,1995,4228,1274,1.0,0.0,30,6.0,5,4,21,350.0,0.7222907543182373,0.29960453510284424
5907942,5460861,4155245,8552,7236,1995,1237,1979,1316,7315,0.3333333333333333,0.0,7,5.0,5,1,21,791.0,0.5481313467025757,0.16033467650413513
5909715,5379711,4578674,8559,6949,1995,3736,1986,1610,4823,1.0,0.0,1,49.0,5,5,1610,105.0,0.5851314663887024,0.11674809455871582
5913013,4449198,4009175,8566,3057,1984,418,1977,5509,8148,0.5,0.0,33,3.0,8,1,126,6447.0,0.6004753708839417,0.14708207547664642
5911564,4415313,5231070,8566,2875,1983,6417,1993,5691,2149,1.0,0.0,4,6.0,2,2,343,252.0,0.42018160223960876,0.15087439119815826
5913709,4274634,4560726,8573,2000,1981,3645,1985,6573,4928,1.0,0.0,6,3.0,1,4,1925,497.0,0.34264132380485535,0.19350816309452057
5915210,4506384,4285601,8573,3365,1985,2063,1981,5208,6510,1.0,0.0,15,7.0,2,1,14,343.0,0.5269944071769714,0.17527088522911072
5916359,4898842,5426113,8580,5150,1990,7110,1995,3430,1470,0.0,0.0,14,1.0,9,4,168,1470.0,0.3699451982975006,0.25071272253990173
5920030,4934457,4925861,8587,5283,1990,5248,1990,3304,3339,0.0,0.0,7,8.0,2,1,630,672.0,0.40427079796791077,0.14370910823345184
5920714,4563738,4609263,8587,3659,1986,3897,1986,4928,4690,1.0,0.0,14,2.0,5,2,1008,791.0,0.5018355250358582,0.2256312370300293
5923897,5563865,5656725,8594,7586,1996,7894,1997,1008,700,0.0,0.0,3,2.0,3,3,231,385.0,0.4228203594684601,0.16492564976215363
5922304,5013556,5532917,8594,5605,1991,7488,1996,2989,1106,1.0,0.0,56,3.0,5,8,42,385.0,0.14139766991138458,-0.057447195053100586
5922635,5288685,4293046,8594,6627,1994,2105,1981,1967,6489,0.5,0.0,3,16.0,5,1,980,273.0,0.5740450620651245,0.0075349146500229836
5925299,4497930,5311813,8601,3323,1985,6711,1994,5278,1890,0.0,0.0,35,4.0,5,7,14,210.0,0.47232046723365784,0.35624706745147705
5924936,4736951,4930115,8601,4485,1988,5262,1990,4116,3339,1.0,0.0,12,6.0,2,5,175,658.0,0.5569078326225281,0.07131845504045486
5928587,5173310,4826964,8608,6200,1992,4870,1989,2408,3738,0.0,0.0,4,2.0,6,7,329,2317.0,0.7115111351013184,0.030894175171852112
5928006,4993960,5404264,8608,5528,1991,7033,1995,3080,1575,1.0,0.0,4,2.0,4,4,448,420.0,0.5675119161605835,0.41446593403816223
5927240,5422632,4354532,8608,7096,1995,2483,1982,1512,6125,0.25,0.0,6,3.0,12,1,287,2674.0,0.507257342338562,0.3268495798110962
5930877,5489252,4292306,8615,7341,1996,2098,1981,1274,6517,1.0,0.0,14,5.0,2,10,77,539.0,0.5944814085960388,0.2170535773038864
5933175,4920362,4231362,8615,5227,1990,1769,1980,3388,6846,0.0,0.0,21,4.0,15,1,7,1162.0,0.5552092790603638,0.3320198655128479
5933386,5699313,4219629,8615,8020,1997,1699,1980,595,6916,1.0,0.0,1,10.0,10,2,595,2415.0,0.573097288608551,0.24207495152950287
5933891,5507866,4523467,8622,7411,1996,3456,1985,1211,5166,0.0,0.0,2,3.0,24,2,112,1050.0,0.28836315870285034,0.12959156930446625
5934310,5595521,3982840,8622,7691,1997,271,1976,931,8351,1.0,0.0,3,16.0,16,1,154,833.0,0.41436344385147095,0.28586646914482117
5937837,5090393,4364717,8629,5899,1992,2546,1982,2730,6083,0.0,0.0,7,9.0,5,3,371,217.0,0.31295377016067505,0.5032584071159363
5939960,4887056,4508553,8629,5094,1989,3379,1985,3535,5250,1.0,0.0,3,11.0,2,2,1512,189.0,0.38810044527053833,0.19886817038059235
5937886,5509292,5174830,8629,7418,1996,6207,1992,1211,2422,0.0,0.0,2,3.0,2,3,84,21.0,0.47912561893463135,0.18722426891326904
5937993,5530516,4359677,8629,7481,1996,2511,1982,1148,6118,0.0,0.0,2,6.0,14,3,35,378.0,0.3587281405925751,0.338108092546463
5940816,5651098,4564373,8629,7873,1997,3666,1986,756,4963,1.0,0.0,1,8.0,3,6,756,1316.0,0.38257333636283875,0.175700381398201
5940537,5172000,4445981,8629,6193,1992,3043,1984,2436,5586,0.0,0.0,15,1.0,3,1,329,5586.0,0.40867453813552856,0.22575494647026062
5945732,4953005,5217607,8643,5353,1990,6368,1993,3290,2275,0.5,0.0,63,6.0,25,18,0,70.0,0.33441492915153503,-0.007071835920214653
5944801,5818948,5043772,8643,8314,1998,5717,1991,329,2926,0.0,0.0,2,7.0,10,4,70,231.0,0.2987808585166931,0.2582205533981323
5944874,5332424,4094317,8643,6781,1994,894,1978,1862,7749,1.0,0.0,28,12.0,21,1,7,833.0,0.5923947095870972,0.3398822844028473
5948038,4949186,4004115,8650,5339,1990,383,1977,3311,8267,0.0,0.0,13,7.0,3,2,28,2282.0,0.37146955728530884,0.30603063106536865
5953518,5231590,5236127,8657,6417,1993,6438,1993,2240,2219,1.0,0.0,40,1.0,5,3,84,2219.0,0.4952872693538666,0.04700300097465515
5950301,4470051,4220415,8657,3169,1984,1706,1980,5488,6951,0.0,0.0,15,12.0,3,1,105,854.0,0.3777972161769867,0.3004339337348938
5953511,4858818,4655849,8657,4982,1989,4114,1987,3675,4543,0.0,0.0,1,9.0,23,5,3675,854.0,0.19543519616127014,0.24761056900024414
5951121,4526003,4130661,8657,3470,1985,1083,1978,5187,7574,1.0,0.0,7,4.0,3,3,3311,4571.0,0.5562204122543335,0.06198715791106224
5953632,4782380,5220225,8657,4688,1988,6375,1993,3969,2282,1.0,0.0,60,3.0,4,4,14,609.0,0.37121468782424927,0.15467225015163422
5953143,5303077,4197323,8657,6676,1994,1559,1980,1981,7098,0.5,0.0,12,4.0,5,8,518,1526.0,0.6093412637710571,0.15878571569919586
5952178,5409586,4510064,8657,7054,1995,3386,1985,1603,5271,0.0,0.0,5,16.0,6,5,49,581.0,0.3130866289138794,0.018179703503847122
5955547,4358564,4205064,8664,2504,1982,1608,1980,6160,7056,1.0,0.0,14,10.0,1,2,1113,56.0,0.3537396192550659,0.3481016159057617
5954144,4266444,4677754,8664,1958,1981,4205,1987,6706,4459,0.0,0.0,14,8.0,3,3,441,203.0,0.5456115007400513,0.059710338711738586
5956509,5347632,4189545,8664,6830,1994,1510,1980,1834,7154,1.0,0.0,111,10.0,15,7,0,140.0,0.46536383032798767,0.06205889955163002
5958015,5408602,4321967,8671,7047,1995,2280,1982,1624,6391,1.0,0.0,16,5.0,10,1,203,4424.0,0.2785932421684265,0.18480440974235535
5962402,5733855,4547252,8678,8125,1998,3575,1985,553,5103,1.0,0.0,1,9.0,22,1,553,84.0,0.9999489784240723,0.08119220286607742
5963342,4694352,4362125,8678,4275,1987,2532,1982,4403,6146,1.0,0.0,26,9.0,5,1,462,28.0,0.48943841457366943,0.1825249195098877
5962603,4198328,4512885,8678,1566,1980,3400,1985,7112,5278,0.0,0.0,13,15.0,6,3,2359,567.0,0.31392109394073486,0.3004443943500519
5963659,4821332,5269696,8678,4849,1989,6557,1993,3829,2121,1.0,0.0,16,4.0,4,6,49,350.0,0.5213126540184021,0.22715413570404053
5963862,5163160,5014846,8678,6158,1992,5612,1991,2520,3066,1.0,0.0,5,8.0,5,4,784,84.0,0.4433209300041199,0.047548115253448486
5963481,5329489,5401767,8678,6767,1994,7026,1995,1911,1652,1.0,0.0,10,4.0,11,15,182,14.0,0.5246597528457642,-0.01837357133626938
5966401,4587662,4256315,8685,3778,1986,1902,1981,4907,6783,1.0,0.0,69,10.0,3,1,7,420.0,0.41269251704216003,0.12353851646184921
5969290,5763293,4512384,8692,8195,1998,3400,1985,497,5292,1.0,0.0,1,10.0,3,2,497,3227.0,0.7484591603279114,0.2571759521961212
5967851,5158484,4636614,8692,6144,1992,4030,1987,2548,4662,1.0,0.0,5,8.0,1,8,7,455.0,0.6505579352378845,0.13834698498249054
5969250,4600934,5065935,8692,3848,1986,5801,1991,4844,2891,0.5,0.0,55,5.0,4,7,14,427.0,0.35945263504981995,0.15260274708271027
5966799,5596797,4437909,8692,7698,1997,3001,1984,994,5691,1.0,1.0,2,4.0,10,3,336,1862.0,0.18145616352558136,0.26752549409866333
5974522,4807115,4772889,8699,4800,1989,4646,1988,3899,4053,1.0,0.0,180,10.0,6,2,0,441.0,0.5776793360710144,0.33087965846061707
5973954,5801396,4413133,8699,8279,1998,2861,1983,420,5838,0.0,0.0,1,2.0,34,2,420,3360.0,0.21903526782989502,0.1554359644651413
5971707,5318404,4435080,8699,6732,1994,2987,1984,1967,5712,0.5,0.0,8,2.0,3,1,287,4249.0,0.5720502734184265,0.22565871477127075
5974169,5253308,4489634,8699,6494,1993,3281,1984,2205,5418,1.0,0.0,21,4.0,17,1,28,1862.0,0.18346065282821655,0.24319668114185333
5971780,5740012,5082413,8699,8139,1998,5864,1992,560,2835,0.5,0.0,1,5.0,14,19,560,259.0,0.4512237310409546,0.5223295092582703
5973014,4624868,4599175,8699,3981,1986,3841,1986,4718,4858,0.0,0.0,14,11.0,2,3,0,1169.0,0.40120646357536316,0.18099285662174225
5972188,4883577,5334562,8699,5080,1989,6788,1994,3619,1911,1.0,0.0,9,1.0,3,8,287,1911.0,0.6192330718040466,0.35220542550086975
5973525,5128632,5783808,8699,6032,1992,8237,1998,2667,462,1.0,0.0,30,1.0,5,13,77,462.0,0.5082122683525085,0.1907753050327301
5974389,5265010,4713529,8699,6536,1993,4366,1987,2163,4333,1.0,0.0,21,1.0,3,2,35,4333.0,0.4711994528770447,0.2900213599205017
5977892,5019731,4442700,8706,5626,1991,3029,1984,3080,5677,1.0,0.0,2,5.0,4,1,1645,1687.0,0.6044553518295288,0.05510411784052849
5974863,4644755,5092848,8706,4072,1987,5906,1992,4634,2800,0.5,0.0,15,7.0,1,4,693,14.0,0.25131791830062866,0.17294065654277802
5976278,4649087,4299368,8706,4086,1987,2140,1981,4620,6566,0.0,0.0,10,9.0,14,2,280,287.0,0.6958842277526855,0.14778195321559906
5981032,4478769,4291532,8713,3218,1984,2098,1981,5495,6615,0.5,0.0,29,9.0,2,1,112,2240.0,0.27336904406547546,0.08003406226634979
5979494,4770187,3957743,8713,4639,1988,138,1976,4074,8575,0.0,0.0,13,3.0,1,1,147,231.0,0.47496163845062256,0.2307274043560028
5980707,4434037,4148934,8713,2980,1984,1195,1979,5733,7518,1.0,0.0,12,5.0,5,3,441,3206.0,0.3797171413898468,0.20158053934574127
5984701,5823807,4033775,8720,8328,1998,551,1977,392,8169,1.0,0.0,3,2.0,3,1,91,7798.0,0.6485005617141724,0.060970451682806015
5987016,5621752,4951888,8720,7775,1997,5353,1990,945,3367,1.0,0.0,9,4.0,26,6,7,280.0,0.47491025924682617,0.07670343667268753
5984150,5819992,4259355,8720,8321,1998,1916,1981,399,6804,1.0,0.0,1,22.0,7,2,399,2450.0,0.9999999403953552,0.1631462723016739
5988099,4261613,4087731,8727,1930,1981,852,1978,6797,7875,0.0,0.0,8,12.0,1,1,378,1638.0,0.5000584125518799,0.23466607928276062
5987675,4977629,4941951,8727,5465,1990,5311,1990,3262,3416,0.0,0.0,11,3.0,5,8,35,357.0,0.4354930818080902,0.057877570390701294
5992890,4869531,4590565,8734,5017,1989,3792,1986,3717,4942,0.3333333333333333,0.0,9,2.0,7,6,14,3885.0,0.4484183192253113,0.17192918062210083
5994892,4365302,5546362,8734,2546,1982,7530,1996,6188,1204,1.0,0.0,13,2.0,7,2,399,525.0,0.4247908592224121,0.21062332391738892
5994672,4295419,4347764,8734,2119,1981,2441,1982,6615,6293,0.0,0.0,24,11.0,3,1,28,2751.0,0.5860105156898499,0.18240468204021454
5995017,4862160,5051270,8734,4989,1989,5745,1991,3745,2989,0.3333333333333333,0.0,32,3.0,18,10,21,1183.0,0.5076557993888855,0.09919875860214233
5997134,4446469,4402646,8741,3043,1984,2805,1983,5698,5936,0.0,0.0,4,3.0,2,2,210,2485.0,0.49487972259521484,0.23859596252441406
5996249,5388344,4300990,8741,6984,1995,2147,1981,1757,6594,1.0,0.0,4,24.0,4,4,7,385.0,0.6092791557312012,0.2149726301431656
6002955,5626136,4134292,8748,7796,1997,1111,1979,952,7637,1.0,0.0,6,3.0,10,1,0,4431.0,0.6586163640022278,0.22065162658691406
6001021,4807872,4612625,8748,4807,1989,3911,1986,3941,4837,1.0,0.0,14,9.0,4,2,28,14.0,0.7282506227493286,0.0664915218949318
6001059,5916150,5855938,8748,8580,1999,8405,1999,168,343,1.0,0.0,1,1.0,10,5,168,343.0,0.5695300698280334,0.22352366149425507
6005767,4517660,4458831,8755,3421,1985,3113,1984,5334,5642,1.0,0.0,24,12.0,6,3,378,35.0,0.4518764019012451,0.1349254995584488
6004309,4141359,5474535,8755,1153,1979,7285,1995,7602,1470,1.0,1.0,131,3.0,2,1,42,21.0,0.3171531856060028,0.17821042239665985
6004248,4603857,4904673,8755,3869,1986,5171,1990,4886,3584,1.0,0.0,8,3.0,2,2,1001,805.0,0.6671485900878906,0.030239013954997063
6007321,5059110,5097582,8762,5773,1991,5927,1992,2989,2835,1.0,0.0,14,1.0,5,6,133,2835.0,0.4876616299152374,0.49453049898147583
6007590,4613345,4931515,8762,3918,1986,5269,1990,4844,3493,1.0,0.0,12,2.0,4,6,112,476.0,0.3571835160255432,0.3861541748046875
6014044,5394359,4398812,8776,6998,1995,2784,1983,1778,5992,0.0,0.0,16,3.0,8,3,49,1974.0,0.4439743161201477,0.15268534421920776
6015079,4878609,5308593,8783,5059,1989,6697,1994,3724,2086,0.0,0.0,1,1.0,7,2,3724,2086.0,0.5082026124000549,0.16749179363250732
6017989,4897298,4352006,8790,5143,1990,2462,1982,3647,6328,0.0,0.0,14,16.0,12,5,497,63.0,0.6376684308052063,0.3037432134151459
6020763,5311479,5242276,8797,6704,1994,6459,1993,2093,2338,0.0,0.0,7,5.0,5,3,7,343.0,0.5378970503807068,0.15177275240421295
6019750,5398851,4231039,8797,7019,1995,1762,1980,1778,7035,0.0,0.0,15,9.0,43,1,0,231.0,0.3068726658821106,-0.042670950293540955
6023736,5889965,4998303,8804,8489,1999,5549,1991,315,3255,1.0,0.0,2,5.0,32,5,42,287.0,0.45554035902023315,0.2214241921901703
6024727,5114404,5361003,8811,5983,1992,6879,1994,2828,1932,1.0,0.0,34,5.0,9,5,28,7.0,0.6703125238418579,0.231620192527771
6025910,4679075,5620786,8811,4205,1987,7775,1997,4606,1036,0.0,0.0,23,4.0,5,24,189,112.0,0.5890584588050842,0.12767866253852844
6026339,5402341,4411296,8811,7026,1995,2854,1983,1785,5957,1.0,0.0,8,7.0,42,1,616,3724.0,0.29325830936431885,0.27617794275283813
6024687,4776834,4461643,8811,4667,1988,3127,1984,4144,5684,1.0,0.0,2,9.0,5,1,3458,707.0,0.6057332754135132,0.17743325233459473
6027457,4206763,4932064,8818,1622,1980,5269,1990,7196,3549,1.0,0.0,14,3.0,1,2,105,1253.0,0.4911777973175049,0.24178290367126465
6029009,5266988,5379786,8818,6543,1993,6949,1995,2275,1869,1.0,0.0,23,3.0,2,4,84,84.0,0.5138668417930603,0.16289769113063812
6027216,5345281,5082031,8818,6823,1994,5864,1992,1995,2954,1.0,0.0,11,5.0,9,4,42,700.0,0.4368075728416443,0.07334114611148834
6028966,4851678,4417936,8818,4954,1989,2889,1983,3864,5929,0.0,0.0,14,10.0,2,1,112,420.0,0.46464160084724426,0.15539492666721344
6026848,4572396,4041029,8818,3708,1986,586,1977,5110,8232,0.5,0.0,26,10.0,3,1,77,1225.0,0.5470123291015625,0.1483098566532135
6029254,4768193,4043925,8818,4625,1988,600,1977,4193,8218,0.5,0.0,65,7.0,6,2,154,4228.0,0.5070318579673767,0.05196987837553024
6029212,5157692,5042614,8818,6137,1992,5717,1991,2681,3101,0.0,0.0,24,3.0,4,6,126,1225.0,0.3422512412071228,0.0874197781085968
re365904,4106058,4217722,8825,950,1978,1692,1980,7875,7133,0.5,0.0,68,7.0,2,3,889,511.0,0.336795449256897,0.02682381495833397
6031473,5451894,5687944,8825,7201,1995,7992,1997,1624,833,1.0,0.0,17,3.0,7,7,91,189.0,0.36205920577049255,0.10424827039241791
6035017,5347574,5476193,8832,6830,1994,7292,1995,2002,1540,1.0,0.0,21,2.0,4,4,91,504.0,0.5963149666786194,0.18750809133052826
6034043,4923619,4545223,8832,5241,1990,3568,1985,3591,5264,0.0,0.0,12,6.0,16,3,42,238.0,0.5624805688858032,0.10014744102954865
6036577,4992074,4874905,8839,5521,1991,5038,1989,3318,3801,1.0,0.0,7,7.0,3,7,98,112.0,0.5559170246124268,0.22989057004451752
6039755,5571171,5022456,8846,7614,1996,5640,1991,1232,3206,1.0,0.0,8,1.0,8,2,21,3206.0,0.1649676114320755,0.16989299654960632
6040193,5143849,4079554,8846,6088,1992,810,1978,2758,8036,0.5,0.0,15,6.0,8,1,336,420.0,0.34026068449020386,0.2401513308286667
6042882,4740416,4690046,8853,4499,1988,4261,1987,4354,4592,0.5,0.0,10,6.0,6,4,14,637.0,0.7498571276664734,0.19231975078582764
6044195,5325459,5419383,8853,6753,1994,7089,1995,2100,1764,0.5,0.0,7,3.0,6,6,497,994.0,0.5353774428367615,0.12501905858516693
6043283,5547841,5112628,8853,7537,1996,5976,1992,1316,2877,0.0,0.5,10,2.0,5,9,63,546.0,0.48365503549575806,0.05450297147035599
6042619,5700452,4154629,8853,8027,1997,1230,1979,826,7623,1.0,0.0,4,16.0,15,2,14,1099.0,0.2819789946079254,0.266969233751297
6047126,5367621,4091618,8860,6900,1994,880,1978,1960,7980,1.0,0.0,51,8.0,14,1,91,1575.0,0.5639826655387878,0.20925338566303253
6046670,5695345,4125586,8860,8013,1997,1048,1978,847,7812,0.0,0.0,2,1.0,4,1,133,7812.0,0.539993941783905,0.03491734713315964
6048821,5407878,4809874,8867,7047,1995,4814,1989,1820,4053,0.5,0.0,2,17.0,18,4,1148,84.0,0.39826056361198425,0.10992947220802307
6048620,4642267,4104107,8867,4058,1987,943,1978,4809,7924,0.5,0.0,65,2.0,14,2,21,1197.0,0.45734596252441406,0.3664245903491974
6048097,5690107,4484907,8867,7999,1997,3253,1984,868,5614,1.0,0.0,2,6.0,5,3,518,1148.0,0.5505098700523376,0.13003887236118317
re366544,4044546,5688848,8867,607,1977,7992,1997,8260,875,0.0,0.0,22,1.0,1,29,224,875.0,0.5044668912887573,0.20260268449783325
6049686,4868600,4060256,8867,5010,1989,698,1977,3857,8169,1.0,0.0,98,17.0,11,1,35,168.0,0.5079345107078552,0.18667934834957123
6052358,5508985,5155101,8874,7411,1996,6130,1992,1463,2744,1.0,0.0,9,6.0,2,1,252,483.0,0.3979787528514862,0.10814491659402847
6052907,4866846,5554471,8881,5010,1989,7558,1996,3871,1323,0.0,0.0,15,3.0,6,7,581,819.0,0.4282851219177246,0.21279920637607574
6054985,5479603,5103367,8881,7299,1995,5941,1992,1582,2940,1.0,0.0,13,21.0,4,4,7,28.0,0.3962883949279785,0.02906578965485096
6055396,5583629,5612299,8881,7649,1996,7747,1997,1232,1134,1.0,0.0,2,2.0,25,13,686,371.0,0.3755315840244293,0.11005707830190659
6054256,4425162,4280820,8881,2931,1984,2035,1981,5950,6846,0.0,0.0,44,1.0,6,2,49,6846.0,0.49666422605514526,0.05833468213677406
6058430,5481542,4137100,8888,7306,1996,1125,1979,1582,7763,0.0,0.0,67,3.0,15,5,14,1645.0,0.5543459057807922,0.2179890275001526
6056008,5197328,4401291,8888,6298,1993,2798,1983,2590,6090,0.5,0.0,30,2.0,17,2,28,3038.0,0.42307040095329285,0.24052272737026215
6056559,5194020,4755492,8888,6284,1993,4569,1988,2604,4319,1.0,0.0,9,5.0,4,4,154,364.0,0.5034477710723877,0.14588402211666107
6056642,5188363,4347290,8888,6263,1993,2434,1982,2625,6454,1.0,0.0,10,13.0,6,5,238,35.0,0.5031794905662537,0.11044606566429138
6059237,5555815,4913770,8895,7565,1996,5206,1990,1330,3689,0.0,0.0,6,2.0,11,5,140,2338.0,0.45767471194267273,0.08498285710811615
6059693,4930767,4343850,8895,5269,1990,2413,1982,3626,6482,1.0,0.0,8,5.0,8,3,56,4641.0,0.5859605669975281,0.11392097920179367
6060636,4871493,4061777,8895,5024,1989,705,1977,3871,8190,0.0,0.5,9,3.0,3,1,644,3773.0,0.3386625051498413,0.23656421899795532
6059927,5080754,4850026,8895,5857,1992,4947,1989,3038,3948,1.0,0.0,3,11.0,5,10,1988,56.0,0.6464218497276306,0.15057207643985748
6060975,5582357,4361313,8895,7649,1996,2525,1982,1246,6370,1.0,0.0,1,5.0,5,2,1246,217.0,0.38009563088417053,0.30825182795524597
6064749,5483961,5329148,8902,7320,1996,6767,1994,1582,2135,0.0,0.0,16,4.0,15,4,35,112.0,0.4770447909832001,0.12435922026634216
6062330,4887689,4420900,8902,5101,1989,2910,1983,3801,5992,1.0,0.0,35,8.0,15,4,154,1288.0,0.6459230780601501,0.27288761734962463
6065374,5230262,5466116,8909,6417,1993,7257,1995,2492,1652,1.0,0.0,1,3.0,1,5,2492,42.0,0.5420494675636292,0.35532891750335693
6065742,5197692,5004702,8909,6298,1993,5570,1991,2611,3339,0.0,0.0,12,1.0,25,2,49,3339.0,0.36425265669822693,0.20936626195907593
6066700,5344908,4139986,8909,6823,1994,1146,1979,2086,7763,1.0,0.0,1,3.0,7,2,2086,3990.0,0.6329407691955566,0.1071949377655983
6069733,5028994,5008607,8916,5661,1991,5584,1991,3255,3332,0.0,0.0,12,3.0,1,4,483,35.0,0.3452436029911041,0.18850460648536682
6068752,5876675,4699701,8916,8461,1999,4303,1987,455,4613,0.5,0.0,1,3.0,29,4,455,2072.0,0.6270232796669006,0.12169795483350754
6068207,4838422,4168077,8916,4912,1989,1356,1979,4004,7560,0.0,0.0,30,1.0,6,1,56,7560.0,0.461666077375412,0.306210458278656
6068395,5326168,4803198,8916,6760,1994,4786,1989,2156,4130,1.0,0.0,2,3.0,3,4,259,1813.0,0.6885295510292053,0.07594805955886841
6070863,4828231,5722891,8923,4877,1989,8097,1998,4046,826,0.0,0.0,9,5.0,1,5,245,28.0,0.5053978562355042,0.2568936347961426
6071421,4386730,4040264,8923,2714,1983,586,1977,6209,8337,0.0,0.0,50,16.0,2,1,42,147.0,0.5626839399337769,0.2976568937301636
6072351,5748025,5783517,8923,8160,1998,8237,1998,763,686,1.0,0.0,4,1.0,16,3,98,686.0,0.4953054189682007,0.15596869587898254
6071867,4780235,5397543,8923,4681,1988,7012,1995,4242,1911,0.25,0.0,71,9.0,5,9,35,231.0,0.45447808504104614,0.191971093416214
6070390,4640079,4239939,8923,4051,1987,1811,1980,4872,7112,1.0,0.0,126,15.0,2,1,14,924.0,0.43496575951576233,0.08600219339132309
6075238,4127771,5489092,8930,1062,1978,7341,1996,7868,1589,1.0,0.0,11,3.0,1,3,833,273.0,0.45527344942092896,0.3393997550010681
6075223,5783507,5249872,8930,8237,1998,6487,1993,693,2443,0.0,0.0,3,2.0,26,4,126,77.0,0.2750539481639862,0.222792848944664
6073285,4995432,5008306,8930,5535,1991,5584,1991,3395,3346,0.0,0.0,10,4.0,6,2,70,1183.0,0.16882681846618652,0.16434364020824432
6078888,5363889,4686792,8937,6893,1994,4247,1987,2044,4690,0.0,0.0,15,6.0,3,7,7,434.0,0.2601073682308197,0.20269888639450073
6077999,4594810,5210793,8937,3820,1986,6340,1993,5117,2597,0.5,0.0,53,2.0,3,3,14,98.0,0.6865726709365845,0.12816141545772552
6077722,4316049,4460046,8937,2238,1982,3120,1984,6699,5817,1.0,0.0,20,9.0,3,1,1295,273.0,0.4545333981513977,0.09340142458677292
6079372,4874406,4346618,8944,5038,1989,2434,1982,3906,6510,0.0,0.0,5,8.0,4,3,357,126.0,0.6411307454109192,0.2668644189834595
6082358,5300042,5910509,8951,6669,1994,8559,1999,2282,392,0.3333333333333333,0.0,3,1.0,17,4,1533,392.0,0.5512884855270386,0.21927492320537567
6082850,5386225,5746052,8951,6970,1995,8160,1998,1981,791,0.0,0.0,18,4.0,10,7,7,84.0,0.5125296115875244,0.10742662101984024
6088665,5023869,4628006,8958,5640,1991,3995,1986,3318,4963,0.0,0.0,37,4.0,2,2,7,532.0,0.286615252494812,0.12201682478189468
6088396,5563649,5570347,8958,7586,1996,7607,1996,1372,1351,1.0,1.0,7,5.0,25,7,126,483.0,0.47898566722869873,0.13379362225532532
6085613,4882946,4564373,8958,5080,1989,3666,1986,3878,5292,0.0,0.0,13,8.0,7,6,224,1645.0,0.4507087767124176,0.036870621144771576
6086195,5157468,5619631,8958,6137,1992,7768,1997,2821,1190,0.0,0.0,1,4.0,5,5,2821,378.0,0.20004168152809143,0.17597515881061554
6085455,5475942,4749031,8958,7292,1995,4541,1988,1666,4417,0.5,0.0,1,7.0,6,3,1666,196.0,0.4333629608154297,0.3177347779273987
6091984,5313264,4549452,8965,6711,1994,3589,1985,2254,5376,0.0,0.0,21,8.0,1,5,91,140.0,0.4977372884750366,0.0790376290678978
6091058,5457962,4914308,8965,7229,1995,5206,1990,1736,3759,0.0,0.0,11,4.0,6,5,7,196.0,0.476572185754776,0.24758963286876678
6091581,5801909,4228713,8965,8279,1998,1755,1980,686,7210,1.0,0.0,2,3.0,51,4,168,6531.0,0.8116113543510437,0.17303664982318878
6094615,5477827,4014838,8972,7299,1995,453,1977,1673,8519,0.0,0.0,19,4.0,6,1,28,2233.0,0.6245700716972351,0.21154195070266724
6093182,4898588,4597588,8972,5150,1990,3834,1986,3822,5138,1.0,0.0,13,14.0,2,3,98,595.0,0.3726079761981964,0.39151233434677124
6094213,5142604,5155332,8972,6081,1992,6130,1992,2891,2842,1.0,0.0,3,4.0,1,3,238,609.0,0.499467670917511,0.15667109191417694
6092811,4394023,4388257,8972,2756,1983,2721,1983,6216,6251,1.0,0.0,17,5.0,4,1,21,1519.0,0.38252338767051697,0.255698025226593
6093784,5098807,4813179,8972,5927,1992,4828,1989,3045,4144,0.0,0.0,3,1.0,1,3,1253,4144.0,0.5691083073616028,0.096883125603199
6092824,4691933,5826335,8972,4268,1987,8335,1998,4704,637,0.0,0.0,6,1.0,2,4,1694,637.0,0.4876434803009033,0.18703320622444153
6096371,5403433,5247268,8979,7033,1995,6473,1993,1946,2506,0.0,0.0,15,1.0,21,3,42,2506.0,0.3345089852809906,0.17021431028842926
6095373,5988868,5269269,8979,8727,1999,6557,1993,252,2422,0.0,0.0,2,9.0,37,3,98,21.0,0.4689904451370239,0.30254796147346497
6096406,4863791,4300922,8979,4996,1989,2147,1981,3983,6832,0.0,0.0,23,1.0,2,1,168,6832.0,0.21919554471969604,0.260483056306839
6097837,5237402,4020499,8979,6438,1993,481,1977,2541,8498,0.0,0.0,8,2.0,41,1,217,8036.0,0.5305888056755066,0.36740636825561523
6097718,5598581,4237909,8979,7698,1997,1804,1980,1281,7175,0.0,0.0,11,2.0,18,1,14,5019.0,0.3324529826641083,0.11364758014678955
6095651,4632528,4213511,8979,4016,1986,1664,1980,4963,7315,0.5,0.0,1,2.0,2,3,4963,1463.0,0.47733694314956665,0.33690109848976135
6098544,5605780,4213682,8986,7726,1997,1664,1980,1260,7322,0.0,0.0,5,7.0,16,3,203,4466.0,0.6126242280006409,0.22842054069042206
6101599,5390298,5935040,8986,6984,1995,8622,1999,2002,364,1.0,0.0,6,2.0,1,8,49,28.0,0.46955999732017517,0.2880006730556488
6102004,4919497,4226436,8993,5227,1990,1741,1980,3766,7252,0.0,0.0,5,6.0,8,1,35,2961.0,0.3170238733291626,0.3547070026397705
6102243,4109599,4515200,8993,971,1978,3414,1985,8022,5579,0.0,0.0,26,2.0,1,3,28,2485.0,0.31250229477882385,0.2415694296360016
6102803,5046739,4501844,8993,5731,1991,3344,1985,3262,5649,1.0,0.0,19,8.0,1,2,70,1624.0,0.4489613473415375,0.19567656517028809
6105099,5682470,5385401,8993,7971,1997,6970,1995,1022,2023,1.0,0.0,2,5.0,15,3,28,63.0,0.566560685634613,0.032072458416223526
6103109,5207905,5604352,8993,6333,1993,7719,1997,2660,1274,0.0,0.0,10,4.0,4,6,168,441.0,0.3297194540500641,0.18655002117156982
6103020,5057449,5135824,8993,5766,1991,6060,1992,3227,2933,1.0,1.0,17,3.0,4,2,14,1141.0,0.41170069575309753,0.16101333498954773
6104186,5493219,4379337,8993,7355,1996,2651,1983,1638,6342,1.0,0.0,12,2.0,4,4,7,1988.0,0.33120715618133545,0.21491330862045288
6105745,4773516,4989276,9000,4653,1988,5514,1991,4347,3486,1.0,0.0,4,1.0,1,3,189,3486.0,0.5970028042793274,0.31783050298690796
6106011,4892903,5606121,9000,5122,1990,7726,1997,3878,1274,0.5,0.0,12,8.0,2,26,112,42.0,0.43337497115135193,0.1654185950756073
6110520,5032513,4372313,9007,5675,1991,2595,1983,3332,6412,0.5,0.0,5,8.0,5,6,623,175.0,0.5065252780914307,0.19660331308841705
6110650,4985601,5876680,9007,5493,1991,8461,1999,3514,546,0.0,0.0,6,1.0,24,7,350,546.0,0.3998202085494995,0.2095334827899933
6108960,4589221,4337661,9007,3792,1986,2378,1982,5215,6629,1.0,0.0,18,4.0,2,9,112,427.0,0.718342661857605,0.19081592559814453
6113579,5050606,5239579,9014,5745,1991,6445,1993,3269,2569,1.0,0.0,32,7.0,1,3,21,371.0,0.5374706983566284,0.10275842249393463
6115621,5213099,4428609,9014,6354,1993,2952,1984,2660,6062,1.0,0.0,7,4.0,11,1,70,784.0,0.6250029802322388,0.16442599892616272
6113365,5232273,5145255,9014,6424,1993,6095,1992,2590,2919,0.5,0.0,13,7.0,2,10,266,49.0,0.5796786546707153,0.1413860321044922
6116389,5553514,5318330,9021,7558,1996,6732,1994,1463,2289,1.0,0.0,5,3.0,8,1,21,1232.0,0.36988532543182373,0.02006678655743599
6117796,4444618,4435247,9021,3036,1984,2987,1984,5985,6034,0.0,0.0,20,22.0,4,4,35,112.0,0.3324066400527954,0.299496591091156
6116291,4967802,4169763,9021,5423,1990,1370,1979,3598,7651,1.0,0.0,3,7.0,1,2,28,2345.0,0.4457700252532959,0.057899538427591324
6119607,5543117,5749018,9028,7523,1996,8160,1998,1505,868,0.0,0.0,2,1.0,7,6,1211,868.0,0.48135805130004883,0.18104586005210876
6120595,4692425,4335876,9028,4268,1987,2364,1982,4760,6664,0.5,0.0,6,4.0,1,2,588,4557.0,0.312956303358078,0.03075609728693962
6120637,5804271,4588638,9028,8286,1998,3785,1986,742,5243,0.0,1.0,2,4.0,2,2,322,28.0,0.7003681063652039,0.297126829624176
6124323,5192751,4183408,9035,6277,1993,1475,1980,2758,7560,0.0,0.0,10,3.0,2,3,0,2387.0,0.3688428997993469,-0.05224399268627167
6124459,4255579,4702769,9035,1895,1981,4317,1987,7140,4718,1.0,0.0,6,1.0,4,5,2170,4718.0,0.3362896740436554,0.10055956244468689
6124429,5374531,5878523,9035,6928,1994,8468,1999,2107,567,0.0,0.0,5,3.0,11,10,294,147.0,0.08921598643064499,0.13086140155792236
6125192,5151945,4002995,9035,6116,1992,376,1977,2919,8659,1.0,0.0,24,15.0,5,1,35,1603.0,0.41542476415634155,0.20479744672775269
6124455,5348975,4424829,9035,6837,1994,2931,1984,2198,6104,0.5,0.0,65,6.0,34,2,14,448.0,0.6915299296379089,0.018567895516753197
6127768,5739563,4580681,9042,8139,1998,3750,1986,903,5292,0.5,0.0,10,1.0,3,2,56,5292.0,0.26517975330352783,0.12627682089805603
6125709,4170901,5166793,9042,1384,1979,6172,1992,7658,2870,1.0,0.0,8,1.0,3,6,945,2870.0,0.5167661309242249,0.07434888929128647
6126628,4443214,4765672,9042,3029,1984,4618,1988,6013,4424,1.0,0.0,24,9.0,1,3,168,56.0,0.5314334034919739,0.2340291142463684
6130875,5646936,4024737,9049,7859,1997,509,1977,1190,8540,0.3333333333333333,0.0,22,9.0,8,1,119,1043.0,0.5449000000953674,0.04122069850564003
6129775,5267371,5329734,9049,6550,1993,6774,1994,2499,2275,0.0,0.0,11,9.0,10,12,35,7.0,0.18612916767597198,0.08112902194261551
6130794,4821125,5693416,9049,4849,1989,8006,1997,4200,1043,1.0,0.0,43,1.0,10,2,154,1043.0,0.3744674623012543,0.182026207447052
6131332,4340146,4719709,9056,2392,1982,4401,1988,6664,4655,0.0,0.0,27,11.0,1,5,238,721.0,0.23307497799396515,0.09816872328519821
6138036,5487175,4279779,9063,7327,1996,2028,1981,1736,7035,1.0,0.0,17,7.0,5,5,28,56.0,0.6418041586875916,0.01918218471109867
6137473,5534893,5720486,9063,7495,1996,8090,1998,1568,973,1.0,0.0,15,1.0,13,7,21,973.0,0.3025980293750763,0.10025858134031296
6138838,5064536,5175128,9070,5794,1991,6207,1992,3276,2863,0.0,0.0,4,3.0,3,7,812,245.0,0.22589832544326782,0.3179296553134918
6141365,4689797,5216349,9070,4254,1987,6361,1993,4816,2709,1.0,0.0,17,3.0,4,1,567,1414.0,0.2694382667541504,0.16396282613277435
6141046,5777743,4279391,9070,8223,1998,2028,1981,847,7042,0.0,0.0,2,3.0,11,1,133,4564.0,0.513558566570282,0.22497881948947906
6141612,5884204,4760879,9070,8475,1999,4597,1988,595,4473,0.0,0.0,2,6.0,22,7,280,140.0,0.531777560710907,0.31976160407066345
6139955,5447389,4035134,9070,7187,1995,558,1977,1883,8512,0.0,0.0,3,7.0,4,1,357,7245.0,0.4123130142688751,0.13025666773319244
6138668,4984158,4285320,9070,5486,1991,2063,1981,3584,7007,0.3333333333333333,0.0,81,2.0,8,5,7,1393.0,0.45052874088287354,0.4004170298576355
6138330,5144725,5910509,9070,6095,1992,8559,1999,2975,511,1.0,0.0,15,1.0,8,4,336,511.0,0.5513976812362671,0.09508950263261795
6141097,5818583,5012325,9070,8314,1998,5598,1991,756,3472,1.0,0.0,1,7.0,11,17,756,1001.0,0.45686814188957214,0.29558050632476807
6139753,5169538,5011052,9070,6186,1992,5598,1991,2884,3472,1.0,0.0,4,5.0,5,4,525,287.0,0.5850011706352234,0.010549930855631828
6139575,4222126,5783773,9070,1720,1980,8237,1998,7350,833,1.0,0.0,38,7.0,1,19,56,7.0,0.6239761710166931,0.23063777387142181
6144707,5943371,4072552,9077,8636,1999,768,1978,441,8309,0.0,0.0,1,5.0,10,1,441,2555.0,0.569105327129364,0.31847572326660156
6142926,5395333,4721138,9077,7005,1995,4408,1988,2072,4669,1.0,0.0,32,9.0,30,1,14,147.0,0.3966737687587738,0.23475733399391174
6143698,5447199,4685019,9077,7187,1995,4233,1987,1890,4844,0.5,0.0,5,5.0,6,2,21,1575.0,0.4917442202568054,0.15276288986206055
6143639,4612083,4559361,9077,3911,1986,3638,1985,5166,5439,0.0,0.0,75,11.0,2,5,0,259.0,0.3912651240825653,0.05336807295680046
6143187,5232586,4733727,9077,6424,1993,4471,1988,2653,4606,0.0,0.0,9,4.0,11,6,70,2275.0,0.4850132465362549,0.26615941524505615
6141933,4555375,4371637,9077,3617,1985,2588,1983,5460,6489,0.0,0.0,2,4.0,2,5,1533,3626.0,0.2500400245189667,-0.06337732076644897
6143274,4639365,5455300,9077,4044,1987,7215,1995,5033,1862,0.5,0.0,69,1.0,18,10,105,1862.0,0.41205093264579773,0.014767087996006012
6146854,5777325,5718597,9084,8223,1998,8083,1998,861,1001,0.0,0.0,6,2.0,7,2,14,490.0,0.1863510012626648,-0.005114056169986725
6147841,4881139,4405679,9084,5066,1989,2819,1983,4018,6265,1.0,0.0,41,7.0,11,8,637,84.0,0.7460604906082153,0.12454769760370255
6150828,5537204,4046979,9091,7502,1996,614,1977,1589,8477,0.0,0.3333333333333333,11,2.0,3,3,28,6783.0,0.35539504885673523,0.1699814796447754
6150403,4532937,3976715,9091,3505,1985,236,1976,5586,8855,1.0,0.0,14,9.0,4,5,91,392.0,0.6576412916183472,0.23527628183364868
6150648,4350859,5848113,9091,2455,1982,8377,1998,6636,714,1.0,0.0,6,1.0,6,9,3297,714.0,0.6286051869392395,0.21970704197883606
6148921,5040603,3994104,9091,5710,1991,334,1976,3381,8757,1.0,0.0,10,3.0,4,1,119,7028.0,0.25101178884506226,0.2820069193840027
6151037,5136305,4045735,9091,6060,1992,607,1977,3031,8484,1.0,0.0,45,7.0,11,1,21,252.0,0.6015342473983765,0.34498852491378784
6152356,4114687,5519106,9098,992,1978,7446,1996,8106,1652,1.0,0.0,3,2.0,1,6,2226,259.0,0.7186836004257202,0.4168611764907837
6153444,5232547,5392502,9098,6424,1993,6998,1995,2674,2100,0.0,0.0,13,3.0,4,8,203,203.0,0.4766364097595215,8.21426510810852e-05
6152128,5848585,5436928,9098,8384,1998,7145,1995,714,1953,1.0,0.0,2,6.0,10,2,21,196.0,0.7513110637664795,0.19741742312908173
6156108,5028265,4118178,9105,5661,1991,1006,1978,3444,8099,0.5,0.0,6,10.0,3,1,1008,2436.0,0.4844970405101776,0.15615567564964294
6156998,4697062,4490108,9105,4289,1987,3281,1984,4816,5824,1.0,0.0,4,7.0,1,2,301,175.0,0.7487618327140808,0.2246650755405426
6157858,5246418,5202899,9105,6473,1993,6312,1993,2632,2793,1.0,0.0,19,17.0,8,1,147,21.0,0.5626220107078552,0.20784510672092438
6156292,5676925,4180159,9105,7957,1997,1454,1979,1148,7651,0.5,0.0,2,7.0,10,1,189,679.0,0.7017396688461304,0.22192123532295227
6158269,5015322,4768894,9112,5612,1991,4632,1988,3500,4480,0.0,0.0,3,3.0,5,2,945,2191.0,0.44062548875808716,0.1825353354215622
6160501,5251308,4770966,9112,6487,1993,4639,1988,2625,4473,0.0,0.0,34,14.0,37,1,28,847.0,0.49414342641830444,0.21982276439666748
6159661,5801094,4720194,9112,8279,1998,4401,1988,833,4711,0.0,0.0,25,5.0,6,3,14,1253.0,0.741717517375946,0.16895997524261475
6162664,5920770,4371864,9119,8587,1999,2588,1983,532,6531,1.0,0.0,1,6.0,16,3,532,1218.0,0.5276352763175964,0.18875962495803833
6161546,5057104,4345107,9119,5766,1991,2420,1982,3353,6699,1.0,0.0,32,11.0,2,6,91,833.0,0.439662367105484,0.2524317800998688
6165298,5104728,5418785,9126,5948,1992,7082,1995,3178,2044,1.0,0.0,6,9.0,2,6,133,126.0,0.2279680073261261,0.2985592186450958
6166047,5811442,6001497,9126,8300,1998,8748,1999,826,378,0.3333333333333333,0.0,1,1.0,6,2,826,378.0,0.391411691904068,0.0010715994285419583
6168977,5965927,4404345,9133,8685,1999,2812,1983,448,6321,1.0,0.0,3,11.0,4,14,105,518.0,0.43051671981811523,0.13381554186344147
6170596,5335743,4188016,9140,6795,1994,1503,1980,2345,7637,0.3333333333333333,0.0,8,7.0,6,2,56,2324.0,0.45561447739601135,0.22080618143081665
6171566,5028314,5923530,9140,5661,1991,8594,1999,3479,546,0.0,0.0,5,2.0,7,7,1008,231.0,0.38404881954193115,0.11909905076026917
6170575,5672203,4303506,9140,7943,1997,2161,1981,1197,6979,0.5,0.0,1,17.0,17,1,1197,91.0,0.5266180634498596,0.20135483145713806
6173041,5604792,4056766,9140,7719,1997,670,1977,1421,8470,1.0,0.0,6,4.0,24,1,14,6195.0,0.6809142827987671,0.19895672798156738
6174355,5897695,4546647,9147,8517,1999,3575,1985,630,5572,1.0,0.0,1,6.0,24,5,630,679.0,0.7034825682640076,0.16759023070335388
6176595,4656569,5437249,9154,4114,1987,7152,1995,5040,2002,1.0,0.0,3,4.0,1,10,203,294.0,0.5912801623344421,0.3650602698326111
re370347,5087601,5285793,9161,5885,1992,6620,1994,3276,2541,1.0,0.0,16,7.0,1,5,28,49.0,0.8923293948173523,0.19420042634010315
6179715,4969855,5449373,9161,5430,1990,7194,1995,3731,1967,1.0,0.0,8,10.0,3,7,336,7.0,0.7811571955680847,0.26866763830184937
6178707,4612913,5650560,9161,3918,1986,7873,1997,5243,1288,0.0,0.0,3,2.0,19,2,1645,686.0,0.4185900092124939,0.08992186188697815
6182167,5805821,5672996,9161,8286,1998,7943,1997,875,1218,0.0,0.0,12,5.0,25,14,0,168.0,0.36746931076049805,0.35214200615882874
6181009,4291293,5063292,9161,2091,1981,5787,1991,7070,3374,0.0,1.0,22,8.0,3,11,105,161.0,0.3805680572986603,0.1893058866262436
6181867,5236199,4709793,9161,6438,1993,4352,1987,2723,4809,0.3333333333333333,0.0,61,8.0,3,7,0,1057.0,0.3481702208518982,0.1550525724887848
6179399,5611637,4718677,9161,7747,1997,4394,1988,1414,4767,0.0,0.0,5,19.0,8,5,161,532.0,0.49854061007499695,0.1243903860449791
6181944,6026305,4946401,9161,8811,2000,5332,1990,350,3829,1.0,0.0,1,7.0,4,8,350,1337.0,0.5667343735694885,0.3551429212093353
6183920,5795688,5723722,9168,8265,1998,8097,1998,903,1071,0.5,0.0,6,1.0,2,3,140,1071.0,0.32318323850631714,0.1294436752796173
6184430,5719097,4320569,9168,8083,1998,2273,1982,1085,6895,0.0,0.0,1,2.0,7,1,1085,105.0,0.482282429933548,0.14686961472034454
6185082,5861737,3984400,9168,8419,1999,278,1976,749,8890,0.0,0.0,3,3.0,9,1,280,4088.0,0.48895731568336487,0.034499090164899826
6185175,5938790,5649975,9168,8629,1999,7873,1997,539,1295,0.5,0.0,4,1.0,29,7,0,1295.0,0.559310257434845,0.2576102018356323
6189674,5873155,4890714,9182,8454,1999,5115,1990,728,4067,0.0,1.0,1,3.0,11,3,728,2989.0,0.5976638197898865,0.40815165638923645
6189653,4574937,5001886,9182,3722,1986,5563,1991,5460,3619,0.0,0.0,2,4.0,1,5,4592,7.0,0.44017499685287476,0.2848506271839142
6192435,5369593,5982698,9182,6907,1994,8713,1999,2275,469,0.5,0.0,11,1.0,19,5,98,469.0,0.362976998090744,0.3502086102962494
6194598,5359044,5548117,9189,6872,1994,7537,1996,2317,1652,1.0,0.0,12,2.0,2,4,49,693.0,0.6741235852241516,0.28354862332344055
6194379,4100024,4166229,9189,922,1978,1335,1979,8267,7854,0.5,0.0,25,22.0,1,1,756,2758.0,0.4962785840034485,0.187901109457016
6193041,5275269,5083711,9189,6578,1994,5871,1992,2611,3318,0.3333333333333333,0.0,2,11.0,4,7,168,539.0,0.2806205451488495,0.21280734241008759
6195244,4831498,4353811,9189,4884,1989,2476,1982,4305,6713,1.0,0.0,21,2.0,4,8,42,5642.0,0.5810535550117493,0.1545213907957077
6195667,5706458,5911379,9189,8041,1998,8566,1999,1148,623,1.0,0.0,3,1.0,5,8,693,623.0,0.44319581985473633,0.15582937002182007
6197742,5891126,4332467,9196,8496,1999,2343,1982,700,6853,0.0,0.0,4,5.0,11,8,105,5117.0,0.41053658723831177,0.3882303237915039
6198232,6011361,4859135,9196,8769,2000,4982,1989,427,4214,1.0,0.0,2,8.0,4,3,21,217.0,0.5553026795387268,0.35291576385498047
6196403,5413261,4296576,9196,7068,1995,2126,1981,2128,7070,0.0,0.0,8,8.0,4,2,154,924.0,0.5458625555038452,0.35151633620262146
6198130,5448083,4780581,9196,7187,1995,4681,1988,2009,4515,1.0,1.0,4,5.0,1,25,112,1309.0,0.645800769329071,0.1689511090517044
6200287,5370802,4209993,9203,6914,1994,1643,1980,2289,7560,0.3333333333333333,0.0,59,9.0,107,1,7,1162.0,0.5756796002388,0.24233514070510864
6202111,5272584,4212262,9203,6564,1993,1657,1980,2639,7546,0.0,0.0,72,1.0,2,1,14,7546.0,0.43288111686706543,0.15237756073474884
6201108,5340925,4567872,9203,6809,1994,3687,1986,2394,5516,1.0,0.0,12,7.0,1,3,7,154.0,0.5375482439994812,-0.006901595275849104
6199715,5029721,4137693,9203,5668,1991,1132,1979,3535,8071,0.5,0.0,7,5.0,4,1,112,1778.0,0.6360602378845215,0.27996590733528137
6203485,5282781,4226234,9210,6606,1994,1741,1980,2604,7469,1.0,1.0,34,13.0,1,1,14,21.0,0.5723081231117249,0.11484143137931824
6203330,5338232,4041093,9210,6802,1994,586,1977,2408,8624,0.5,0.0,2,5.0,1,1,56,805.0,0.36540213227272034,0.040835484862327576
6203775,5385719,4767625,9210,6970,1995,4625,1988,2240,4585,0.5,0.3333333333333333,6,20.0,19,3,350,35.0,0.22986586391925812,0.1677941530942917
6202756,5787988,5504038,9210,8251,1998,7397,1996,959,1813,1.0,0.0,4,11.0,8,14,21,28.0,0.6847750544548035,0.15136151015758514
6205473,5631907,5452649,9210,7810,1997,7208,1995,1400,2002,0.0,0.0,3,5.0,3,12,441,1162.0,0.4826587438583374,0.09671758860349655
6202257,5390972,4442910,9210,6991,1995,3029,1984,2219,6181,0.0,0.0,8,10.0,6,3,364,420.0,0.3568139970302582,0.29921433329582214
6204171,5188979,5163192,9210,6263,1993,6165,1992,2947,3045,1.0,0.0,9,3.0,6,4,126,1351.0,0.4950144290924072,0.16566795110702515
6205210,5699416,4385452,9210,8020,1997,2707,1983,1190,6503,1.0,0.0,16,14.0,7,2,35,343.0,0.4548162817955017,0.2048022747039795
6206181,5025915,4779202,9217,5654,1991,4674,1988,3563,4543,1.0,0.0,3,4.0,2,6,630,1239.0,0.4804065227508545,0.259319931268692
6205638,4979584,4321781,9217,5472,1990,2280,1982,3745,6937,0.0,0.0,13,3.0,2,1,140,2268.0,0.3706481158733368,0.17599767446517944
6207052,4533068,4681121,9217,3505,1985,4219,1987,5712,4998,0.0,0.0,33,2.0,4,4,0,1050.0,0.6043382883071899,0.27269789576530457
6208902,5735887,4170775,9217,8132,1998,1377,1979,1085,7840,0.5,0.0,9,5.0,29,1,0,147.0,0.3801218569278717,0.1945192962884903
6211324,5403904,4393034,9224,7033,1995,2749,1983,2191,6475,1.0,0.0,4,6.0,13,5,98,3626.0,0.4932556450366974,0.2251630425453186
6216883,6116848,4448356,9238,9021,2000,3057,1984,217,6181,0.5,0.0,1,14.0,10,2,217,518.0,0.5468519926071167,0.3530523180961609
6221479,5288676,5221060,9245,6627,1994,6382,1993,2618,2863,1.0,0.0,11,3.0,5,5,7,1463.0,0.5989591479301453,0.14312376081943512
6222594,5669681,4402321,9245,7936,1997,2805,1983,1309,6440,0.0,0.0,2,4.0,2,1,553,4487.0,0.2669507563114166,0.2397422194480896
6221854,5428006,4319456,9245,7117,1995,2266,1982,2128,6979,0.3333333333333333,0.0,6,8.0,1,1,581,1379.0,0.27031001448631287,0.06464449316263199
6220763,5647043,4201720,9245,7859,1997,1587,1980,1386,7658,1.0,0.0,9,5.0,5,3,28,140.0,0.4199443459510803,0.12256890535354614
6223814,5014117,5307184,9252,5605,1991,6690,1994,3647,2562,0.0,0.0,11,1.0,11,3,434,2562.0,0.5384425520896912,0.15434367954730988
6223683,5521351,4550880,9252,7453,1996,3596,1985,1799,5656,0.0,0.0,20,4.0,12,6,56,1113.0,0.2877786457538605,0.06753984838724136
6226111,5933258,4220819,9252,8615,1999,1706,1980,637,7546,1.0,0.0,5,38.0,6,3,7,35.0,0.5856403708457947,-0.006032764445990324
6230149,4319328,5340255,9259,2259,1982,6809,1994,7000,2450,0.0,0.0,30,5.0,2,5,266,322.0,0.654558002948761,0.28086093068122864
6228963,5173555,5102872,9259,6200,1992,5941,1992,3059,3318,1.0,0.0,2,15.0,1,7,259,21.0,0.5059604048728943,0.3323335647583008
6232367,5304586,5336367,9266,6683,1994,6795,1994,2583,2471,0.5,0.0,6,2.0,14,2,0,1330.0,0.576326847076416,0.3807373344898224
6231667,5922126,4431010,9266,8594,1999,2966,1984,672,6300,1.0,0.0,1,8.0,4,1,672,2653.0,0.6702281832695007,0.3459502160549164
6233726,5544302,4950128,9266,7523,1996,5346,1990,1743,3920,1.0,0.0,39,2.0,24,5,7,378.0,0.48350340127944946,0.18033207952976227
6232620,5737049,4164759,9266,8132,1998,1321,1979,1134,7945,0.0,0.0,5,2.0,4,1,301,6979.0,0.2999074459075928,0.19126096367835999
6233648,5124987,4292159,9266,6018,1992,2098,1981,3248,7168,1.0,0.0,106,8.0,7,1,28,3619.0,0.541660726070404,0.1783694624900818
6236302,4980541,5088312,9273,5472,1990,5892,1992,3801,3381,0.0,0.0,18,1.0,8,2,14,3381.0,0.4333548843860626,0.33770543336868286
6237029,5587723,4587050,9273,7663,1996,3778,1986,1610,5495,0.0,0.0,4,12.0,15,3,308,539.0,0.2418513000011444,0.13322561979293823
6236882,5339824,5487199,9273,6809,1994,7334,1996,2464,1939,1.0,0.0,3,2.0,3,1,1141,903.0,0.4116360545158386,0.13062684237957
6238469,5480476,5260133,9280,7306,1996,6522,1993,1974,2758,0.5,0.0,13,2.0,5,7,140,791.0,0.45082804560661316,0.24858738481998444
6239786,5889507,4293089,9280,8489,1999,2105,1981,791,7175,1.0,0.0,9,2.0,51,1,35,3220.0,0.4416792392730713,0.19942814111709595
6237748,5211277,4393974,9280,6347,1993,2756,1983,2933,6524,1.0,0.5,5,7.0,4,1,14,63.0,0.3451487421989441,0.2536659240722656
6242357,5869367,4126389,9287,8440,1999,1055,1978,847,8232,1.0,0.0,3,8.0,14,1,287,686.0,0.48593106865882874,0.2223525047302246
6243803,5001662,5791947,9287,5556,1991,8258,1998,3731,1029,1.0,0.0,11,2.0,5,2,7,672.0,0.4304136037826538,0.30345383286476135
6247071,5944801,4883187,9294,8643,1999,5080,1989,651,4214,1.0,0.0,4,4.0,10,2,238,364.0,0.588123619556427,0.21300451457500458
6245120,5018238,5812806,9294,5626,1991,8300,1998,3668,994,0.0,0.0,7,1.0,4,6,231,994.0,0.4099639356136322,0.20123903453350067
6245947,5288921,5261015,9294,6627,1994,6522,1993,2667,2772,1.0,0.0,1,3.0,4,20,2667,301.0,0.3046171963214874,0.27721112966537476
6249570,4630261,5285863,9301,4002,1986,6620,1994,5299,2681,1.0,0.0,20,1.0,3,1,7,2681.0,0.3639715015888214,0.17189335823059082
6253256,5293614,4907435,9308,6641,1994,5185,1990,2667,4123,1.0,0.0,23,3.0,6,5,7,329.0,0.5368853211402893,0.2540345788002014
6250308,5755783,4749167,9308,8181,1998,4541,1988,1127,4767,1.0,0.0,3,18.0,19,2,231,182.0,0.4917144775390625,0.1607029289007187
6251471,4416156,4132667,9308,2882,1983,1097,1979,6426,8211,0.0,0.0,3,5.0,3,2,2723,2842.0,0.5102576017379761,0.1311918944120407
6251369,4383987,4196499,9308,2693,1983,1559,1980,6615,7749,1.0,0.0,9,4.0,6,2,350,3549.0,0.6223688721656799,0.2093503177165985
6250433,5992576,5664377,9308,8734,1999,7922,1997,574,1386,1.0,0.0,1,2.0,21,7,574,371.0,0.620839536190033,0.3977883756160736
6253792,4160010,4064448,9315,1279,1979,719,1977,8036,8596,0.0,0.0,8,24.0,3,2,973,168.0,0.5647092461585999,0.24487820267677307
6254932,4126563,4575168,9315,1055,1978,3722,1986,8260,5593,0.0,0.0,31,3.0,1,2,35,2044.0,0.4761665463447571,0.2111218124628067
6254511,6023988,5888130,9315,8811,2000,8489,1999,504,826,1.0,0.0,1,1.0,12,3,504,826.0,0.4782286584377289,0.15038196742534637
6256824,5787610,5711473,9322,8251,1998,8062,1998,1071,1260,1.0,0.0,6,1.0,90,2,119,1260.0,0.5839855670928955,0.31734031438827515
6259358,4260980,4514894,9322,1923,1981,3414,1985,7399,5908,0.0,0.0,33,6.0,2,4,56,294.0,0.3947455883026123,0.2500044107437134
6256904,4365423,5760719,9322,2553,1982,8188,1998,6769,1134,1.0,0.0,27,2.0,9,13,259,189.0,0.354948490858078,0.06501348316669464
6258220,4428815,4736456,9322,2952,1984,4478,1988,6370,4844,0.3333333333333333,0.0,23,8.0,2,8,7,1365.0,0.3601124882698059,0.09108467400074005
6261941,6020640,4435173,9329,8797,2000,2987,1984,532,6342,1.0,0.0,3,30.0,6,2,112,42.0,0.3486746549606323,0.14488860964775085
6260536,5572979,4591768,9329,7621,1996,3799,1986,1708,5530,1.0,0.0,6,6.0,9,10,140,2037.0,0.5574909448623657,0.34458208084106445
6262905,4870555,5688594,9329,5017,1989,7992,1997,4312,1337,1.0,0.0,54,3.0,2,13,21,322.0,0.24896490573883057,0.09296619892120361
6261658,4879823,5333522,9329,5066,1989,6788,1994,4263,2541,1.0,0.0,8,1.0,3,3,1148,2541.0,0.4193098545074463,0.27375781536102295
6266602,5480221,5037251,9336,7306,1996,5696,1991,2030,3640,0.3333333333333333,0.0,6,2.0,8,1,112,98.0,0.5182482600212097,0.23223556578159332
6264908,5335609,5827951,9336,6795,1994,8335,1998,2541,1001,0.0,0.0,9,1.0,16,2,63,1001.0,0.24395543336868286,0.02017488144338131
6264899,5474747,4011414,9336,7285,1995,432,1977,2051,8904,1.0,0.0,13,8.0,12,1,21,3010.0,0.4812141954898834,0.2076914757490158
6269153,6049594,4171853,9343,8867,2000,1391,1979,476,7952,1.0,0.0,2,17.0,18,1,301,245.0,0.5895255208015442,0.26555532217025757
6268083,5773163,4418681,9343,8216,1998,2896,1983,1127,6447,1.0,0.0,2,5.0,2,1,350,707.0,0.6426897048950195,0.1631491631269455
6271853,5384588,4737188,9350,6963,1995,4485,1988,2387,4865,0.0,0.0,26,11.0,11,2,42,98.0,0.4847049415111542,0.022896509617567062
6271102,5369060,4657372,9350,6907,1994,4121,1987,2443,5229,0.5,0.0,6,5.0,11,13,399,2954.0,0.6962878704071045,0.3848985433578491
6270802,4767628,4799585,9350,4625,1988,4772,1989,4725,4578,1.0,0.0,80,1.0,3,3,49,4578.0,0.35763418674468994,0.12176618725061417
6270009,5649663,4305617,9350,7873,1997,2175,1981,1477,7175,1.0,0.0,5,8.0,6,1,238,42.0,0.43097174167633057,0.35517457127571106
6273810,4712832,5418732,9357,4366,1987,7082,1995,4991,2275,0.5,0.0,11,5.0,2,4,616,126.0,0.45886167883872986,0.18309247493743896
6273937,4430807,4207356,9357,2966,1984,1622,1980,6391,7735,0.5,0.0,18,10.0,5,5,2919,2618.0,0.334331214427948,0.3094230592250824
6274498,5926722,5430796,9357,8601,1999,7124,1995,756,2233,1.0,0.0,5,6.0,8,5,14,665.0,0.5047261714935303,0.16772398352622986
6278441,5714978,4789752,9364,8069,1998,4723,1988,1295,4641,0.3333333333333333,0.0,31,1.0,10,2,7,4641.0,0.35618942975997925,0.025283997878432274
6278237,5294870,5062142,9364,6648,1994,5780,1991,2716,3584,0.0,0.0,69,7.0,2,4,28,1120.0,0.7359732389450073,0.15611007809638977
6275997,6083185,4075544,9364,8951,2000,782,1978,413,8582,0.0,0.0,1,9.0,10,1,413,4410.0,0.5731590986251831,0.13644053041934967
6282230,5758104,5661242,9371,8181,1998,7908,1997,1190,1463,0.0,0.0,2,1.0,2,7,168,1463.0,0.10989640653133392,0.07774458080530167
6282303,5546471,4525933,9371,7530,1996,3470,1985,1841,5901,1.0,0.0,34,3.0,16,1,49,42.0,0.6180181503295898,0.2979292869567871
6280952,4554088,5195567,9371,3610,1985,6291,1993,5761,3080,0.0,0.0,120,9.0,32,5,42,147.0,0.3467250466346741,0.053920160979032516
6280398,5348555,5259481,9371,6837,1994,6522,1993,2534,2849,1.0,0.0,23,1.0,6,2,98,2849.0,0.20115400850772858,0.220822274684906
6279569,5590648,4747497,9371,7677,1997,4534,1988,1694,4837,1.0,0.0,12,12.0,25,2,98,259.0,0.24703238904476166,0.2664172351360321
6281917,5985975,4131391,9371,8720,1999,1090,1978,651,8281,0.0,0.0,4,6.0,1,2,42,2415.0,0.5252168774604797,0.08093057572841644
6280118,5095975,4382633,9371,5920,1992,2686,1983,3451,6685,1.0,1.0,19,2.0,4,2,56,616.0,0.4203088879585266,0.3140987157821655
6284803,5202128,5505233,9378,6312,1993,7404,1996,3066,1974,1.0,0.0,40,3.0,11,12,49,245.0,0.4753146767616272,0.2987949848175049
6286469,5622155,5599284,9385,7782,1997,7705,1997,1603,1680,1.0,0.0,3,2.0,11,7,28,770.0,0.5984441041946411,0.14516520500183105
6292427,5757701,4502450,9392,8181,1998,3351,1985,1211,6041,1.0,0.0,1,18.0,4,5,1211,903.0,0.4941908121109009,0.20949845016002655
6292394,5991202,4967433,9392,8727,1999,5423,1990,665,3969,1.0,0.0,4,8.0,2,9,56,105.0,0.5195145606994629,0.2483852356672287
6291321,5399522,5859896,9392,7019,1995,8412,1999,2373,980,1.0,0.0,5,1.0,3,2,217,980.0,0.5732852220535278,0.1662948727607727
6291326,5377031,4866119,9392,6935,1994,5003,1989,2457,4389,0.0,0.0,27,3.0,26,12,0,1869.0,0.38095852732658386,0.2704419195652008
6290607,5738596,4319712,9392,8139,1998,2266,1982,1253,7126,1.0,0.0,1,9.0,23,3,1253,1106.0,0.7297133207321167,0.10656989365816116
6294983,5954423,4591652,9399,8664,1999,3799,1986,735,5600,0.0,0.0,2,7.0,4,1,112,812.0,0.4964669346809387,0.05558813363313675
6293696,4956538,4133679,9399,5367,1990,1104,1979,4032,8295,0.0,0.0,76,14.0,3,3,28,294.0,0.5074084997177124,0.14598076045513153
6294416,4906588,4512301,9399,5178,1990,3400,1985,4221,5999,1.0,0.0,15,2.0,18,5,294,903.0,0.44657087326049805,-0.007741440087556839
6295461,6122263,4777209,9399,9028,2000,4667,1988,371,4732,1.0,0.0,1,2.0,8,8,371,175.0,0.550308883190155,-0.021285995841026306
6296185,5426282,4524672,9406,7110,1995,3463,1985,2296,5943,0.5,0.0,28,4.0,4,3,0,84.0,0.59416663646698,0.23338374495506287
6297623,4866590,4296562,9406,5003,1989,2126,1981,4403,7280,0.0,0.0,14,7.0,1,2,112,1211.0,0.4357132315635681,0.1507720798254013
6300407,4336345,5642505,9413,2364,1982,7845,1997,7049,1568,0.5,0.0,11,3.0,15,5,609,133.0,0.47349801659584045,0.13238154351711273
6301397,5528384,5026079,9413,7474,1996,5654,1991,1939,3759,0.0,0.0,13,6.0,2,1,112,931.0,0.4779680371284485,0.16342443227767944
6299590,5376118,5767404,9413,6935,1994,8202,1998,2478,1211,1.0,0.0,18,4.0,62,5,7,168.0,0.4737943708896637,0.18803665041923523
6299575,4666443,4435633,9413,4156,1987,2987,1984,5257,6426,1.0,0.0,27,3.0,5,4,210,182.0,0.5768888592720032,0.1813773363828659
6298685,5382126,5487790,9413,6956,1995,7334,1996,2457,2079,0.0,0.0,11,2.0,8,14,140,511.0,0.4313232898712158,0.17790114879608154
6304816,5889477,4835186,9420,8489,1999,4898,1989,931,4522,0.0,0.0,6,3.0,6,4,70,21.0,0.5949758291244507,0.12784624099731445
6302343,4720057,4943624,9420,4401,1988,5318,1990,5019,4102,1.0,0.0,1,6.0,3,1,5019,938.0,0.566217839717865,0.18978437781333923
6303510,6008132,5630370,9420,8762,1999,7810,1997,658,1610,1.0,0.0,3,4.0,15,3,182,329.0,0.647718071937561,0.1781104952096939
6301861,4941572,5643825,9420,5311,1990,7852,1997,4109,1568,1.0,0.0,174,5.0,4,11,7,392.0,0.3477766513824463,0.1691122055053711
6305172,4872312,4317862,9427,5031,1989,2252,1982,4396,7175,0.0,0.0,9,3.0,2,6,49,315.0,0.6295191049575806,0.1053798720240593
6305937,5775346,5357446,9427,8223,1998,6865,1994,1204,2562,1.0,0.0,4,2.0,13,2,315,525.0,0.4548473060131073,0.30726441740989685
6307441,4748640,5242011,9427,4534,1988,6459,1993,4893,2968,0.5,0.0,8,2.0,4,3,1309,98.0,0.6725443601608276,0.09650085866451263
6312374,5470322,4682755,9441,7271,1995,4226,1987,2170,5215,1.0,0.0,14,8.0,30,7,70,539.0,0.5722252130508423,0.29400330781936646
6313670,5450026,5120168,9441,7194,1995,6004,1992,2247,3437,1.0,0.0,11,7.0,4,1,28,21.0,0.6013268828392029,0.12664492428302765
6311440,4408543,4735728,9441,2840,1983,4478,1988,6601,4963,0.0,0.0,17,11.0,2,5,35,1393.0,0.36859384179115295,0.05031032860279083
6312753,6194020,5428150,9441,9189,2001,7117,1995,252,2324,1.0,0.0,1,16.0,24,2,252,175.0,0.7605506777763367,0.1733873188495636
6312431,5261910,5503297,9441,6529,1993,7397,1996,2912,2044,1.0,0.0,16,9.0,6,23,21,21.0,0.5707842111587524,0.3198568820953369
6317637,5587896,5721857,9448,7663,1996,8090,1998,1785,1358,1.0,0.0,12,3.0,6,18,21,364.0,0.5595371127128601,0.3042944371700287
6315981,5571797,5817975,9448,7614,1996,8314,1998,1834,1134,1.0,0.0,16,2.0,1,3,182,588.0,0.09543794393539429,0.018817521631717682
6314878,5619920,5554206,9448,7775,1997,7558,1996,1673,1890,1.0,0.0,1,5.0,8,5,1673,742.0,0.6330742835998535,0.2943866550922394
6315900,5656373,4984957,9448,7894,1997,5493,1991,1554,3955,0.0,0.0,1,9.0,4,1,1554,77.0,0.31509724259376526,0.29915323853492737
6316120,5747148,5971733,9448,8160,1998,8699,1999,1288,749,1.0,0.0,6,1.0,15,5,238,749.0,0.2927452325820923,0.3453860282897949
6316601,5514788,4921123,9448,7432,1996,5234,1990,2016,4214,0.6666666666666666,0.0,24,5.0,2,4,84,826.0,0.3580615222454071,0.13005010783672333
6316020,5639754,4448356,9448,7838,1997,3057,1984,1610,6391,0.5,0.0,7,14.0,4,2,7,728.0,0.5194830894470215,0.12817423045635223
6318527,5954480,4277636,9455,8664,1999,2014,1981,791,7441,0.0,0.0,1,4.0,9,3,791,4907.0,0.5114002823829651,0.16249535977840424
6318546,4431103,4536550,9455,2966,1984,3519,1985,6489,5936,1.0,0.0,4,13.0,4,2,140,854.0,0.2740468382835388,0.08608592301607132
6319241,5458629,5487952,9455,7229,1995,7334,1996,2226,2121,1.0,0.0,13,3.0,9,7,63,490.0,0.3080562353134155,-0.0339961051940918
6322567,5674221,6042328,9462,7950,1997,8853,2000,1512,609,1.0,0.0,1,1.0,1,15,1512,609.0,0.35226935148239136,0.25246351957321167
6323810,6181281,4525438,9462,9161,2001,3463,1985,301,5999,1.0,1.0,1,7.0,5,5,301,273.0,0.6672292351722717,0.22239871323108673
6326767,5686810,4761759,9469,7985,1997,4597,1988,1484,4872,0.0,0.0,2,12.0,3,2,1127,798.0,0.45256495475769043,0.1329142153263092
6326106,5643698,4023153,9469,7852,1997,495,1977,1617,8974,1.0,0.0,1,5.0,1,2,1617,1218.0,0.38883352279663086,0.27009260654449463
6329236,6010931,4614869,9476,8769,2000,3925,1986,707,5551,1.0,0.0,8,8.0,5,4,21,175.0,0.3969065845012665,0.13039599359035492
6332215,5784584,5174887,9483,8237,1998,6207,1992,1246,3276,1.0,0.0,1,8.0,2,24,1246,21.0,0.42857590317726135,0.14417289197444916
6330755,4909695,6062697,9483,5192,1990,8902,2000,4291,581,0.0,0.0,25,4.0,13,13,35,203.0,0.6201227307319641,0.1874377578496933
6331311,5725491,4157981,9483,8104,1998,1258,1979,1379,8225,1.0,0.0,4,7.0,30,2,434,1890.0,0.46754521131515503,0.08360752463340759
6332096,5534018,4359156,9483,7495,1996,2511,1982,1988,6972,1.0,0.0,20,5.0,17,1,35,84.0,0.5487292408943176,0.027152152732014656
6332064,5812905,4359174,9483,8300,1998,2511,1982,1183,6972,1.0,0.0,2,12.0,3,5,455,665.0,0.6978779435157776,0.14157089591026306
6332840,5791994,6175434,9490,8258,1998,9147,2001,1232,343,0.5,0.0,15,1.0,5,7,7,343.0,0.6678070425987244,0.43853750824928284
6334035,5475470,6021909,9490,7285,1995,8804,2000,2205,686,1.0,0.0,42,4.0,13,6,14,140.0,0.2812545597553253,0.29104986786842346
6333597,5838105,5275819,9490,8356,1998,6578,1994,1134,2912,1.0,0.0,4,8.0,6,6,224,28.0,0.7363611459732056,0.33366018533706665
6333074,6063438,4567592,9490,8902,2000,3680,1986,588,5810,0.0,0.0,1,14.0,7,6,588,1204.0,0.5774520039558411,0.07484354823827744
6337078,5720967,5987741,9504,8090,1998,8727,1999,1414,777,1.0,0.0,5,2.0,1,4,7,154.0,0.38668861985206604,0.2854495942592621
6339438,5850531,4495471,9511,8384,1998,3309,1985,1127,6202,0.0,0.0,4,3.0,6,1,56,1316.0,0.3578645586967468,0.27410054206848145
6338901,5425983,4232726,9511,7110,1995,1776,1980,2401,7735,0.0,0.0,16,9.0,3,1,14,931.0,0.504483699798584,0.30070531368255615
6340912,5928552,4759864,9518,8608,1999,4590,1988,910,4928,0.0,0.0,1,9.0,7,4,910,126.0,0.5701030492782593,0.006831175647675991
6340240,5083870,4311290,9518,5871,1992,2210,1982,3647,7308,1.0,0.0,10,5.0,3,1,175,1939.0,0.6232913732528687,0.23160624504089355
6342964,6124962,5044664,9525,9035,2000,5724,1991,490,3801,1.0,0.0,2,3.0,3,5,203,2317.0,0.735373318195343,0.24195271730422974
6343042,4807197,5468714,9525,4800,1989,7264,1995,4725,2261,1.0,0.0,4,3.0,2,7,189,392.0,0.26410526037216187,0.2880806028842926
6342120,5209723,5176117,9525,6340,1993,6214,1993,3185,3311,0.5,0.0,19,6.0,24,7,14,280.0,0.5518018007278442,0.010658110491931438
6343946,5645441,5180688,9532,7859,1997,6228,1993,1673,3304,1.0,1.0,3,6.0,4,12,63,273.0,0.6406198740005493,0.09155574440956116
6346583,5717010,5104345,9539,8076,1998,5948,1992,1463,3591,1.0,0.0,5,3.0,5,10,189,1190.0,0.5082623362541199,0.18582220375537872
6350386,5994222,4892325,9553,8734,1999,5122,1990,819,4431,1.0,0.0,5,5.0,19,6,105,301.0,0.47965899109840393,0.18352481722831726
6350761,5691364,5119663,9553,7999,1997,6004,1992,1554,3549,1.0,0.0,20,4.0,2,4,0,455.0,0.7289082407951355,0.16688527166843414
6350095,4673119,4527358,9553,4184,1987,3477,1985,5369,6076,0.0,0.0,13,9.0,10,1,126,644.0,0.345438688993454,0.28863826394081116
6349649,4841864,4302212,9553,4926,1989,2154,1981,4627,7399,1.0,0.0,6,23.0,7,3,119,3248.0,0.4533687233924866,0.3365787863731384
6350571,5541076,5996118,9553,7516,1996,8741,1999,2037,812,0.5,0.0,1,1.0,3,8,2037,812.0,0.4851052761077881,0.04401808977127075
6351786,5321962,4457311,9553,6746,1994,3106,1984,2807,6447,0.0,0.0,19,16.0,19,14,154,14.0,0.2964068055152893,0.16563323140144348
6353480,5129048,6022118,9560,6032,1992,8804,2000,3528,756,1.0,0.0,14,2.0,1,7,105,70.0,0.549665093421936,0.3062642216682434
6356731,5446527,4508970,9567,7180,1995,3379,1985,2387,6188,1.0,0.0,2,21.0,13,2,917,630.0,0.6013275384902954,0.3523242771625519
6354129,5694801,5545704,9567,8013,1997,7530,1996,1554,2037,1.0,0.0,4,1.0,9,5,98,2037.0,0.5934768319129944,0.09302007406949997
6355121,5413648,4694028,9567,7068,1995,4275,1987,2499,5292,0.25,0.0,1,5.0,3,11,2499,791.0,0.3180754780769348,0.19612696766853333
6360346,5500826,6213736,9574,7383,1996,9231,2001,2191,343,1.0,0.0,5,1.0,21,6,329,343.0,0.49352747201919556,0.22482244670391083
6358788,4554050,5035590,9574,3610,1985,5689,1991,5964,3885,0.0,0.0,10,2.0,1,1,525,392.0,0.4020100235939026,0.11907797306776047
6357145,5638614,4252793,9574,7838,1997,1881,1981,1736,7693,1.0,0.0,9,14.0,5,2,273,301.0,0.4425170421600342,0.21261493861675262
6359321,4774202,5511278,9574,4653,1988,7425,1996,4921,2149,1.0,0.0,20,1.0,9,1,84,2149.0,0.35945069789886475,0.17882399260997772
6361554,6015387,5626195,9581,8783,2000,7796,1997,798,1785,1.0,0.0,3,4.0,3,18,147,175.0,0.40104785561561584,0.12530696392059326
6363171,5105468,5052359,9581,5948,1992,5752,1991,3633,3829,1.0,0.0,50,3.0,10,8,224,1309.0,0.484014630317688,0.2740669250488281
6360462,4621837,4961701,9581,3967,1986,5395,1990,5614,4186,0.3333333333333333,0.0,40,1.0,10,7,105,4186.0,0.28584036231040955,0.30905357003211975
6369750,6197722,5238015,9595,9196,2001,6445,1993,399,3150,1.0,0.0,1,4.0,5,6,399,1792.0,0.49474236369132996,0.1915566623210907
6367876,4640547,4103184,9595,4051,1987,936,1978,5544,8659,1.0,0.0,22,2.0,1,1,287,3493.0,0.5763741135597229,0.29722267389297485
6368396,5209814,5286903,9595,6340,1993,6620,1994,3255,2975,0.0,0.5,57,3.0,1,1,0,777.0,0.257125586271286,0.20100586116313934
6370401,6059213,5395054,9595,8895,2000,7005,1995,700,2590,0.0,0.0,2,8.0,18,8,126,434.0,0.37814831733703613,0.12126783281564713
6368025,5915886,4270003,9595,8580,1999,1972,1981,1015,7623,1.0,0.0,2,1.0,10,1,714,7623.0,0.9999999403953552,0.13286232948303223
6369882,5022644,5307876,9595,5640,1991,6697,1994,3955,2898,0.0,0.0,15,5.0,8,46,49,259.0,0.4560154378414154,0.13801102340221405
6370074,5566107,4186635,9595,7593,1996,1496,1980,2002,8099,0.5,0.0,36,3.0,3,2,42,6790.0,0.48448845744132996,0.37408703565597534
6369834,5266875,6128875,9595,6543,1993,9049,2000,3052,546,0.0,0.0,14,1.0,8,3,77,546.0,0.3811812400817871,0.22777234017848969
6370354,5255062,5531290,9595,6501,1993,7488,1996,3094,2107,1.0,0.0,3,1.0,9,11,2170,2107.0,0.4132053256034851,0.09774968028068542
6370290,5208819,4853425,9595,6333,1993,4961,1989,3262,4634,0.0,0.0,26,1.0,5,2,0,4634.0,0.5308069586753845,0.13687683641910553
6372975,4402244,4807494,9602,2805,1983,4807,1989,6797,4795,1.0,0.0,15,5.0,2,3,476,98.0,0.5168336629867554,0.3003821074962616
6373230,5281905,4100229,9602,6599,1994,922,1978,3003,8680,1.0,0.0,13,13.0,8,2,245,3052.0,0.4426923096179962,0.0860469788312912
6373400,6150956,5823386,9602,9091,2000,8328,1998,511,1274,1.0,0.0,1,5.0,11,5,511,434.0,0.4666979908943176,0.39376065135002136
6374260,5786856,4069162,9602,8244,1998,747,1978,1358,8855,0.0,0.0,4,8.0,17,1,7,4186.0,0.4751422703266144,0.20806026458740234
6376452,5098595,4479673,9609,5927,1992,3225,1984,3682,6384,0.3333333333333333,0.0,16,21.0,7,2,168,1512.0,0.39720478653907776,0.09356406331062317
6377986,5804803,4616353,9609,8286,1998,3932,1986,1323,5677,1.0,0.0,35,8.0,10,7,0,1274.0,0.5971658229827881,0.3075568675994873
6376819,5164578,4152417,9609,6165,1992,1216,1979,3444,8393,1.0,0.0,5,2.0,4,3,371,4921.0,0.4528422951698303,0.1190529316663742
6374536,5329726,6172792,9609,6774,1994,9140,2001,2835,469,1.0,0.0,41,1.0,2,11,7,469.0,0.7174351215362549,0.30666637420654297
6377827,5995052,4261710,9609,8734,1999,1930,1981,875,7679,0.5,0.0,12,23.0,3,4,63,112.0,0.5822578072547913,0.2685210704803467
6381063,5731892,5001667,9616,8118,1998,5556,1991,1498,4060,1.0,0.0,9,1.0,7,2,84,4060.0,0.5051577091217041,0.35802796483039856
6381324,5680446,5768141,9616,7964,1997,8202,1998,1652,1414,1.0,0.0,15,9.0,19,3,182,140.0,0.37850648164749146,0.2879749834537506
6379316,4349015,4672333,9616,2448,1982,4177,1987,7168,5439,1.0,0.0,31,1.0,1,2,98,5439.0,0.41158461570739746,0.24609515070915222
6381445,5603096,4525933,9616,7712,1997,3470,1985,1904,6146,1.0,0.0,38,4.0,6,1,14,133.0,0.45028045773506165,0.1609494537115097
6384275,4851381,5029903,9623,4954,1989,5668,1991,4669,3955,0.0,0.0,9,11.0,3,8,7,63.0,0.5121285319328308,0.19114093482494354
6382342,4869334,4069878,9623,5017,1989,754,1978,4606,8869,1.0,0.0,27,2.0,1,5,126,3318.0,0.5077646374702454,0.2683883011341095
6389026,5144622,5680697,9630,6088,1992,7971,1997,3542,1659,1.0,0.0,42,1.0,5,6,0,1659.0,0.4362788200378418,0.1532680243253708
6389402,5355474,5849040,9630,6858,1994,8384,1998,2772,1246,0.5,0.0,61,4.0,14,1,49,210.0,0.41078707575798035,0.0936640128493309
6388870,6102721,5587220,9630,8993,2000,7663,1996,637,1967,0.0,0.0,3,3.0,2,7,63,1050.0,0.33395084738731384,0.23400677740573883
6388226,4853250,5502441,9630,4961,1989,7390,1996,4669,2240,0.0,0.0,45,6.0,5,1,119,266.0,0.4922111928462982,0.07658477872610092
6389536,6044463,5567143,9630,8853,2000,7600,1996,777,2030,1.0,0.0,1,1.0,8,3,777,2030.0,0.475138396024704,0.1870812177658081
6389478,6236835,5711191,9630,9273,2001,8062,1998,357,1568,0.0,0.0,1,1.0,4,7,357,1568.0,0.34156113862991333,0.08346370607614517
6389065,5469495,4734632,9630,7264,1995,4471,1988,2366,5159,1.0,0.0,42,6.0,26,2,7,819.0,0.22327718138694763,0.22769474983215332
6387790,6303490,4431472,9630,9420,2001,2966,1984,210,6664,1.0,0.0,2,21.0,5,2,7,189.0,0.6800775527954102,0.48952606320381165
6391038,4747407,4660526,9637,4534,1988,4135,1987,5103,5502,1.0,0.0,42,3.0,6,4,35,3003.0,0.5610083937644958,0.13979770243167877
6389795,6079198,5334775,9637,8944,2000,6788,1994,693,2849,1.0,0.0,3,3.0,6,17,7,455.0,0.5637205243110657,0.3256329298019409
6390760,4768361,5517915,9637,4632,1988,7446,1996,5005,2191,0.0,0.0,7,3.0,7,8,532,840.0,0.6086796522140503,0.29471665620803833
6392275,5411901,5658543,9637,7061,1995,7901,1997,2576,1736,1.0,0.0,2,6.0,5,6,483,777.0,0.4818725883960724,0.2142162024974823
6394299,5871067,5147520,9644,8447,1999,6102,1992,1197,3542,0.0,0.0,2,22.0,2,9,21,119.0,0.3680349290370941,0.39921942353248596
6396776,6160769,6159689,9644,9112,2000,9112,2000,532,532,1.0,0.0,6,1.0,5,5,28,532.0,0.5267451405525208,0.3162814974784851
6395884,5356804,4533437,9644,6865,1994,3505,1985,2779,6139,0.5,0.0,5,22.0,3,3,294,126.0,0.5889638066291809,-0.04040442034602165
6397569,5713190,4215640,9651,8069,1998,1678,1980,1582,7973,1.0,0.0,3,5.0,3,1,441,4963.0,0.5071713924407959,0.2939029932022095
6401145,6185221,4671325,9651,9168,2001,4177,1987,483,5474,0.0,0.0,2,5.0,12,3,119,1358.0,0.6429969668388367,0.24828459322452545
6398148,4917323,5086348,9651,5220,1990,5878,1992,4431,3773,1.0,0.0,17,4.0,4,2,364,756.0,0.552462100982666,0.20795802772045135
6401621,4145971,4807494,9658,1181,1979,4807,1989,8477,4851,1.0,0.0,11,5.0,1,3,707,154.0,0.605331540107727,0.24159686267375946
6402937,5244565,4381716,9658,6466,1993,2679,1983,3192,6979,1.0,0.0,5,16.0,4,6,308,595.0,0.592298150062561,0.23375657200813293
6403283,5238781,6061594,9658,6445,1993,8895,2000,3213,763,1.0,0.0,5,1.0,6,11,651,763.0,0.44643908739089966,0.15853570401668549
6403132,5230761,4357190,9658,6417,1993,2497,1982,3241,7161,0.0,0.0,17,5.0,5,10,63,3948.0,0.193474680185318,0.328174352645874
6408152,5994011,5097335,9665,8734,1999,5920,1992,931,3745,1.0,0.0,3,1.0,9,7,7,3745.0,0.7164554595947266,0.151199609041214
6411276,5625576,4832785,9672,7789,1997,4891,1989,1883,4781,0.0,0.0,79,2.0,21,10,14,3794.0,0.2935487627983093,0.15474581718444824
6413924,5679661,4404753,9679,7964,1997,2819,1983,1715,6860,0.0,0.0,5,13.0,13,1,70,147.0,0.5078622102737427,0.15440303087234497
6415420,5530841,4419793,9679,7481,1996,2903,1983,2198,6776,1.0,0.0,13,2.0,35,1,105,4802.0,0.5528665781021118,0.10696901381015778
6413796,5932345,4292127,9679,8615,1999,2098,1981,1064,7581,0.0,0.0,2,2.0,3,1,553,6048.0,0.4068518877029419,0.2502833306789398
6412213,4663995,5100632,9679,4149,1987,5934,1992,5530,3745,0.0,0.0,16,10.0,3,3,665,259.0,0.3688097596168518,0.19103342294692993
6417578,4494007,4058811,9686,3302,1985,684,1977,6384,9002,0.5,0.0,9,9.0,10,2,532,581.0,0.47041741013526917,0.30593544244766235
6417638,5053976,4392656,9686,5752,1991,2749,1983,3934,6937,0.0,0.0,14,3.0,8,1,119,3829.0,0.2600362300872803,0.06854838877916336
6417278,5779562,5669568,9686,8230,1998,7936,1997,1456,1750,0.5,0.0,44,3.0,28,3,7,602.0,0.4187586307525635,0.17644251883029938
6417982,4942609,4445153,9686,5311,1990,3036,1984,4375,6650,1.0,1.0,15,22.0,6,8,63,70.0,0.4757451117038727,0.564757764339447
6417563,6310773,4016033,9686,9434,2001,460,1977,252,9226,1.0,0.0,1,5.0,4,1,252,441.0,0.5605517029762268,0.20958848297595978
6421149,5442623,4004847,9693,7166,1995,390,1977,2527,9303,1.0,0.0,35,9.0,14,1,49,5621.0,0.46354129910469055,0.34203454852104187
6418679,4941300,4053840,9693,5311,1990,649,1977,4382,9044,0.5,0.0,8,8.0,5,1,1015,6111.0,0.5794956088066101,0.1729268580675125
6418694,4229915,4364755,9693,1762,1980,2546,1982,7931,7147,1.0,0.0,11,7.0,1,1,224,1386.0,0.3570646047592163,0.35152873396873474
6419643,4883455,4614365,9693,5080,1989,3925,1986,4613,5768,1.0,0.0,46,4.0,6,1,56,1267.0,0.5074409246444702,0.30127331614494324
6421425,6219413,4117705,9693,9238,2001,1006,1978,455,8687,1.0,0.0,3,7.0,8,2,35,2373.0,0.49803265929222107,0.06242435425519943
6419202,6095480,4965727,9693,8979,2000,5409,1990,714,4284,1.0,0.0,2,4.0,4,1,56,665.0,0.6579392552375793,0.19334611296653748
6424328,5798744,5161081,9700,8272,1998,6151,1992,1428,3549,1.0,0.0,6,10.0,6,11,126,315.0,0.28316640853881836,0.08161817491054535
re37805,4556614,4195844,9700,3624,1985,1552,1980,6076,8148,0.0,0.0,54,3.0,4,3,105,5621.0,0.4386710226535797,0.09945065528154373
6423556,5233191,5296711,9700,6424,1993,6655,1994,3276,3045,1.0,0.0,18,1.0,10,3,28,3045.0,0.3853214383125305,0.20205819606781006
6422444,5954255,4939428,9700,8664,1999,5297,1990,1036,4403,0.5,0.0,5,5.0,5,5,91,854.0,0.44843536615371704,0.13312095403671265
6425393,4077404,5110229,9707,796,1978,5969,1992,8911,3738,0.0,0.0,46,5.0,1,7,133,1981.0,0.6664526462554932,0.10352091491222382
6427359,5664337,5075429,9714,7922,1997,5836,1991,1792,3878,0.5,0.0,10,1.0,38,5,112,3878.0,0.5679192543029785,0.24295338988304138
6427752,5310165,4071713,9714,6704,1994,761,1978,3010,8953,1.0,0.0,18,10.0,11,1,105,5145.0,0.5080947279930115,0.21003997325897217
6433058,5651862,5418750,9721,7880,1997,7082,1995,1841,2639,0.0,0.0,12,10.0,16,3,14,35.0,0.3671570420265198,0.07536863535642624
6433445,5773901,4752714,9721,8216,1998,4555,1988,1505,5166,1.0,1.0,6,6.0,7,2,0,2240.0,0.3186432123184204,0.2089911699295044
6432025,5651752,4596993,9721,7880,1997,3827,1986,1841,5894,0.0,0.0,3,12.0,5,7,98,1050.0,0.5735318660736084,0.15227153897285461
6432932,5622721,4004115,9721,7782,1997,383,1977,1939,9338,1.0,0.0,10,7.0,4,2,231,931.0,0.48758214712142944,0.10375320911407471
6434587,5706481,4224027,9721,8041,1998,1727,1980,1680,7994,1.0,0.0,20,3.0,9,2,7,6818.0,0.37176239490509033,0.022909391671419144
6434468,4486838,5128832,9721,3260,1984,6032,1992,6461,3689,0.0,0.0,17,4.0,6,3,616,777.0,0.5428027510643005,0.1420109122991562
6438614,5978484,4107675,9728,8706,1999,957,1978,1022,8771,0.0,0.0,8,10.0,9,1,14,287.0,0.3736375570297241,0.2577812671661377
6435235,6123124,6253734,9728,9035,2000,9315,2001,693,413,1.0,0.0,3,1.0,8,6,56,413.0,0.5633048415184021,0.304343581199646
6435790,4762437,4450420,9728,4604,1988,3064,1984,5124,6664,1.0,0.0,25,3.0,5,2,126,4942.0,0.4398959279060364,0.15452831983566284
6435159,5086735,4170852,9728,5885,1992,1384,1979,3843,8344,1.0,0.0,2,6.0,4,2,1722,1008.0,0.5352583527565002,0.37164539098739624
6439407,5507596,4448842,9735,7411,1996,3057,1984,2324,6678,0.0,0.0,3,14.0,11,3,175,4025.0,0.28495508432388306,-0.006054573226720095
6445489,5737115,4543228,9742,8132,1998,3554,1985,1610,6188,0.3333333333333333,0.0,31,4.0,52,2,7,1890.0,0.30378878116607666,-0.012788336724042892
6445398,5629733,4994251,9742,7803,1997,5528,1991,1939,4214,1.0,0.0,57,6.0,9,5,7,1680.0,0.5759962201118469,0.023822488263249397
6443627,5647043,5184340,9742,7859,1997,6242,1993,1883,3500,1.0,0.0,16,6.0,5,4,84,1148.0,0.5971881747245789,0.16963669657707214
6446732,5584344,5292134,9749,7656,1996,6641,1994,2093,3108,1.0,0.0,5,2.0,17,7,245,875.0,0.709354043006897,0.25982940196990967
6452170,5719324,4577713,9756,8083,1998,3736,1986,1673,6020,0.0,0.0,22,9.0,3,1,28,140.0,0.5156102180480957,0.2208547741174698
6452332,5036317,5746052,9756,5689,1991,8160,1998,4067,1596,0.0,0.0,35,9.0,7,7,35,21.0,0.38910937309265137,0.0959467738866806
6452789,6175490,5201046,9756,9147,2001,6305,1993,609,3451,0.5,1.0,6,17.0,265,3,14,7.0,0.5059670209884644,0.25125226378440857
6454565,5975893,4343850,9763,8706,1999,2413,1982,1057,7350,1.0,0.0,13,5.0,34,3,42,5509.0,0.7793906927108765,0.1493779569864273
6458503,4126601,4274464,9770,1055,1978,2000,1981,8715,7770,0.5,0.0,5,5.0,3,1,2093,2730.0,0.47994789481163025,0.19680961966514587
6460023,5636277,4017118,9770,7824,1997,467,1977,1946,9303,0.0,0.0,15,30.0,4,1,21,546.0,0.6142131090164185,0.13421249389648438
6458672,5206749,6135478,9770,6326,1993,9063,2000,3444,707,0.0,0.0,69,1.0,44,11,14,707.0,0.3117554485797882,0.216630220413208
6462919,5578342,5012011,9777,7635,1996,5598,1991,2142,4179,0.0,0.0,17,6.0,3,1,133,350.0,0.36502328515052795,0.13524283468723297
6463431,5459861,4685248,9777,7229,1995,4240,1987,2548,5537,1.0,0.0,9,4.0,9,5,161,2758.0,0.3466111421585083,0.029476087540388107
6463585,5343516,6299966,9777,6816,1994,9413,2001,2961,364,1.0,0.0,62,1.0,16,33,14,364.0,0.41507023572921753,0.13882611691951752
6465565,5324764,4561910,9784,6753,1994,3652,1985,3031,6132,0.0,0.0,15,2.0,3,5,14,5145.0,0.30188697576522827,0.07657763361930847
6465561,5784257,4035500,9784,8237,1998,558,1977,1547,9226,0.0,0.0,10,9.0,10,3,7,21.0,0.31399980187416077,0.25569626688957214
6466599,5239553,4447482,9784,6445,1993,3050,1984,3339,6734,1.0,0.0,6,4.0,3,8,70,161.0,0.6554181575775146,0.45669350028038025
6465975,5444341,5174018,9784,7173,1995,6207,1992,2611,3577,1.0,0.0,15,4.0,12,7,49,119.0,0.6026778817176819,-0.06920287013053894
6463938,5071776,h230,9784,5822,1991,4079,1987,3962,5705,0.0,0.0,28,4.0,5,2,7,1092.0,0.49627479910850525,0.22651110589504242
6466082,6127741,4035070,9784,9042,2000,558,1977,742,9226,0.0,0.0,2,4.0,4,1,98,5425.0,0.1910443753004074,0.3508082330226898
6467544,5377755,4352496,9791,6942,1995,2469,1982,2849,7322,1.0,0.0,13,5.0,4,2,56,2163.0,0.6935797333717346,0.2881620526313782
6468480,5651800,5030628,9791,7880,1997,5668,1991,1911,4123,0.0,0.0,8,2.0,16,2,476,147.0,0.5577260255813599,0.11038810759782791
6470974,6105690,4414117,9798,9000,2000,2868,1983,798,6930,1.0,0.0,6,3.0,17,5,7,1512.0,0.34890076518058777,0.10821431130170822
6473196,5440403,4955159,9798,7159,1995,5367,1990,2639,4431,0.5,0.0,14,10.0,3,6,105,77.0,0.444077730178833,0.15133510529994965
6472561,4009124,4454006,9798,418,1977,3085,1984,9380,6713,0.0,0.0,17,7.0,1,1,371,91.0,0.5416460037231445,0.18383710086345673
6471337,4719472,6185848,9798,4394,1988,9175,2001,5404,623,0.0,0.0,43,1.0,9,17,147,623.0,0.6281551122665405,0.23719877004623413
6472850,5552696,4483682,9798,7551,1996,3246,1984,2247,6552,0.5,0.0,4,4.0,5,4,56,2856.0,0.5331390500068665,0.3117024302482605
6473761,6233601,5647453,9798,9266,2001,7866,1997,532,1932,1.0,0.0,6,9.0,1,5,14,42.0,0.691180944442749,0.20254148542881012
6476903,6009410,5790939,9805,8762,1999,8251,1998,1043,1554,0.0,0.5,50,7.0,6,9,21,28.0,0.3636443018913269,0.2720063626766205
6474474,4728405,5721219,9805,4443,1988,8090,1998,5362,1715,0.0,0.0,1,3.0,5,1,5362,385.0,0.15023016929626465,0.2367747575044632
6475463,5441721,5129134,9805,7166,1995,6039,1992,2639,3766,1.0,0.0,7,1.0,10,5,1148,3766.0,0.3518267571926117,0.018437199294567108
6479090,4950490,4380918,9812,5346,1990,2672,1983,4466,7140,0.0,0.0,21,6.0,2,3,518,945.0,0.38401907682418823,0.08790608495473862
6479219,4173470,5003341,9812,1405,1979,5563,1991,8407,4249,0.5,1.0,36,1.0,1,1,238,4249.0,0.40424761176109314,0.13255904614925385
6478936,5516412,5693900,9812,7439,1996,8006,1997,2373,1806,1.0,0.0,30,2.0,9,4,63,1211.0,0.476278156042099,0.10675162076950073
6479344,5486488,6100906,9812,7327,1996,8986,2000,2485,826,1.0,0.0,42,6.0,7,1,63,42.0,0.49223408102989197,0.17285384237766266
6481192,5172539,6013714,9819,6200,1992,8776,2000,3619,1043,1.0,0.0,12,1.0,3,5,490,1043.0,0.7049939632415771,0.21737845242023468
6484414,4715764,4697089,9826,4380,1987,4289,1987,5446,5537,0.0,0.0,49,12.0,4,3,21,469.0,0.434487521648407,0.18952244520187378
6489297,5428015,4444157,9833,7117,1995,3036,1984,2716,6797,1.0,0.0,4,3.0,1,4,413,966.0,0.7094756364822388,0.07219227403402328
6493873,5105268,5727874,9840,5948,1992,8111,1998,3892,1729,1.0,0.0,31,5.0,3,9,63,140.0,0.5721907615661621,0.30766427516937256
6492995,5917484,5611406,9840,8580,1999,7747,1997,1260,2093,1.0,0.0,8,3.0,5,1,49,371.0,0.5766786932945251,0.24191826581954956
6493127,6330098,4565726,9840,9476,2001,3673,1986,364,6167,0.5,0.0,1,7.0,6,9,364,4193.0,0.7964892387390137,0.2327326387166977
6495633,5253871,6250054,9847,6501,1993,9308,2001,3346,539,1.0,0.0,87,1.0,7,3,0,539.0,0.8167774081230164,0.05753737688064575
6495656,4999388,4807305,9847,5549,1991,4807,1989,4298,5040,1.0,0.0,21,3.0,6,5,406,3675.0,0.49684444069862366,0.07823473960161209
6494078,4994096,5168372,9847,5528,1991,6179,1992,4319,3668,0.5,0.0,32,21.0,9,13,448,273.0,0.49483606219291687,0.23039723932743073
6497083,5848514,6016757,9854,8384,1998,8790,2000,1470,1064,1.0,0.0,1,1.0,4,1,1470,1064.0,0.5750176906585693,0.2863929867744446
6498820,4319334,4418737,9854,2259,1982,2896,1983,7595,6958,0.5,0.0,6,17.0,6,3,4648,84.0,0.4504542648792267,0.12291476130485535
6501584,5901000,5545768,9861,8524,1999,7530,1996,1337,2331,1.0,0.0,2,1.0,7,12,161,2331.0,0.8279417157173157,-0.005215942859649658
6500453,4485045,6002044,9861,3253,1984,8748,1999,6608,1113,0.3333333333333333,0.5,42,2.0,2,5,231,791.0,0.35133954882621765,0.15075771510601044
6499661,5347121,5016450,9861,6830,1994,5619,1991,3031,4242,1.0,0.0,32,4.0,30,2,14,735.0,0.3058565557003021,0.04713621735572815
6500239,4743299,6277753,9861,4513,1988,9364,2001,5348,497,0.0,0.0,8,3.0,28,98,77,154.0,0.1731114685535431,0.32816439867019653
6502646,5511785,4557544,9868,7425,1996,3631,1985,2443,6237,0.5,0.0,8,16.0,10,2,189,903.0,0.6247298121452332,0.2968829572200775
6504926,5452289,4843277,9868,7201,1995,4926,1989,2667,4942,1.0,0.0,80,4.0,89,4,70,1526.0,0.6862185001373291,0.12504759430885315
6506097,5640242,5426299,9875,7838,1997,7110,1995,2037,2765,0.0,0.0,17,2.0,6,1,28,910.0,0.5107477903366089,0.24193550646305084
6506208,5569164,4415418,9875,7607,1996,2875,1983,2268,7000,1.0,0.0,35,19.0,6,1,56,665.0,0.6256073117256165,0.33409246802330017
6508135,5035147,4165642,9882,5689,1991,1335,1979,4193,8547,1.0,1.0,23,12.0,4,1,154,161.0,0.5275459289550781,0.04989667981863022
6511412,5904666,5831615,9889,8538,1999,8342,1998,1351,1547,1.0,0.0,4,7.0,19,1,343,245.0,0.442129909992218,0.30879488587379456
6511706,5453494,4222689,9889,7208,1995,1720,1980,2681,8169,0.0,0.0,47,7.0,28,1,21,812.0,0.4616333544254303,0.1439356803894043
6514286,4946467,5397396,9896,5332,1990,7012,1995,4564,2884,1.0,0.0,9,4.0,7,6,56,735.0,0.196992427110672,0.21152697503566742
6516024,5021950,4633387,9896,5633,1991,4016,1986,4263,5880,0.0,0.0,35,23.0,10,17,28,28.0,0.22206075489521027,0.24769414961338043
6516897,5813480,4469366,9903,8307,1998,3169,1984,1596,6734,1.0,0.0,8,7.0,33,4,77,4137.0,0.3708871006965637,0.40435099601745605
6524877,5583369,4511940,9917,7649,1996,3393,1985,2268,6524,1.0,0.0,36,7.0,6,3,112,1582.0,0.5827329754829407,0.3146715462207794
6524637,5126151,5299812,9917,6025,1992,6669,1994,3892,3248,1.0,0.0,21,5.0,9,14,21,1659.0,0.5860297083854675,0.24956244230270386
6527457,5515467,5536169,9924,7432,1996,7502,1996,2492,2422,1.0,0.0,7,2.0,9,15,336,434.0,0.5856006741523743,0.28472408652305603
6528761,5670773,4338724,9924,7936,1997,2385,1982,1988,7539,0.0,0.0,6,5.0,5,2,315,1862.0,0.5625804662704468,0.30246230959892273
6527747,4790828,4929482,9924,4730,1988,5262,1990,5194,4662,1.0,0.0,85,6.0,1,5,182,63.0,0.5340563654899597,0.17554235458374023
6530115,5280665,4666539,9931,6599,1994,4156,1987,3332,5775,0.0,0.0,6,5.0,13,1,1764,2436.0,0.5179734230041504,0.16176164150238037
6531013,5126210,5708220,9931,6025,1992,8048,1998,3906,1883,0.0,0.0,5,6.0,8,8,1099,175.0,0.5869718790054321,0.17019698023796082
6531997,5070326,4447753,9931,5815,1991,3050,1984,4116,6881,1.0,0.0,24,13.0,6,5,28,658.0,0.41218385100364685,0.08834820240736008
6532439,5781446,5624164,9931,8230,1998,7789,1997,1701,2142,0.5,0.0,8,7.0,12,9,7,308.0,0.2478865385055542,0.2747950553894043
6531695,5923042,5496437,9931,8594,1999,7369,1996,1337,2562,0.0,1.0,10,3.0,14,4,77,1197.0,0.5161466598510742,0.12115666270256042
6534991,4780786,4782534,9938,4681,1988,4695,1988,5257,5243,0.5,0.0,90,8.0,4,3,7,826.0,0.30222803354263306,0.06717134267091751
6533593,4937404,4298947,9938,5290,1990,2133,1981,4648,7805,1.0,0.0,10,10.0,5,4,21,497.0,0.5509284138679504,0.10317512601613998
6533803,5380411,5399171,9938,6949,1995,7019,1995,2989,2919,0.0,1.0,51,5.0,4,30,14,826.0,0.44336235523223877,0.14355285465717316
6535108,5001933,4403717,9938,5563,1991,2812,1983,4375,7126,0.0,0.0,27,3.0,8,4,329,1876.0,0.38015371561050415,0.2230476289987564
6534023,5968352,4596113,9938,8692,1999,3827,1986,1246,6111,0.5,0.0,11,5.0,1,2,14,1008.0,0.4792712330818176,0.09484125673770905
6534147,4448835,4544141,9938,3057,1984,3561,1985,6881,6377,1.0,0.0,6,7.0,1,4,4410,126.0,0.401612251996994,0.17977066338062286
6535096,5146905,4911775,9938,6102,1992,5199,1990,3836,4739,0.0,0.0,6,22.0,5,1,168,203.0,0.69346022605896,0.1698647290468216
6533456,5174445,6028542,9938,6207,1992,8818,2000,3731,1120,1.0,0.0,3,3.0,7,1,182,91.0,0.3375806510448456,0.039114102721214294
6537851,6017812,6371678,9945,8790,2000,9602,2002,1155,343,1.0,0.0,10,1.0,3,11,56,343.0,0.2545723021030426,0.28787899017333984
6538650,6362826,4484663,9945,9581,2002,3253,1984,364,6692,1.0,0.0,1,4.0,11,1,364,147.0,0.41429638862609863,0.12469765543937683
6539501,5765152,4215270,9945,8195,1998,1671,1980,1750,8274,1.0,0.0,66,1.0,16,3,28,8274.0,0.09644515812397003,0.25837478041648865
6537471,5741531,4773300,9945,8146,1998,4653,1988,1799,5292,1.0,0.0,2,10.0,12,3,266,406.0,0.38247984647750854,0.20357568562030792
6536167,6134849,4237937,9945,9063,2000,1804,1980,882,8141,1.0,0.0,5,9.0,5,3,147,3535.0,0.49029916524887085,0.2259536236524582
6540734,5836965,4792320,9952,8356,1998,4737,1988,1596,5215,1.0,0.0,31,11.0,5,9,7,392.0,0.5164830684661865,0.312582790851593
6540865,5407985,6213736,9952,7047,1995,9231,2001,2905,721,0.0,0.0,7,1.0,1,6,49,721.0,0.41288501024246216,0.1524485945701599
6542620,5305400,5442638,9952,6683,1994,7166,1995,3269,2786,0.0,0.0,43,6.0,6,7,35,91.0,0.44040560722351074,0.2603125274181366
re38065,4814826,4529958,9959,4828,1989,3484,1985,5131,6475,0.0,0.0,7,16.0,3,10,791,7.0,0.6606269478797913,0.36534518003463745
6544609,5095063,4164236,9959,5913,1992,1321,1979,4046,8638,0.0,0.0,11,4.0,3,1,7,1190.0,0.4714592695236206,0.1210569515824318
6544193,5183044,5536187,9959,6242,1993,7502,1996,3717,2457,1.0,0.0,10,9.0,2,1,259,308.0,0.5427862405776978,0.021761106327176094
6546383,5717914,4153843,9959,8076,1998,1223,1979,1883,8736,1.0,0.0,41,25.0,23,1,21,497.0,0.5257255434989929,0.04494137689471245
6544627,5017835,4949749,9959,5619,1991,5346,1990,4340,4613,0.0,0.0,12,2.0,9,2,14,651.0,0.299504816532135,0.09954850375652313
6547965,4983305,4928520,9966,5486,1991,5262,1990,4480,4704,1.0,0.0,13,5.0,7,5,175,1274.0,0.4511955678462982,0.2200087159872055
6546635,5365781,4321980,9966,6900,1994,2280,1982,3066,7686,1.0,0.0,6,13.0,4,1,182,966.0,0.36044687032699585,0.3794192671775818
6551266,4402940,4474253,9973,2805,1983,3197,1984,7168,6776,1.0,0.0,19,4.0,1,2,588,2219.0,0.397811621427536,0.0052741640247404575
6551269,5396902,4705229,9973,7012,1995,4331,1987,2961,5642,1.0,0.0,8,3.0,24,4,259,1820.0,0.5195929408073425,0.14516998827457428
6552160,5645632,4007947,9973,7859,1997,411,1977,2114,9562,0.0,0.0,18,16.0,19,1,70,112.0,0.30840036273002625,0.28743916749954224
6550552,5570749,5744866,9973,7614,1996,8153,1998,2359,1820,0.0,0.0,17,2.0,20,1,35,483.0,0.576474130153656,0.21018409729003906
6552731,5754180,5770565,9973,8174,1998,8209,1998,1799,1764,0.25,0.0,10,1.0,9,9,168,1764.0,0.41911017894744873,-0.0631486251950264
6555922,5945716,5165707,9980,8643,1999,6172,1992,1337,3808,1.0,0.0,2,2.0,6,8,812,483.0,0.5872049927711487,0.10670233517885208
6555139,5683716,5675857,9980,7978,1997,7957,1997,2002,2023,1.0,0.0,1,5.0,1,3,2002,266.0,0.5346858501434326,0.11713890731334686
6554139,4824564,4660861,9980,4863,1989,4135,1987,5117,5845,1.0,0.0,21,14.0,1,9,819,203.0,0.5774633288383484,0.16412241756916046
6556883,6259960,4046979,9980,9322,2001,614,1977,658,9366,0.5,0.0,6,2.0,8,3,14,7672.0,0.350050151348114,0.0995684415102005
6554865,5653765,4440730,9980,7887,1997,3015,1984,2093,6965,1.0,0.0,12,3.0,27,8,196,4305.0,0.530022382736206,0.08817625790834427
6554816,5242436,6231114,9980,6459,1993,9266,2001,3521,714,1.0,0.0,48,1.0,45,12,7,714.0,0.6773205399513245,0.16505588591098785
6556875,5768516,4010450,9980,8202,1998,425,1977,1778,9555,0.0,0.0,6,18.0,8,3,434,42.0,0.3931020498275757,0.41166725754737854
6560463,5148174,4034722,9987,6102,1992,558,1977,3885,9429,0.0,0.0,14,5.0,2,1,21,4214.0,0.2802264392375946,0.21705667674541473
6559532,5793064,5410547,9987,8258,1998,7054,1995,1729,2933,1.0,0.0,3,14.0,27,8,476,140.0,0.4692605435848236,0.1973007172346115
6558383,5972416,4375738,9987,8699,1999,2623,1983,1288,7364,0.5,0.0,8,19.0,16,1,49,301.0,0.6413044929504395,0.27814310789108276
6558487,5154782,3997491,9987,6130,1992,348,1976,3857,9639,1.0,0.0,5,4.0,4,1,2079,1778.0,0.5620648860931396,0.33891960978507996
6560656,5933647,4228400,9987,8615,1999,1748,1980,1372,8239,1.0,0.0,29,8.0,29,4,77,2548.0,0.288560152053833,0.027425281703472137
6560111,6341644,4207379,9987,9525,2002,1622,1980,462,8365,1.0,0.0,1,4.0,3,1,462,1148.0,0.42795422673225403,0.13550585508346558
6564018,5483284,6128820,9994,7313,1996,9049,2000,2681,945,0.5,0.0,7,2.0,7,3,140,259.0,0.5852385759353638,0.2449386715888977
6561547,5826914,5218154,9994,8335,1998,6368,1993,1659,3626,1.0,0.0,3,3.0,9,2,105,1848.0,0.5654889345169067,0.2588728666305542
6563523,6210279,4392327,9994,9224,2001,2749,1983,770,7245,0.5,0.0,6,9.0,3,2,98,371.0,0.41158682107925415,0.17211167514324188
6561961,6511129,6330775,9994,9889,2003,9483,2001,105,511,0.0,0.0,1,1.0,16,26,105,511.0,0.44656863808631897,0.31972378492355347
6565411,5141467,5182212,10001,6081,1992,6235,1993,3920,3766,1.0,0.0,7,12.0,3,9,420,287.0,0.6019400954246521,0.04021046310663223
6567535,5134496,4377501,10001,6053,1992,2637,1983,3948,7364,1.0,0.0,53,3.0,25,6,0,5649.0,0.3944041132926941,0.10718218982219696
6569457,4794001,6144072,10008,4744,1988,9077,2000,5264,931,1.0,0.0,18,4.0,11,6,7,63.0,0.5773131847381592,0.17311382293701172
6570476,6043729,4147010,10008,8853,2000,1188,1979,1155,8820,1.0,0.0,1,3.0,5,1,1155,1519.0,0.5734601020812988,0.3376966714859009
6570626,5446505,6358601,10008,7180,1995,9574,2002,2828,434,1.0,0.0,7,1.0,6,8,336,434.0,0.4998462200164795,-0.03390907868742943
6572170,5486026,5272101,10015,7327,1996,6564,1993,2688,3451,0.0,0.0,5,25.0,3,9,42,7.0,0.5068771839141846,0.1914348602294922
6572885,5968551,4406727,10015,8692,1999,2826,1983,1323,7189,1.0,0.0,11,11.0,48,4,224,1785.0,1.0,0.13777513802051544
6573928,5798740,5497930,10015,8272,1998,7376,1996,1743,2639,0.5,0.0,3,4.0,6,8,1029,77.0,0.5130244493484497,0.18379750847816467
6575423,5356072,6318690,10022,6865,1994,9455,2001,3157,567,0.0,0.0,7,1.0,10,1,217,567.0,0.6153780817985535,0.2203940898180008
6575932,5817113,4401044,10022,8314,1998,2798,1983,1708,7224,1.0,0.0,35,8.0,45,1,14,2800.0,0.48060259222984314,0.20096071064472198
6575306,4895242,5409408,10022,5136,1990,7054,1995,4886,2968,1.0,0.0,8,2.0,1,1,301,301.0,0.6531403660774231,0.2224859893321991
6576582,4326994,4991860,10022,2308,1982,5521,1991,7714,4501,1.0,0.0,49,4.0,3,1,7,70.0,0.4806956648826599,0.030441410839557648
6578766,6375078,5785095,10029,9609,2002,8244,1998,420,1785,1.0,0.0,2,1.0,38,2,189,1785.0,0.21157817542552948,0.05594795569777489
6578287,6000227,6334255,10029,8748,1999,9497,2002,1281,532,0.0,0.0,9,1.0,4,5,7,532.0,0.6552833318710327,0.36180993914604187
6580587,6496004,4995880,10029,9847,2002,5535,1991,182,4494,0.0,0.0,1,7.0,1,4,182,70.0,0.5311151742935181,0.23779690265655518
6579443,5928497,4228326,10029,8608,1999,1748,1980,1421,8281,1.0,0.0,3,22.0,9,2,224,98.0,0.5184351801872253,0.10946110635995865
6580249,6046514,4389179,10029,8860,2000,2728,1983,1169,7301,1.0,0.0,5,2.0,107,2,336,1190.0,0.36530688405036926,0.22105149924755096
6579671,4210717,4247668,10029,1643,1980,1853,1981,8386,8176,1.0,0.0,2,2.0,3,1,602,7553.0,0.3017175495624542,0.43140754103660583
6581918,5346246,4334289,10036,6830,1994,2350,1982,3206,7686,0.0,0.0,3,8.0,14,1,910,1099.0,0.32828450202941895,0.008470762521028519
6582304,5642484,5833303,10036,7845,1997,8349,1998,2191,1687,1.0,0.0,22,15.0,15,1,28,21.0,0.3064538538455963,0.1464792639017105
6586254,5057483,5086259,10043,5766,1991,5878,1992,4277,4165,0.0,0.0,50,8.0,3,2,77,84.0,0.4556120038032532,0.2047940045595169
6587320,5640299,5280759,10043,7838,1997,6599,1994,2205,3444,1.0,0.0,5,5.0,32,5,7,2611.0,0.5279691219329834,0.15660928189754486
6587516,4404532,4754005,10043,2812,1983,4562,1988,7231,5481,0.3333333333333333,0.0,31,4.0,3,1,294,3129.0,0.5260680913925171,0.049976132810115814
6591272,6038565,4148933,10050,8839,2000,1195,1979,1211,8855,1.0,0.0,9,23.0,4,2,336,735.0,0.5693540573120117,0.2440827339887619
6588383,6446611,4603383,10050,9749,2002,3862,1986,301,6188,1.0,0.0,1,9.0,2,9,301,2590.0,0.5472293496131897,0.28575775027275085
6588487,5551998,4791240,10050,7551,1996,4730,1988,2499,5320,0.0,0.0,5,15.0,25,8,84,532.0,0.38446202874183655,0.23192943632602692
6588842,4846230,4999714,10050,4940,1989,5549,1991,5110,4501,0.0,0.0,6,3.0,3,15,420,3731.0,0.26898276805877686,0.08089274913072586
6589238,5709224,4431952,10050,8055,1998,2966,1984,1995,7084,1.0,0.0,68,1.0,28,1,21,7084.0,0.4151875078678131,0.22978773713111877
6590684,6295396,5383665,10050,9399,2001,6963,1995,651,3087,0.0,0.0,1,4.0,7,8,651,1302.0,0.6226707696914673,0.07960755378007889
6590679,6094281,4006607,10050,8972,2000,404,1977,1078,9646,1.0,0.0,1,6.0,17,1,1078,2023.0,0.4596382677555084,-0.0019429996609687805
6592067,5302167,4859362,10057,6676,1994,4982,1989,3381,5075,0.0,0.0,6,3.0,8,9,280,1876.0,0.5749919414520264,0.2712516486644745
6593255,4872787,5708660,10057,5031,1989,8048,1998,5026,2009,0.0,0.0,6,9.0,8,5,364,91.0,0.08451618254184723,0.09770496934652328
6591906,5498960,6210356,10057,7376,1996,9224,2001,2681,833,0.0,0.0,35,3.0,3,63,7,133.0,0.3271385431289673,0.10613914579153061
6594415,4857726,4731497,10057,4975,1989,4457,1988,5082,5600,0.0,0.0,26,17.0,1,2,7,56.0,0.25019901990890503,0.040718089789152145
6593698,5942853,4630796,10057,8636,1999,4009,1986,1421,6048,1.0,0.0,8,5.0,4,4,14,2688.0,0.5636982917785645,0.3636735677719116
6595107,5111969,5716246,10064,5976,1992,8076,1998,4088,1988,0.6666666666666666,0.0,16,1.0,8,2,301,1988.0,0.31716230511665344,0.209920272231102
6600271,5387848,4865775,10071,6977,1995,5003,1989,3094,5068,1.0,0.0,9,14.0,6,14,567,147.0,0.7067224383354187,0.2138042151927948
6600363,5907259,5032897,10071,8545,1999,5675,1991,1526,4396,0.5,0.0,16,25.0,5,16,70,35.0,0.6024203300476074,0.21213261783123016
6600386,4648087,5596478,10071,4079,1987,7691,1997,5992,2380,0.0,0.0,19,3.0,5,2,609,308.0,0.17391008138656616,0.11167855560779572
6598491,4680544,4044899,10071,4212,1987,607,1977,5859,9464,1.0,0.0,5,5.0,1,1,294,1169.0,0.542830765247345,0.2187575101852417
6601192,5940075,4063683,10071,8629,1999,719,1977,1442,9352,1.0,0.0,18,9.0,8,1,49,2492.0,0.3656337261199951,0.21829462051391602
6604053,4516530,5651064,10078,3421,1985,7873,1997,6657,2205,0.0,0.0,9,2.0,5,19,980,182.0,0.24136103689670563,0.06872459501028061
6602276,4502286,6120683,10078,3351,1985,9028,2000,6727,1050,0.0,0.0,37,1.0,2,3,7,1050.0,0.20821727812290192,0.11743473261594772
6604149,6134245,5424129,10078,9056,2000,7103,1995,1022,2975,0.0,0.0,4,2.0,3,10,35,1120.0,0.5154495239257812,0.1969255805015564
6603457,4761905,4471572,10078,4604,1988,3183,1984,5474,6895,1.0,0.0,17,5.0,4,3,749,336.0,0.5683578252792358,0.314697802066803
6601265,5199996,4582449,10078,6305,1993,3757,1986,3773,6321,0.5,0.0,3,13.0,4,4,483,861.0,0.5115594863891602,0.12215598672628403
6602807,5665644,5008596,10078,7922,1997,5584,1991,2156,4494,1.0,0.0,9,5.0,13,8,70,1253.0,0.5048940777778625,0.07501620054244995
6602569,5221503,5248624,10078,6382,1993,6480,1993,3696,3598,0.0,0.0,17,6.0,8,10,49,805.0,0.4796740710735321,0.29087209701538086
6604406,5945611,4984315,10085,8643,1999,5493,1991,1442,4592,0.3333333333333333,0.0,2,5.0,10,8,168,91.0,0.47413092851638794,0.2036159634590149
6607568,4673487,5633591,10092,4184,1987,7817,1997,5908,2275,1.0,0.0,15,3.0,4,13,7,805.0,0.22160175442695618,0.04271719604730606
6607878,5525464,5530991,10092,7467,1996,7488,1996,2625,2604,0.5,0.0,119,4.0,17,5,21,21.0,0.4748443067073822,0.04951660707592964
6608802,5986825,4124054,10092,8720,1999,1041,1978,1372,9051,0.0,0.0,2,18.0,5,1,315,35.0,0.3617607653141022,0.1305067390203476
6609147,5572646,5997140,10092,7614,1996,8741,1999,2478,1351,1.0,0.0,24,3.0,3,40,49,798.0,0.18761615455150604,0.1540095955133438
6610041,5364386,3989959,10099,6893,1994,306,1976,3206,9793,0.3333333333333333,0.0,31,9.0,10,1,84,1456.0,0.23726068437099457,0.15748468041419983
6611278,6147692,4797473,10099,9084,2000,4758,1989,1015,5341,0.5,0.0,11,18.0,2,5,14,1092.0,0.5626399517059326,0.05257560685276985
6609966,6039165,5401888,10099,8846,2000,7026,1995,1253,3073,0.3333333333333333,0.0,4,2.0,7,2,126,1106.0,0.5546063780784607,-0.026387281715869904
6611692,6112098,6435074,10099,9007,2000,9728,2002,1092,371,1.0,0.0,2,1.0,7,6,322,371.0,0.4237934350967407,0.13318325579166412
6614118,5475255,5716230,10106,7285,1995,8076,1998,2821,2030,1.0,1.0,9,6.0,2,6,63,98.0,0.430239200592041,0.33316898345947266
6615113,5445486,4062007,10106,7180,1995,705,1977,2926,9401,0.0,0.0,22,9.0,12,1,49,1505.0,0.4137660264968872,0.1221267357468605
6615149,5713668,4307971,10106,8069,1998,2189,1981,2037,7917,1.0,0.0,18,21.0,31,1,7,2107.0,0.2891213893890381,0.05655114725232124
6612828,5699189,5828799,10106,8020,1997,8335,1998,2086,1771,0.0,0.0,6,5.0,32,2,119,56.0,0.2774001359939575,0.2688898742198944
6613350,5728146,5302763,10106,8111,1998,6676,1994,1995,3430,1.0,0.0,17,3.0,61,9,147,1456.0,0.2766035497188568,0.2812618017196655
6612002,5426830,4449545,10106,7117,1995,3064,1984,2989,7042,0.5,0.0,41,16.0,3,7,0,154.0,0.35529136657714844,0.19034340977668762
6612315,6497239,6123783,10106,9854,2002,9035,2000,252,1071,1.0,0.0,1,2.0,32,2,252,210.0,0.3637312352657318,0.11667914688587189
6611996,4840012,4473218,10106,4919,1989,3190,1984,5187,6916,0.5,0.5,41,5.0,11,8,56,1155.0,0.5355975031852722,0.34896573424339294
6613017,5370675,4806946,10106,6914,1994,4800,1989,3192,5306,1.0,0.0,273,12.0,125,1,7,1407.0,0.48705506324768066,0.3224697411060333
6616228,5984408,5582860,10113,8720,1999,7649,1996,1393,2464,1.0,0.0,4,1.0,4,12,175,2464.0,0.5704799294471741,0.26528051495552063
6617007,5902448,4315141,10113,8531,1999,2231,1982,1582,7882,0.5,0.0,2,11.0,6,1,1169,868.0,0.5389009118080139,0.4213438034057617
6616922,5389676,4342234,10113,6984,1995,2406,1982,3129,7707,1.0,0.0,17,5.0,25,2,84,4361.0,0.41101062297821045,0.21767060458660126
6618347,5155722,4264563,10113,6130,1992,1944,1981,3983,8169,1.0,0.0,13,7.0,1,3,42,546.0,0.5069308876991272,0.13700009882450104
6616822,5037527,5648048,10113,5696,1991,7866,1997,4417,2247,0.5,0.0,12,2.0,4,8,0,1043.0,0.41677242517471313,0.11592890322208405
6621703,4347543,5197508,10120,2434,1982,6298,1993,7686,3822,0.0,0.0,9,13.0,1,3,196,49.0,0.5162006616592407,0.3156149089336395
6620148,5795322,4337023,10120,8265,1998,2371,1982,1855,7749,1.0,0.0,39,1.0,4,5,7,7749.0,0.5737411379814148,0.24150145053863525
6620869,5258422,4220578,10120,6515,1993,1706,1980,3605,8414,1.0,1.0,31,3.0,17,1,161,6566.0,0.297101229429245,0.1912902444601059
6621763,6122602,4051085,10120,9028,2000,635,1977,1092,9485,1.0,0.0,7,7.0,7,1,21,742.0,0.4050396680831909,-0.010836605913937092
6621141,5613861,5665773,10120,7754,1997,7922,1997,2366,2198,0.5,0.0,34,7.0,6,4,35,588.0,0.3399885296821594,0.04813089966773987
6622732,5171694,4463364,10127,6193,1992,3134,1984,3934,6993,0.0,0.0,4,9.0,4,1,385,378.0,0.13265931606292725,0.020172875374555588
6624507,6075284,6153170,10127,8930,2000,9098,2000,1197,1029,1.0,0.0,7,1.0,11,1,42,1029.0,0.44745272397994995,0.15441042184829712
6625683,6385686,6371678,10127,9623,2002,9602,2002,504,525,1.0,0.0,1,1.0,11,11,504,525.0,0.7179534435272217,0.20966672897338867
6625164,5802465,5764136,10127,8279,1998,8195,1998,1848,1932,1.0,0.0,63,5.0,21,12,21,168.0,0.44446319341659546,0.15036483108997345
6624107,5707913,4897550,10127,8048,1998,5143,1990,2079,4984,0.5,0.0,38,3.0,3,4,7,105.0,0.6686763763427734,0.18761183321475983
6625155,6324166,6261886,10127,9462,2001,9329,2001,665,798,1.0,0.0,4,4.0,4,7,42,7.0,0.44778865575790405,0.009075276553630829
6628472,6144517,4192189,10134,9077,2000,1531,1980,1057,8603,1.0,0.0,2,7.0,7,1,21,567.0,0.44761207699775696,0.2701791226863861
6628815,6266435,6146119,10134,9336,2001,9084,2000,798,1050,1.0,0.0,5,4.0,5,4,70,154.0,0.47685506939888,0.035972245037555695
6627300,5783120,4220729,10134,8237,1998,1706,1980,1897,8428,0.0,0.0,89,4.0,8,1,0,224.0,0.7397027015686035,0.3657885789871216
6629599,4265216,4622291,10141,1951,1981,3967,1986,8190,6174,0.5,0.0,20,5.0,4,3,749,1407.0,0.4031968116760254,0.1662798970937729
6629863,5496197,4337057,10141,7369,1996,2371,1982,2772,7770,1.0,0.0,1,14.0,10,1,2772,3038.0,0.6906194090843201,0.31617939472198486
6630976,6313889,4065829,10141,9441,2001,733,1978,700,9408,1.0,0.0,2,9.0,8,1,98,3227.0,0.5761699676513672,0.04659568518400192
6631452,6035389,5330689,10141,8832,2000,6774,1994,1309,3367,1.0,0.0,4,5.0,4,27,721,371.0,0.5825133919715881,-0.02018464170396328
6632723,5382816,4439448,10148,6956,1995,3008,1984,3192,7140,1.0,0.0,7,8.0,5,2,294,2170.0,0.7378003597259521,-0.0660322904586792
6632779,5095987,4304190,10148,5920,1992,2168,1981,4228,7980,0.3333333333333333,0.0,39,2.0,6,3,91,1379.0,0.5514417290687561,0.20767980813980103
6633287,6061041,4308528,10148,8895,2000,2189,1981,1253,7959,1.0,0.3333333333333333,2,6.0,4,5,301,4046.0,0.4177049696445465,0.41509324312210083
6633242,6298160,4217732,10148,9406,2001,1692,1980,742,8456,0.5,0.0,2,6.0,8,1,119,2149.0,0.32478979229927063,0.06284038722515106
6634698,6103341,4328999,10155,8993,2000,2322,1982,1162,7833,0.0,0.0,19,8.0,7,3,35,1169.0,0.44224026799201965,0.3092743456363678
6634165,6260350,4351405,10155,9329,2001,2462,1982,826,7693,1.0,0.0,6,2.0,8,4,224,7.0,0.6454598307609558,0.23109124600887299
6639575,6157361,4212248,10162,9105,2000,1657,1980,1057,8505,1.0,0.0,6,8.0,8,1,0,945.0,0.5939269661903381,0.33938780426979065
6640145,5701369,4080845,10162,8027,1997,817,1978,2135,9345,0.0,0.0,12,11.0,10,2,476,14.0,0.24325498938560486,0.09394358098506927
6640035,5450427,4754926,10162,7194,1995,4569,1988,2968,5593,0.0,0.0,43,3.0,8,4,14,1239.0,0.5737812519073486,0.1438715159893036
6638452,4398476,5645769,10162,2784,1983,7859,1997,7378,2303,0.0,0.0,10,4.0,5,5,511,693.0,0.4762340784072876,0.1401437371969223
6637575,5080434,5403571,10162,5857,1992,7033,1995,4305,3129,0.0,0.0,16,2.0,3,1,413,2100.0,0.25997549295425415,0.08175118267536163
6638234,5151598,4139969,10162,6116,1992,1146,1979,4046,9016,1.0,0.0,33,7.0,6,1,224,4984.0,0.2822461724281311,0.16605916619300842
6640145,5220674,5412781,10162,6375,1993,7061,1995,3787,3101,0.0,0.0,162,3.0,7,5,7,469.0,0.3746643662452698,0.3438422977924347
6641482,5819206,5381119,10169,8314,1998,6949,1995,1855,3220,0.0,0.0,10,7.0,9,2,77,168.0,0.49081507325172424,0.25893634557724
6641651,4957553,5577134,10169,5374,1990,7628,1996,4795,2541,1.0,0.0,23,7.0,8,6,483,819.0,0.7258177995681763,0.16112199425697327
6642428,5509913,5687229,10169,7418,1996,7985,1997,2751,2184,1.0,0.0,59,22.0,47,14,7,140.0,0.4372517764568329,0.22070342302322388
6642908,5719580,4142364,10169,8083,1998,1160,1979,2086,9009,0.0,0.0,7,9.0,13,1,49,3136.0,0.23218536376953125,0.08569686859846115
6643548,5700283,3993787,10169,8027,1997,327,1976,2142,9842,1.0,0.0,30,17.0,5,1,77,2611.0,0.6516609191894531,0.31508708000183105
6641610,6110201,5188131,10169,9007,2000,6263,1993,1162,3906,1.0,0.0,8,8.0,4,2,7,294.0,0.5307356119155884,0.26681971549987793
6641186,6357807,4691725,10169,9574,2002,4268,1987,595,5901,1.0,0.0,3,22.0,6,1,210,371.0,0.6519150733947754,0.2602267563343048
6645171,5827262,4112898,10176,8335,1998,985,1978,1841,9191,1.0,0.0,15,9.0,7,1,0,2324.0,0.5037789344787598,0.3218998610973358
6645084,5121925,4002174,10176,6011,1992,376,1977,4165,9800,1.0,0.0,13,20.0,1,1,161,273.0,0.7398372292518616,0.34556642174720764
6647241,5828939,5997379,10176,8335,1998,8741,1999,1841,1435,1.0,0.0,2,4.0,6,5,574,126.0,0.7769920825958252,0.4074990153312683
6644721,4984673,5361526,10176,5493,1991,6886,1994,4683,3290,0.0,0.0,2,3.0,1,13,3381,497.0,0.23419395089149475,0.10112245380878448
6646522,5610563,4385975,10176,7740,1997,2707,1983,2436,7469,1.0,0.0,8,25.0,8,11,840,70.0,0.3187516927719116,0.2618190348148346
6648895,6120506,4695060,10183,9028,2000,4282,1987,1155,5901,1.0,0.0,8,6.0,6,2,147,1470.0,0.4667307734489441,0.1559886336326599
6649543,6146948,5197474,10183,9084,2000,6298,1993,1099,3885,1.0,0.0,2,4.0,10,6,126,70.0,0.5553070902824402,0.15191815793514252
6649293,5503944,5358146,10183,7397,1996,6872,1994,2786,3311,1.0,0.0,60,6.0,2,15,7,686.0,0.46942228078842163,0.20090068876743317
6653829,5791432,5279509,10190,8258,1998,6592,1994,1932,3598,0.0,0.0,6,3.0,8,6,7,469.0,0.3060033619403839,0.21800149977207184
6651397,4691490,4800953,10190,4268,1987,4779,1989,5922,5411,0.0,0.0,4,5.0,10,3,70,49.0,0.48507416248321533,0.35135045647621155
6652261,5253999,5357315,10190,6501,1993,6865,1994,3689,3325,1.0,0.0,5,7.0,2,1,105,581.0,0.5621442794799805,0.07053855061531067
6653945,4734680,4079554,10190,4471,1988,810,1978,5719,9380,1.0,0.0,34,8.0,6,1,588,903.0,0.4647630751132965,0.007717111147940159
6654033,5870590,5472003,10190,8440,1999,7278,1995,1750,2912,0.0,0.0,16,14.0,13,5,21,7.0,0.3720705211162567,0.1357221156358719
6652373,4352274,4391855,10190,2469,1982,2742,1983,7721,7448,0.0,0.0,17,14.0,1,1,168,91.0,0.6344922184944153,0.3312722146511078
6653147,5917592,5855400,10190,8580,1999,8405,1999,1610,1785,0.5,0.0,3,1.0,5,13,224,1785.0,0.2737026512622833,0.024275047704577446
6656329,4590031,5095559,10197,3792,1986,5920,1992,6405,4277,0.0,0.0,15,4.0,9,12,294,2541.0,0.44143012166023254,0.10418219119310379
6656630,5348820,4262816,10197,6837,1994,1937,1981,3360,8260,1.0,0.0,7,26.0,6,5,161,56.0,0.5562332272529602,0.30358684062957764
6656329,4957884,4518414,10197,5374,1990,3428,1985,4823,6769,0.0,0.0,11,5.0,15,5,896,1890.0,0.4332787096500397,0.15672600269317627
6660508,4816158,5680843,10204,4835,1989,7971,1997,5369,2233,0.0,0.0,17,2.0,10,6,21,2023.0,0.2534879148006439,0.1152166798710823
6659167,4541296,5774452,10204,3547,1985,8216,1998,6657,1988,0.0,0.0,9,13.0,1,7,21,14.0,0.12121476233005524,0.1428670883178711
6661161,5033032,4992282,10204,5675,1991,5521,1991,4529,4683,0.0,0.0,8,17.0,4,9,56,112.0,0.49531838297843933,0.041384778916835785
6664787,5570019,4191011,10211,7607,1996,1524,1980,2604,8687,1.0,0.0,8,10.0,5,2,112,357.0,0.41498634219169617,0.053856488317251205
6665381,6005924,4512384,10211,8755,1999,3400,1985,1456,6811,1.0,0.0,3,10.0,2,2,21,4746.0,0.6995337009429932,0.09380015730857849
6662503,5444115,4239051,10211,7173,1995,1811,1980,3038,8400,0.0,0.0,4,3.0,9,2,1834,875.0,0.29945865273475647,0.14201056957244873
6662512,4738065,4296011,10211,4492,1988,2119,1981,5719,8092,0.5,0.0,15,3.0,17,3,630,1589.0,0.3967288136482239,0.10983867943286896
6663748,6506312,5898830,10211,9875,2003,8517,1999,336,1694,0.0,0.0,1,16.0,29,22,336,42.0,0.46843191981315613,0.16949518024921417
6668224,6517464,5986775,10218,9903,2003,8720,1999,315,1498,0.0,0.0,1,6.0,8,5,315,14.0,0.5556784272193909,0.22142913937568665
6670578,5744781,4429020,10225,8153,1998,2952,1984,2072,7273,1.0,0.0,14,6.0,11,4,28,189.0,0.5032235980033875,0.3634411692619324
6668422,5862570,4447644,10225,8426,1999,3050,1984,1799,7175,1.0,0.0,11,4.0,8,2,70,4886.0,0.41189974546432495,0.1190565899014473
6669619,4890524,4435128,10225,5115,1990,2987,1984,5110,7238,0.0,0.0,11,5.0,3,4,238,3493.0,0.4459349811077118,0.4220105707645416
6669295,5282665,4134488,10225,6606,1994,1111,1979,3619,9114,0.5,0.0,3,3.0,9,1,350,5824.0,0.5941145420074463,0.37333405017852783
6669133,5924641,4380426,10225,8601,1999,2665,1983,1624,7560,1.0,0.0,8,8.0,3,2,21,966.0,0.6295698285102844,0.25768449902534485
6674575,6369939,4854495,10232,9595,2002,4968,1989,637,5264,1.0,0.0,1,11.0,4,3,637,70.0,0.6716930866241455,0.1102244034409523
6673765,4615819,4869800,10232,3932,1986,5017,1989,6300,5215,1.0,0.0,29,6.0,4,2,21,854.0,0.4900088608264923,0.21914954483509064
6673447,4235764,4242610,10232,1790,1980,1825,1980,8442,8407,0.0,0.0,15,15.0,2,1,56,98.0,0.5234958529472351,0.1240241676568985
6673328,5556892,4247132,10232,7565,1996,1853,1981,2667,8379,0.0,0.0,18,3.0,4,1,21,791.0,0.4126092493534088,0.01754174567759037
6674485,5939246,4723062,10232,8629,1999,4415,1988,1603,5817,0.0,0.0,2,2.0,13,4,679,2590.0,0.5820439457893372,0.1835888773202896
6675139,5666289,4565726,10232,7922,1997,3673,1986,2310,6559,1.0,0.0,11,7.0,6,9,28,4585.0,0.3030283451080322,-0.05420166999101639
6674777,6317446,5131321,10232,9448,2001,6046,1992,784,4186,1.0,0.0,2,5.0,4,6,196,2842.0,0.39078643918037415,0.17523746192455292
6673272,4604676,5596710,10232,3869,1986,7691,1997,6363,2541,1.0,0.0,19,7.0,1,12,441,56.0,0.5526658296585083,0.24041076004505157
6673730,4744809,4518872,10232,4520,1988,3428,1985,5712,6804,1.0,0.0,8,7.0,8,5,1897,4221.0,0.2968725860118866,0.06319920718669891
6674700,6385257,4002285,10232,9623,2002,376,1977,609,9856,0.0,0.0,1,2.0,19,1,609,6818.0,0.13437409698963165,0.16617734730243683
6678176,5892664,6218969,10239,8496,1999,9238,2001,1743,1001,1.0,0.0,7,4.0,7,22,154,70.0,0.40719470381736755,0.1357414871454239
6675588,5402654,4757746,10239,7033,1995,4583,1988,3206,5656,1.0,0.0,8,4.0,6,2,203,1890.0,0.6824868321418762,0.21634261310100555
6679351,5496975,4856280,10246,7369,1996,4975,1989,2877,5271,1.0,0.0,1,4.0,2,2,2877,1267.0,0.5353270769119263,0.3313923180103302
6679477,4222126,4209864,10246,1720,1980,1643,1980,8526,8603,0.0,0.0,54,13.0,1,2,14,70.0,0.4841324985027313,0.14578330516815186
6684062,5738583,4594447,10253,8139,1998,3813,1986,2114,6440,0.0,0.0,21,5.0,4,1,0,4326.0,0.7030668258666992,-0.0037564747035503387
6684097,5298026,4170643,10253,6662,1994,1377,1979,3591,8876,1.0,0.5,24,1.0,3,3,322,8876.0,0.35882601141929626,0.10134528577327728
6682533,5116340,4192887,10253,5990,1992,1531,1980,4263,8722,1.0,1.0,61,5.0,10,2,112,4536.0,0.7043555378913879,0.19860944151878357
6681767,4452239,5681120,10253,3078,1984,7971,1997,7175,2282,1.0,0.0,36,5.0,2,12,28,679.0,0.3051997423171997,0.2459714412689209
6682546,4649922,4468938,10253,4093,1987,3169,1984,6160,7084,1.0,0.0,186,7.0,3,4,42,294.0,0.4732460379600525,0.11973989009857178
6687654,5602761,6051866,10260,7712,1997,8874,2000,2548,1386,0.0,0.0,29,13.0,8,42,0,91.0,0.511955738067627,0.14671914279460907
6685921,6555094,4122661,10260,9980,2003,1034,1978,280,9226,0.3333333333333333,0.0,2,3.0,92,2,42,7560.0,0.5991409420967102,0.12311524897813797
6687092,5510940,3981795,10260,7418,1996,264,1976,2842,9996,0.5,0.0,20,4.0,5,1,70,7014.0,0.6074883341789246,0.034482140094041824
6685615,5871432,4316563,10260,8447,1999,2245,1982,1813,8015,0.5,0.0,31,6.0,36,2,28,861.0,0.5002760291099548,0.3277585804462433
6686692,5705285,4987686,10260,8041,1998,5507,1991,2219,4753,0.0,0.0,14,5.0,5,1,126,1253.0,0.58393794298172,0.07952404767274857
6689121,6263880,4004409,10267,9336,2001,390,1977,931,9877,1.0,0.0,4,7.0,33,1,147,5782.0,0.5513923764228821,0.23518820106983185
6689159,5782855,4322020,10267,8237,1998,2280,1982,2030,7987,1.0,0.0,28,12.0,30,3,77,7.0,0.7610000967979431,0.18911877274513245
6688889,5836771,6055565,10267,8356,1998,8881,2000,1911,1386,1.0,0.0,22,1.0,18,4,77,1386.0,0.6464641094207764,0.31456029415130615
6690531,6067213,4160117,10267,8909,2000,1279,1979,1358,8988,1.0,0.0,4,7.0,13,1,252,1148.0,0.47084271907806396,0.09430477768182755
6690025,5854125,5452098,10267,8398,1998,7201,1995,1869,3066,1.0,0.0,7,9.0,17,12,133,280.0,0.3279450535774231,0.09995952248573303
6689978,5767980,5547349,10267,8202,1998,7537,1996,2065,2730,0.0,0.0,7,9.0,157,4,518,98.0,0.5124117136001587,0.26568660140037537
6694186,5113869,5785633,10274,5983,1992,8244,1998,4291,2030,1.0,0.0,113,1.0,7,5,0,2030.0,0.48017847537994385,0.0154111972078681
6694244,6487853,5063033,10274,9833,2002,5787,1991,441,4487,0.5,0.0,3,2.0,150,7,7,616.0,0.6646085381507874,0.11409232020378113
6694159,5435309,5227242,10274,7145,1995,6403,1993,3129,3871,0.5,0.0,58,25.0,5,24,42,238.0,0.5542686581611633,0.12368203699588776
6697480,4555594,4593522,10281,3617,1985,3813,1986,6664,6468,1.0,0.0,81,4.0,2,1,42,2576.0,0.6077607274055481,0.07754329591989517
6695414,6311360,6435097,10281,9441,2001,9728,2002,840,553,1.0,0.0,3,1.0,7,6,77,553.0,0.6492224931716919,0.2194177359342575
6694954,6336444,6107804,10281,9504,2002,9000,2000,777,1281,1.0,0.0,2,2.0,10,5,336,147.0,0.6244688630104065,0.2224777787923813
6695080,5495899,4168153,10281,7369,1996,1356,1979,2912,8925,1.0,0.0,12,3.0,10,1,154,4571.0,0.6874023079872131,0.03419877961277962
6694988,6012461,5556745,10281,8776,2000,7565,1996,1505,2716,0.0,0.0,4,2.0,8,1,448,2261.0,0.14712823927402496,0.03783893585205078
6697131,6184951,4171065,10281,9168,2001,1384,1979,1113,8897,1.0,0.0,3,16.0,13,1,105,35.0,0.43832921981811523,0.16142815351486206
6696762,5877976,4086488,10281,8461,1999,845,1978,1820,9436,0.0,0.0,16,7.0,15,1,77,1827.0,0.5114148855209351,0.2634407579898834
6698769,4183547,4503046,10288,1475,1980,3351,1985,8813,6937,1.0,0.0,7,2.0,3,3,532,98.0,0.5016869306564331,0.012286879122257233
6701073,6597517,6117492,10288,10064,2003,9021,2000,224,1267,0.5,0.0,1,4.0,6,8,224,413.0,0.5619279146194458,0.15778383612632751
6700155,6330184,5472706,10288,9476,2001,7278,1995,812,3010,0.0,0.0,4,12.0,8,4,0,224.0,0.5134776830673218,0.095726378262043
6698997,4583693,6354295,10288,3764,1986,9567,2002,6524,721,0.5,0.0,4,2.0,1,42,406,399.0,0.5934968590736389,0.2545432448387146
6704092,5098184,5711807,10295,5927,1992,8062,1998,4368,2233,1.0,0.0,107,1.0,2,6,7,2233.0,0.6247122287750244,0.444161981344223
6703468,4687732,4571722,10295,4247,1987,3701,1986,6048,6594,0.0,0.0,54,6.0,9,3,0,1715.0,0.44413548707962036,0.09728159755468369
6703871,6172535,4715662,10295,9140,2001,4380,1987,1155,5915,0.0,0.0,9,29.0,7,1,49,42.0,0.36434781551361084,0.1727190613746643
6704549,4430629,4664810,10295,2959,1984,4149,1987,7336,6146,0.0,0.0,16,5.0,3,4,21,3374.0,0.28432905673980713,0.0769786387681961
6703868,6008705,4365528,10295,8762,1999,2553,1982,1533,7742,0.0,0.0,3,9.0,2,3,91,518.0,0.6068698167800903,0.15309707820415497
6703688,5013681,5667228,10295,5605,1991,7929,1997,4690,2366,1.0,0.0,81,2.0,17,1,0,1204.0,0.4341120421886444,0.18291397392749786
6704794,5781549,4375164,10295,8230,1998,2616,1983,2065,7679,0.0,0.0,56,16.0,9,5,0,420.0,0.4640319049358368,0.2083795666694641
6705876,4403272,5752758,10302,2805,1983,8174,1998,7497,2128,0.0,0.0,27,8.0,6,5,217,42.0,0.37125712633132935,0.23379714787006378
6705897,5456618,3988924,10302,7222,1995,306,1976,3080,9996,1.0,0.0,14,1.0,6,2,203,9996.0,0.6466296315193176,0.06912650913000107
6706374,4861620,5023598,10302,4989,1989,5640,1991,5313,4662,0.0,0.0,51,7.0,1,4,7,1799.0,0.38863512873649597,0.2568146884441376
6707303,5469043,4008547,10302,7264,1995,418,1977,3038,9884,0.0,0.0,45,8.0,12,1,21,2961.0,0.3517746925354004,0.17050692439079285
6706557,6229158,4324464,10302,9259,2001,2294,1982,1043,8008,1.0,0.0,1,3.0,10,1,1043,1925.0,0.3131250739097595,0.10415906459093094
6708729,5698056,5541543,10309,8020,1997,7516,1996,2289,2793,0.0,0.0,15,5.0,49,16,84,378.0,0.6025896668434143,0.31339582800865173
6708640,6292431,5352454,10309,9392,2001,6851,1994,917,3458,0.0,0.0,1,1.0,2,2,917,3458.0,0.4651724398136139,0.14444273710250854
6711695,6618816,5213323,10309,10113,2003,6354,1993,196,3955,0.5,0.0,1,6.0,10,8,196,1239.0,0.4605167806148529,0.18759123980998993
6714475,5682354,5538938,10316,7971,1997,7509,1996,2345,2807,1.0,0.0,11,2.0,32,3,7,21.0,0.5742447972297668,0.20981815457344055
6712206,5236085,4532521,10316,6438,1993,3498,1985,3878,6818,1.0,0.0,22,9.0,11,3,420,3731.0,0.7014155387878418,0.2615572214126587
6712480,5517347,4840939,10316,7439,1996,4919,1989,2877,5397,1.0,0.0,20,16.0,7,1,14,91.0,0.5207274556159973,0.04757092893123627
re38476,4863265,5443473,10316,4996,1989,7173,1995,5320,3143,0.5,1.0,51,8.0,7,3,7,42.0,0.5039885640144348,0.1767420917749405
re38481,4476562,4222936,10316,3204,1984,1720,1980,7112,8596,0.0,0.0,21,3.0,7,1,49,392.0,0.25991541147232056,0.03319050371646881
6719632,6146273,5621261,10330,9084,2000,7775,1997,1246,2555,1.0,0.0,23,1.0,6,8,56,2555.0,0.5868479609489441,0.19700521230697632
6719557,4347054,4327480,10330,2434,1982,2315,1982,7896,8015,1.0,0.0,20,10.0,2,2,154,3129.0,0.4944467544555664,0.030748868361115456
6720872,5691869,6508886,10330,7999,1997,9882,2003,2331,448,0.0,0.0,59,1.0,6,2,7,448.0,0.6199308633804321,0.1568278968334198
6719971,5720954,4275129,10330,8090,1998,2000,1981,2240,8330,0.3333333333333333,0.0,11,6.0,8,3,70,1092.0,0.1477336287498474,0.07619994878768921
6719730,5562626,6318697,10330,7586,1996,9455,2001,2744,875,1.0,0.0,20,1.0,6,10,7,875.0,0.6532692313194275,0.3333827257156372
6724312,5764138,5387079,10337,8195,1998,6977,1995,2142,3360,0.0,0.0,13,5.0,4,3,14,42.0,0.4763936996459961,0.11752422153949738
6724442,6049653,6026725,10337,8867,2000,8818,2000,1470,1519,1.0,0.0,2,9.0,14,35,287,7.0,0.5456057786941528,0.12007886916399002
6722747,4695929,4474519,10337,4282,1987,3197,1984,6055,7140,0.0,0.0,6,4.0,3,1,1925,2947.0,0.5591806769371033,0.4062071442604065
6723083,5470322,4099704,10337,7271,1995,922,1978,3066,9415,1.0,0.0,31,17.0,30,1,7,742.0,0.5956956148147583,0.2143922597169876
6723670,4681798,5052873,10337,4219,1987,5752,1991,6118,4585,0.5,0.0,14,16.0,4,4,378,49.0,0.7146289944648743,0.24421024322509766
6726309,5907343,4392139,10344,8545,1999,2742,1983,1799,7602,1.0,0.0,2,13.0,30,1,735,693.0,0.757529079914093,0.14415237307548523
6728737,5640564,4504270,10344,7838,1997,3358,1985,2506,6986,1.0,0.0,48,5.0,13,3,42,1085.0,0.4738461375236511,0.16645117104053497
6728391,5912698,5675368,10344,8566,1999,7950,1997,1778,2394,0.0,0.0,1,2.0,8,4,1778,357.0,0.34380075335502625,0.30542054772377014
6728599,4474174,5296476,10344,3197,1984,6655,1994,7147,3689,0.0,0.0,73,3.0,6,2,0,721.0,0.43966153264045715,0.10619647800922394
6727230,5756097,4439288,10344,8181,1998,3008,1984,2163,7336,0.5,0.0,2,4.0,8,3,154,973.0,0.3746928870677948,0.1563372164964676
6727824,6515856,4836644,10344,9896,2003,4905,1989,448,5439,0.0,0.0,1,8.0,20,1,448,2702.0,0.5516481995582581,0.07274694740772247
6727565,6040096,6331714,10344,8846,2000,9483,2001,1498,861,0.0,0.0,15,3.0,13,6,28,133.0,0.5491222143173218,0.36967331171035767
6725867,5092353,4072161,10344,5906,1992,768,1978,4438,9576,1.0,0.0,5,5.0,37,1,2023,63.0,0.45773664116859436,0.2100609987974167
6730108,5451235,5596569,10351,7201,1995,7691,1997,3150,2660,1.0,0.0,66,15.0,11,9,56,14.0,0.341712087392807,0.2578676640987396
6732689,6182636,6538678,10358,9168,2001,9945,2003,1190,413,0.0,0.0,21,1.0,17,4,42,413.0,0.46498697996139526,0.32277578115463257
6738384,5522059,4289186,10365,7453,1996,2084,1981,2912,8281,0.0,0.0,21,7.0,14,4,252,1253.0,0.34666112065315247,0.2566152513027191
6737159,4575540,4617371,10365,3722,1986,3939,1986,6643,6426,0.0,0.0,4,20.0,3,6,1428,42.0,0.44520267844200134,0.36873164772987366
6740459,6180320,5101292,10372,9161,2001,5934,1992,1211,4438,1.0,0.0,3,2.0,2,3,189,1743.0,0.43635526299476624,0.21368436515331268
re38521,6314606,6514129,10372,9448,2001,9896,2003,924,476,1.0,0.0,3,1.0,42,11,630,476.0,0.7575746774673462,0.3689100444316864
6740341,4831058,4463378,10372,4884,1989,3134,1984,5488,7238,1.0,0.0,12,9.0,1,2,763,2492.0,0.4263931214809418,0.10061921924352646
6739394,4457374,4468712,10372,3106,1984,3162,1984,7266,7210,1.0,0.0,25,5.0,6,2,0,4879.0,0.45733213424682617,0.17323043942451477
6744543,5191202,5004844,10379,6270,1993,5570,1991,4109,4809,0.0,0.0,3,4.0,3,3,1274,1617.0,0.4849000573158264,0.22374944388866425
6743118,5377986,6265454,10379,6942,1995,9336,2001,3437,1043,1.0,0.0,46,2.0,9,12,7,28.0,0.6508991122245789,0.01954762451350689
6742445,5497697,5758345,10379,7376,1996,8181,1998,3003,2198,1.0,0.0,12,12.0,5,10,175,28.0,0.5684475302696228,0.16148899495601654
6744172,6188159,6230525,10379,9175,2001,9266,2001,1204,1113,1.0,0.0,4,3.0,7,9,35,609.0,0.43154019117355347,0.23215240240097046
6742524,4803075,4359515,10379,4786,1989,2511,1982,5593,7868,1.0,0.0,91,7.0,8,5,77,4872.0,0.4197867512702942,0.1798146367073059
6748057,4850007,3981810,10386,4947,1989,264,1976,5439,10122,1.0,0.0,86,4.0,2,1,126,2891.0,0.4963425099849701,-0.013846338726580143
6747455,6605945,6161469,10386,10085,2003,9119,2000,301,1267,1.0,0.0,1,2.0,8,3,301,1001.0,0.8516939282417297,0.02789662592113018
6745975,6092759,4706215,10386,8972,2000,4331,1987,1414,6055,1.0,0.0,17,8.0,101,7,84,252.0,0.575177013874054,0.3163219392299652
6748319,5781872,4038451,10386,8230,1998,572,1977,2156,9814,0.0,0.0,12,9.0,9,1,56,2289.0,0.4561328887939453,-0.051369454711675644
6746700,4251551,4165031,10386,1874,1981,1328,1979,8512,9058,0.5,0.0,46,5.0,1,1,434,1106.0,0.5334115028381348,0.27887392044067383
6747526,5739723,5512804,10386,8139,1998,7425,1996,2247,2961,1.0,0.0,14,7.0,2,7,21,833.0,0.28322312235832214,0.12560100853443146
6746156,5508241,5730217,10386,7411,1996,8118,1998,2975,2268,0.0,0.0,4,2.0,14,3,399,1141.0,0.29816949367523193,0.17606660723686218
6748791,5041321,6246077,10393,5710,1991,9294,2001,4683,1099,0.0,0.0,49,1.0,3,16,707,1099.0,0.1741553246974945,0.2287580370903015
6750230,4411235,6165434,10393,2854,1983,9126,2000,7539,1267,0.0,0.0,12,1.0,7,16,2373,1267.0,0.1501767486333847,0.2275313287973404
6749691,6229215,5262284,10393,9259,2001,6529,1993,1134,3864,0.0,0.0,9,3.0,5,6,161,2891.0,0.23757430911064148,0.1600136011838913
6751482,5884188,4543336,10393,8475,1999,3554,1985,1918,6839,1.0,0.0,16,2.0,10,5,133,1393.0,0.45186007022857666,-0.046497538685798645
6749574,5133032,4694319,10393,6046,1992,4275,1987,4347,6118,0.0,0.0,21,2.0,23,2,203,4361.0,0.2863447666168213,0.2911872863769531
6751202,5519727,4666206,10393,7446,1996,4156,1987,2947,6237,1.0,0.0,16,13.0,10,1,7,665.0,0.3818747103214264,0.1922241598367691
6750319,5635587,5298901,10393,7824,1997,6662,1994,2569,3731,1.0,0.0,4,5.0,6,1,392,525.0,0.6706814765930176,0.125655397772789
6749609,5700261,4050385,10393,8027,1997,635,1977,2366,9758,1.0,0.0,29,19.0,14,2,49,350.0,0.768000066280365,0.35469022393226624
6749172,5662171,4957018,10393,7915,1997,5374,1990,2478,5019,1.0,0.0,7,3.0,9,1,413,1050.0,0.645723283290863,0.32891079783439636
6753468,6269596,5207712,10400,9350,2001,6333,1993,1050,4067,0.0,0.0,2,7.0,9,5,287,119.0,0.5189999341964722,0.21331298351287842
6754324,6397055,4466683,10400,9644,2002,3155,1984,756,7245,1.0,0.0,6,6.0,8,4,91,56.0,0.48457324504852295,0.1377064436674118
6754031,5459624,4828549,10400,7229,1995,4877,1989,3171,5523,1.0,0.0,34,25.0,11,6,28,1400.0,0.5091992020606995,0.24945566058158875
6753199,5814889,4279196,10400,8307,1998,2028,1981,2093,8372,1.0,0.0,22,4.0,35,4,0,2226.0,0.2351084202528,0.2368439882993698
6757767,5327535,4401406,10407,6760,1994,2798,1983,3647,7609,1.0,0.0,16,2.0,1,2,28,3066.0,0.2541942298412323,0.21120619773864746
6756962,6201523,4761648,10407,9203,2001,4597,1988,1204,5810,1.0,0.0,6,7.0,8,4,126,1771.0,0.3802596926689148,0.18672002851963043
6757432,4645459,5497387,10407,4072,1987,7369,1996,6335,3038,1.0,0.0,96,7.0,12,11,49,231.0,0.439401775598526,0.17206823825836182
6759959,5695091,5027238,10414,8013,1997,5654,1991,2401,4760,0.0,0.0,9,8.0,9,5,70,2170.0,0.4722203016281128,0.21955819427967072
6760664,6305221,5351422,10414,9427,2001,6851,1994,987,3563,1.0,0.0,4,8.0,36,3,0,42.0,0.3458162844181061,0.034551069140434265
6758570,6278553,5631239,10414,9364,2001,7810,1997,1050,2604,1.0,0.0,3,14.0,14,1,434,168.0,0.5688920021057129,0.02845120243728161
6763390,5831690,5438525,10421,8342,1998,7152,1995,2079,3269,0.0,1.0,14,2.0,6,6,189,1960.0,0.6488900184631348,0.21520847082138062
6765212,6448089,4600444,10428,9749,2002,3848,1986,679,6580,1.0,0.0,1,7.0,39,5,679,784.0,0.4377640187740326,0.15497376024723053
6764863,6090659,4294057,10428,8965,2000,2112,1981,1463,8316,1.0,0.0,23,10.0,3,4,49,35.0,0.4719342887401581,0.2615457773208618
6764484,5328472,5238022,10428,6767,1994,6445,1993,3661,3983,1.0,0.0,34,3.0,26,24,42,301.0,0.5947949290275574,0.35185396671295166
6766305,6226747,5012101,10428,9252,2001,5598,1991,1176,4830,1.0,0.0,9,3.0,21,3,63,1337.0,0.44462230801582336,0.26744985580444336
6765803,4527850,6078259,10428,3477,1985,8937,2000,6951,1491,0.0,0.0,22,2.0,6,10,7,7.0,0.48052555322647095,0.33419421315193176
6768774,5638499,4140582,10435,7831,1997,1146,1979,2604,9289,0.0,0.0,33,12.0,10,1,56,749.0,0.45156174898147583,0.16877086460590363
6767243,5017740,5311063,10435,5619,1991,6704,1994,4816,3731,1.0,0.0,11,3.0,9,3,686,1638.0,0.318072646856308,0.15163654088974
6768424,5848651,6085328,10435,8384,1998,8951,2000,2051,1484,0.0,0.0,5,6.0,14,12,392,427.0,0.6380466222763062,0.2965373694896698
6766557,5090976,4189381,10435,5899,1992,1510,1980,4536,8925,0.0,0.0,52,12.0,9,1,49,728.0,0.44257599115371704,0.19583025574684143
6767283,6290600,4337646,10435,9392,2001,2378,1982,1043,8057,1.0,0.0,17,6.0,7,1,42,2450.0,0.5458328127861023,0.15720877051353455
6768710,4624914,4509543,10435,3981,1986,3386,1985,6454,7049,0.0,0.0,5,10.0,2,6,336,154.0,0.7372015118598938,0.19015760719776154
6769398,5732554,4379152,10442,8125,1998,2651,1983,2317,7791,0.5,0.0,62,2.0,5,4,28,273.0,0.4354513883590698,-0.0010915007442235947
6770335,5602661,4314722,10442,7712,1997,2231,1982,2730,8211,1.0,0.0,42,5.0,5,4,14,343.0,0.5410860180854797,0.16913045942783356
6772048,6462644,4694008,10442,9777,2002,4275,1987,665,6167,1.0,0.0,3,2.0,14,12,35,5250.0,0.6458828449249268,0.06782509386539459
6770969,5910881,6349985,10442,8559,1999,9553,2002,1883,889,0.5,0.0,3,3.0,4,8,105,154.0,0.40695685148239136,0.24836455285549164
6774306,5745344,4425659,10449,8153,1998,2931,1984,2296,7518,1.0,1.0,23,5.0,11,3,35,2177.0,0.4201722741127014,0.3461780548095703
6775564,5529755,4081373,10449,7481,1996,817,1978,2968,9632,0.0,0.0,13,13.0,7,2,455,126.0,0.7346144318580627,0.09527605772018433
6774571,5803566,4951750,10449,8286,1998,5353,1990,2163,5096,0.0,0.0,7,10.0,4,9,413,602.0,0.3306523561477661,0.30732399225234985
6777186,6277489,4599208,10456,9364,2001,3841,1986,1092,6615,0.0,0.0,17,7.0,15,1,7,1176.0,0.30598074197769165,0.05897821485996246
6777571,6541664,4978769,10456,9952,2003,5465,1990,504,4991,0.5,0.5,1,18.0,4,7,504,623.0,0.5877789258956909,0.31795620918273926
6780730,5811347,5384826,10463,8300,1998,6963,1995,2163,3500,1.0,0.0,41,3.0,6,38,21,91.0,0.4088330566883087,0.10416961461305618
6781724,5465155,re38227,10463,7250,1995,10092,2003,3213,371,0.5,0.5,43,2.0,9,13,0,91.0,0.6289430260658264,0.3610137701034546
6780719,6235590,4911038,10463,9273,2001,5199,1990,1190,5264,1.0,0.0,7,12.0,18,3,119,245.0,0.5838690400123596,0.008924104273319244
6779311,5943815,4293089,10463,8643,1999,2105,1981,1820,8358,0.0,0.0,18,5.0,24,1,0,266.0,0.36548709869384766,0.29582518339157104
6781328,6215252,6484473,10463,9231,2001,9826,2002,1232,637,1.0,0.0,7,1.0,4,6,175,637.0,0.4770217835903168,0.16324841976165771
6783502,6183489,4093038,10470,9168,2001,887,1978,1302,9583,1.0,0.0,7,6.0,52,2,105,413.0,0.42605841159820557,0.19796793162822723
6783646,6382958,5981981,10470,9623,2002,8713,1999,847,1757,0.0,0.0,2,6.0,11,4,175,7.0,0.4206961393356323,0.12605318427085876
6785651,6192354,5006530,10470,9182,2001,5577,1991,1288,4893,0.0,0.0,11,26.0,41,1,70,14.0,0.3534703254699707,0.04360876977443695
6785300,5987338,4417233,10470,8720,1999,2882,1983,1750,7588,1.0,0.0,8,25.0,4,3,7,147.0,0.5268676280975342,0.3042963743209839
6786819,6159097,4410450,10477,9112,2000,2847,1983,1365,7630,0.5,0.0,66,23.0,39,5,7,105.0,0.49021196365356445,0.10850751399993896
6786417,5388248,5297203,10477,6977,1995,6655,1994,3500,3822,0.5,0.0,31,9.0,7,4,56,56.0,0.5972563028335571,0.3922012150287628
6787424,6211026,4354435,10477,9224,2001,2483,1982,1253,7994,1.0,0.0,13,5.0,23,1,70,1043.0,0.5351287126541138,0.13558289408683777
6788455,5793524,4105757,10477,8258,1998,950,1978,2219,9527,0.5,0.5,4,9.0,8,1,119,2317.0,0.5532677173614502,0.16580495238304138
6789625,4228854,5501454,10484,1755,1980,7390,1996,8729,3094,1.0,0.0,55,1.0,3,21,42,3094.0,0.4750899076461792,0.10153859108686447
6795378,5699322,4205832,10491,8020,1997,1615,1980,2471,8876,1.0,0.0,15,6.0,1,1,252,5656.0,0.6670877933502197,0.18423624336719513
6793025,5635457,5515652,10491,7824,1997,7439,1996,2667,3052,0.5,0.0,15,4.0,18,9,14,231.0,0.4595538377761841,0.1595807522535324
6793959,6238926,4782534,10491,9280,2001,4695,1988,1211,5796,0.3333333333333333,0.0,4,8.0,11,3,42,1379.0,0.4784282445907593,0.08467088639736176
6795236,6236498,4779202,10491,9273,2001,4674,1988,1218,5817,1.0,0.0,9,4.0,10,6,196,455.0,0.6269481778144836,0.20112384855747223
6795798,6055483,4269368,10491,8881,2000,1972,1981,1610,8519,0.0,0.0,5,5.0,9,3,434,2135.0,0.5591269135475159,0.38383549451828003
6798515,5898494,5798616,10498,8517,1999,8272,1998,1981,2226,0.0,0.0,3,8.0,3,4,259,203.0,0.5078117251396179,0.24864089488983154
6799123,6542858,3988031,10498,9952,2003,299,1976,546,10199,1.0,0.0,1,13.0,25,1,546,511.0,0.29981082677841187,0.11773819476366043
6799777,5366242,4162926,10505,6900,1994,1307,1979,3605,9198,1.0,0.0,42,5.0,3,1,105,1575.0,0.7197328209877014,0.1662602424621582
6801499,6131084,5091693,10505,9049,2000,5899,1992,1456,4606,0.0,0.0,11,7.0,35,6,77,1379.0,0.29855695366859436,0.1116553470492363
6800566,6228700,6396521,10505,9259,2001,9644,2002,1246,861,1.0,0.0,3,1.0,2,7,7,861.0,0.18010254204273224,0.05585149675607681
6802057,5073851,4223651,10505,5829,1991,1727,1980,4676,8778,1.0,0.0,33,6.0,7,3,126,3472.0,0.08222459256649017,0.25747182965278625
6801548,6631134,4712978,10505,10141,2003,4366,1987,364,6139,0.5,0.0,1,7.0,21,2,364,35.0,0.5162261724472046,0.1314939707517624
6800961,6456153,5262284,10505,9763,2002,6529,1993,742,3976,0.0,0.0,2,3.0,11,6,56,3003.0,0.4311428368091583,0.10564214736223221
6804331,5987155,4409715,10512,8720,1999,2847,1983,1792,7665,0.0,0.0,15,5.0,10,1,49,161.0,0.3093366026878357,0.20055140554904938
6804579,4220170,4165642,10512,1706,1980,1335,1979,8806,9177,0.0,0.0,29,18.0,2,1,350,28.0,0.31844818592071533,-0.013750581070780754
6804636,6359748,6494937,10512,9574,2002,9847,2002,938,665,0.0,0.0,2,4.0,3,53,28,77.0,0.451839417219162,0.23931707441806793
6802605,6270221,4143582,10512,9350,2001,1167,1979,1162,9345,0.0,0.0,24,9.0,104,1,49,847.0,0.5917938947677612,0.028676344081759453
6804377,4943976,4640060,10512,5318,1990,4051,1987,5194,6461,0.0,0.0,76,13.0,8,1,0,259.0,0.3161592483520508,0.12240137904882431
6806604,5227066,6016220,10519,6403,1993,8783,2000,4116,1736,0.0,0.0,5,3.0,5,12,784,385.0,0.47971585392951965,0.16884909570217133
6806546,6391658,4764215,10519,9637,2002,4611,1988,882,5908,0.5,0.0,7,12.0,6,2,49,42.0,0.3153060972690582,0.23692966997623444
6804857,5513417,6537421,10519,7432,1996,9945,2003,3087,574,1.0,0.0,13,1.0,3,6,56,574.0,0.7253730297088623,0.3190962076187134
6805474,6508563,4163557,10519,9882,2003,1314,1979,637,9205,0.0,0.0,2,3.0,2,2,469,1043.0,0.4042094349861145,0.435890257358551
6808687,5063192,4650082,10526,5787,1991,4093,1987,4739,6433,1.0,0.0,18,14.0,3,3,98,966.0,0.7404623627662659,0.12282188981771469
6809105,5478939,4529958,10526,7299,1995,3484,1985,3227,7042,1.0,0.0,4,17.0,4,10,371,35.0,0.638340413570404,0.15442804992198944
6808547,5379506,5408026,10526,6949,1995,7047,1995,3577,3479,0.0,0.0,5,3.0,16,15,1211,756.0,0.5116681456565857,0.1382708102464676
6810517,5680551,4730977,10526,7964,1997,4457,1988,2562,6069,1.0,0.0,54,6.0,10,3,14,217.0,0.5149276256561279,0.2021295577287674
6812351,5275996,6205170,10533,6578,1994,9210,2001,3955,1323,0.5,0.0,6,2.0,12,6,21,112.0,0.6247198581695557,0.10268229991197586
6810818,6640727,4965431,10533,10169,2003,5409,1990,364,5124,1.0,0.0,1,6.0,1,10,364,1995.0,0.2954816520214081,0.30522990226745605
6812093,6362041,4180609,10533,9581,2002,1454,1979,952,9079,1.0,0.0,1,31.0,4,5,952,567.0,0.5916935205459595,0.10448797047138214
6813597,6381564,6413226,10533,9616,2002,9679,2002,917,854,1.0,0.0,5,1.0,5,21,42,854.0,0.49929580092430115,0.18601322174072266
6812369,4729979,6613951,10533,4450,1988,10106,2003,6083,427,0.0,1.0,15,1.0,11,11,1582,427.0,0.2602910101413727,0.30922579765319824
6814459,5900850,4136593,10540,8524,1999,1125,1979,2016,9415,0.0,0.0,33,3.0,6,1,56,882.0,0.5329527854919434,0.09916933625936508
6814335,6330948,5015627,10540,9483,2001,5612,1991,1057,4928,0.0,0.0,4,11.0,21,4,175,112.0,0.5095757246017456,0.2616148591041565
6819744,4620069,5863315,10547,3953,1986,8426,1999,6594,2121,1.0,0.0,16,3.0,2,11,126,238.0,0.37366193532943726,0.14351531863212585
6817244,5952574,4285818,10547,8657,1999,2063,1981,1890,8484,1.0,0.0,5,6.0,104,2,217,1260.0,0.2938261926174164,0.04341387748718262
6819701,4634928,4998268,10547,4023,1987,5542,1991,6524,5005,1.0,0.0,9,22.0,2,6,63,336.0,0.45289346575737,0.26921096444129944
6819934,6694148,6105314,10547,10274,2004,9000,2000,273,1547,0.5,0.0,1,3.0,10,15,273,322.0,0.7010827660560608,0.28946900367736816
6819862,5933570,4476229,10547,8615,1999,3204,1984,1932,7343,1.0,0.0,6,21.0,5,3,91,728.0,0.6492280960083008,0.14116384088993073
6819791,6275281,4122487,10547,9357,2001,1027,1978,1190,9520,0.0,0.0,1,16.0,7,1,1190,1211.0,0.466860830783844,0.22311967611312866
6823426,6378044,4033133,10554,9609,2002,551,1977,945,10003,1.0,0.0,2,20.0,15,2,49,63.0,0.6870245933532715,0.07758374512195587
6821424,4608157,4874288,10554,3890,1986,5038,1989,6664,5516,1.0,0.0,27,1.0,7,2,119,5516.0,0.4108133912086487,0.20177900791168213
6821227,5782328,6092263,10554,8237,1998,8972,2000,2317,1582,1.0,0.0,7,3.0,9,2,112,735.0,0.4890892803668976,0.25723996758461
6822652,5936628,4566199,10554,8622,1999,3680,1986,1932,6874,1.0,0.0,9,12.0,12,1,280,294.0,0.15285658836364746,0.22085264325141907
6820721,4550801,4891017,10554,3596,1985,5115,1990,6958,5439,0.0,0.0,9,9.0,2,9,14,588.0,0.5707645416259766,0.22290289402008057
6822598,6211806,5529748,10554,9224,2001,7481,1996,1330,3073,1.0,0.0,9,3.0,5,3,84,875.0,0.3789737820625305,0.04931239038705826
6824976,6174868,4946900,10561,9147,2001,5332,1990,1414,5229,0.0,0.0,6,7.0,11,4,105,1358.0,0.5451587438583374,0.06650009751319885
6826773,6256168,4456733,10561,9315,2001,3099,1984,1246,7462,1.0,0.0,3,6.0,26,1,756,210.0,0.7392898797988892,0.23375295102596283
6826194,5802526,5632793,10561,8279,1998,7817,1997,2282,2744,0.0,0.0,58,12.0,10,16,21,63.0,0.5522029995918274,0.2041381448507309
6826107,5841700,4505679,10561,8363,1998,3365,1985,2198,7196,1.0,0.0,24,3.0,12,1,49,1610.0,0.3822716474533081,0.023585131391882896
6826413,5379338,4265664,10561,6942,1995,1951,1981,3619,8610,1.0,0.0,13,6.0,3,1,665,4459.0,0.45269131660461426,0.07464087009429932
6826698,5968176,4530412,10561,8692,1999,3491,1985,1869,7070,1.0,0.0,40,14.0,5,1,7,441.0,0.6570022702217102,0.22479970753192902
6825232,6342525,4241169,10561,9525,2002,1818,1980,1036,8743,0.3333333333333333,0.0,1,15.0,36,1,1036,1869.0,0.723822832107544,0.21888987720012665
6829067,6292299,4293522,10568,9392,2001,2105,1981,1176,8463,1.0,0.0,6,29.0,6,6,84,826.0,0.6164429187774658,0.11167097091674805
6827870,5397420,4486616,10568,7012,1995,3260,1984,3556,7308,0.0,0.0,3,8.0,7,8,1568,105.0,0.5633335709571838,0.1090020164847374
6830540,6273843,5568789,10575,9357,2001,7607,1996,1218,2968,1.0,0.0,4,8.0,5,5,336,518.0,0.6766740083694458,0.2668278217315674
6832186,6063131,5240861,10575,8902,2000,6452,1993,1673,4123,1.0,0.0,1,5.0,7,4,1673,427.0,0.43126004934310913,0.31276455521583557
6830838,5607722,4080187,10575,7733,1997,810,1978,2842,9765,0.0,0.0,38,6.0,17,1,0,147.0,0.5300428867340088,0.21139474213123322
6832195,6535521,5410666,10575,9938,2003,7054,1995,637,3521,0.0,0.0,2,14.0,10,16,294,1470.0,0.31142300367355347,0.20748907327651978
6830546,5843121,4804713,10575,8370,1998,4793,1989,2205,5782,1.0,0.0,9,2.0,22,3,175,833.0,0.4828106760978699,0.037056971341371536
6829978,5329893,5843535,10575,6774,1994,8370,1998,3801,2205,0.0,0.0,9,7.0,1,2,287,70.0,0.2607133686542511,0.21974419057369232
6832728,4491923,6238260,10582,3288,1985,9280,2001,7294,1302,0.0,0.0,15,1.0,9,10,350,1302.0,0.47161832451820374,0.057097937911748886
re38671,5033425,4262059,10582,5682,1991,1930,1981,4900,8652,1.0,0.0,17,4.0,2,2,210,1890.0,0.3850797712802887,0.03316690772771835
6833962,6539638,4835011,10582,9952,2003,4898,1989,630,5684,0.5,0.0,3,8.0,9,4,245,315.0,0.512295126914978,-0.009142883121967316
6834653,4248253,4194842,10589,1860,1981,1545,1980,8729,9044,1.0,0.0,4,12.0,1,1,4417,1764.0,0.429953008890152,0.2990987300872803
6838926,5933382,6190389,10596,8615,1999,9182,2001,1981,1414,0.0,0.0,14,10.0,3,11,154,287.0,0.627718448638916,0.27208879590034485
6838810,5570267,5119340,10596,7607,1996,5997,1992,2989,4599,0.0,0.0,19,9.0,2,1,56,399.0,0.6213307976722717,0.2708439230918884
6840063,4822399,5643072,10603,4856,1989,7852,1997,5747,2751,1.0,0.0,31,4.0,8,5,651,1540.0,0.6103543639183044,0.159370556473732
6842777,5727159,4974671,10603,8104,1998,5451,1990,2499,5152,1.0,0.0,142,2.0,7,2,7,910.0,0.4391365051269531,0.04195468872785568
6839995,4809451,5542179,10603,4814,1989,7523,1996,5789,3080,0.5,0.0,12,4.0,2,5,826,609.0,0.4857284128665924,0.11753241717815399
6840730,5664924,5595725,10603,7922,1997,7691,1997,2681,2912,0.0,0.0,2,2.0,8,7,630,868.0,0.5534884333610535,0.20684421062469482
6842020,5419207,4455555,10603,7089,1995,3092,1984,3514,7511,0.5,0.0,13,11.0,3,5,42,945.0,0.3495296239852905,0.48621222376823425
6841117,4445406,4435064,10603,3043,1984,2987,1984,7560,7616,0.0,0.0,21,2.0,2,7,63,686.0,0.33959078788757324,0.22847439348697662
6843050,5644908,4285013,10610,7859,1997,2056,1981,2751,8554,1.0,0.0,6,6.0,8,1,665,2954.0,0.7583045959472656,0.23781517148017883
6845165,4909116,4391063,10610,5192,1990,2742,1983,5418,7868,0.0,0.0,5,10.0,5,1,2863,1008.0,0.41674095392227173,0.16772888600826263
6843802,6099560,4242646,10610,8986,2000,1825,1980,1624,8785,1.0,0.0,19,14.0,29,1,98,245.0,0.7738927602767944,0.2980162501335144
6843771,6554772,4420170,10610,9980,2003,2903,1983,630,7707,1.0,0.0,1,12.0,3,3,630,1281.0,0.6588404178619385,0.03570700064301491
6844946,5646399,4759633,10610,7859,1997,4590,1988,2751,6020,0.0,0.0,14,5.0,4,4,133,1106.0,0.44347721338272095,0.229005828499794
6843576,6028689,4397909,10610,8818,2000,2777,1983,1792,7833,1.0,0.0,60,6.0,4,2,0,3080.0,0.5627432465553284,0.11590954661369324
6846309,5261877,5527304,10617,6529,1993,7474,1996,4088,3143,1.0,1.0,57,9.0,23,14,0,301.0,0.34210100769996643,0.2761981785297394
6845758,6026786,5861999,10617,8818,2000,8419,1999,1799,2198,1.0,0.0,10,3.0,14,3,63,630.0,0.5659920573234558,0.14246919751167297
6848564,4249075,3978357,10624,1860,1981,243,1976,8764,10381,0.0,0.0,10,11.0,1,2,238,651.0,0.4825083315372467,0.3584524691104889
6852978,6376841,4817067,10631,9609,2002,4835,1989,1022,5796,0.5,0.0,1,9.0,3,17,1022,3430.0,0.5555895566940308,0.29069092869758606
6853047,6144539,4624291,10631,9077,2000,3981,1986,1554,6650,0.0,0.0,4,9.0,3,1,392,1022.0,0.3657817840576172,0.2624359428882599
6853822,5733698,6555579,10631,8125,1998,9980,2003,2506,651,1.0,0.0,10,1.0,29,10,413,651.0,0.31637030839920044,0.25627171993255615
6856945,6157685,6139578,10638,9105,2000,9070,2000,1533,1568,0.0,0.0,9,6.0,2,51,147,7.0,0.4010145366191864,0.18829111754894257
6858737,5574165,4023097,10645,7621,1996,495,1977,3024,10150,1.0,0.0,2,5.0,1,1,252,196.0,0.13967186212539673,0.06415755301713943
6858153,5693563,4104330,10645,8006,1997,943,1978,2639,9702,0.0,0.0,128,3.0,10,1,21,1204.0,0.5565489530563354,0.36259281635284424
6859155,5835034,5833990,10645,8349,1998,8349,1998,2296,2296,1.0,0.0,22,2.0,1,9,168,1351.0,0.6591319441795349,0.06732984632253647
6859250,5539545,4707154,10645,7509,1996,4338,1987,3136,6307,1.0,0.0,35,8.0,17,1,21,2716.0,0.5790609121322632,0.24970978498458862
6858259,5955161,5190827,10645,8664,1999,6270,1993,1981,4375,0.0,0.0,9,15.0,1,3,112,294.0,0.2790684998035431,0.3642168939113617
6862556,5765176,4291532,10652,8195,1998,2098,1981,2457,8554,1.0,0.0,94,11.0,26,1,0,315.0,0.4944312870502472,0.1919270157814026
6862526,4607257,4813759,10652,3883,1986,4828,1989,6769,5824,0.0,0.0,39,1.0,6,3,154,5824.0,0.39443740248680115,0.11733898520469666
6860355,5941337,6712395,10652,8636,1999,10316,2004,2016,336,0.5,0.0,3,1.0,6,11,637,336.0,0.4602762758731842,0.12138275802135468
6860481,4856263,5079782,10652,4975,1989,5857,1992,5677,4795,1.0,0.0,8,10.0,3,6,217,1722.0,0.5535931587219238,0.17335808277130127
6863749,4092178,4237563,10659,880,1978,1804,1980,9779,8855,1.0,0.0,6,4.0,3,3,70,322.0,0.61993008852005,0.19385135173797607
6864875,5767978,4050883,10659,8202,1998,635,1977,2457,10024,0.0,0.0,31,2.0,19,2,231,6258.0,0.4563395380973816,0.1218368336558342
6865073,6470283,4840341,10659,9791,2002,4919,1989,868,5740,1.0,0.0,2,9.0,5,5,224,91.0,0.39761507511138916,0.2139260619878769
6863307,6467807,4313266,10659,9791,2002,2224,1982,868,8435,0.0,0.0,5,7.0,19,1,7,28.0,0.3887995779514313,0.23030200600624084
6867674,5293146,6481849,10666,6641,1994,9819,2002,4025,847,1.0,0.0,5,2.0,2,18,105,126.0,0.6327651143074036,0.2818200886249542
6866196,5398336,4587209,10666,7012,1995,3778,1986,3654,6888,1.0,0.0,155,16.0,5,4,14,231.0,0.2115878015756607,0.33761006593704224
6868139,5161180,4931515,10666,6151,1992,5269,1990,4515,5397,0.5,0.0,34,3.0,4,6,196,700.0,0.5957536697387695,0.11494001746177673
6869076,6485020,3994396,10673,9826,2002,334,1976,847,10339,1.0,0.0,4,3.0,5,1,154,518.0,0.5826020240783691,0.08631919324398041
6870887,4939585,5491576,10673,5297,1990,7348,1996,5376,3325,0.5,1.0,3,17.0,9,2,3367,28.0,0.4505634307861328,0.17096436023712158
6870915,6226375,4882295,10673,9252,2001,5073,1989,1421,5600,1.0,0.0,3,2.0,8,6,231,581.0,0.45409095287323,0.040813885629177094
6868658,6438930,4097890,10673,9735,2002,908,1978,938,9765,0.5,0.0,2,18.0,26,2,406,2366.0,0.7297603487968445,0.12466805428266525
6871221,6256635,6621098,10673,9315,2001,10120,2003,1358,553,1.0,0.0,17,6.0,9,6,0,42.0,0.5332676768302917,0.0037875063717365265
6873183,6472909,5082413,10680,9798,2002,5864,1992,882,4816,1.0,0.0,3,10.0,3,19,133,252.0,0.6939122676849365,0.2079857736825943
6873315,6332084,4029404,10680,9483,2001,530,1977,1197,10150,0.0,0.0,2,10.0,2,1,497,4550.0,0.29893913865089417,0.17029011249542236
6872897,5669489,4620935,10680,7936,1997,3960,1986,2744,6720,1.0,0.0,6,13.0,5,2,931,2016.0,0.31972891092300415,0.01573532074689865
6873432,5749021,4372929,10680,8160,1998,2595,1983,2520,8085,0.0,0.0,19,11.0,9,2,154,938.0,0.38405731320381165,0.26084163784980774
6876114,5659216,4227653,10687,7901,1997,1748,1980,2786,8939,0.5,0.0,3,11.0,8,2,581,413.0,0.4440918564796448,0.016408510506153107
6874214,4687556,5870740,10687,4247,1987,8440,1999,6440,2247,0.0,0.0,5,10.0,3,19,2555,7.0,0.42787325382232666,0.15695486962795258
6874953,4447492,4572681,10687,3050,1984,3708,1986,7637,6979,0.0,0.0,35,7.0,4,8,217,3976.0,0.28363677859306335,0.2095220983028412
6876947,4499394,6664502,10687,3330,1985,10211,2003,7357,476,0.0,0.0,40,1.0,4,2,35,476.0,0.39679771661758423,0.14346861839294434
6877291,5315803,6343196,10694,6725,1994,9525,2002,3969,1169,0.5,0.0,3,1.0,11,2,287,1169.0,0.29419344663619995,0.07717529684305191
6879964,5946667,4756366,10694,8643,1999,4576,1988,2051,6118,1.0,0.0,16,6.0,10,6,56,1421.0,0.29820260405540466,0.19053223729133606
6878174,6090171,4940129,10694,8965,2000,5304,1990,1729,5390,1.0,0.0,1,2.0,35,2,1729,3577.0,0.46962788701057434,0.36369311809539795
6878664,5882810,5071434,10694,8475,1999,5822,1991,2219,4872,0.0,0.0,12,6.0,23,3,343,1050.0,0.6115496754646301,0.18457822501659393
6878507,5470772,4043925,10694,7271,1995,600,1977,3423,10094,0.0,0.0,13,9.0,10,2,49,301.0,0.45538029074668884,0.24766387045383453
6879427,5333117,4178638,10694,6781,1994,1447,1979,3913,9247,0.0,0.0,6,16.0,5,1,952,490.0,0.16162319481372833,0.16909289360046387
6878386,4537887,5331605,10694,3526,1985,6774,1994,7168,3920,0.5,0.0,13,1.0,3,2,224,3920.0,0.500598132610321,-0.039263416081666946
6880215,5850645,4685355,10701,8391,1998,4240,1987,2310,6461,1.0,0.0,7,2.0,6,4,154,357.0,0.6434175968170166,0.276567667722702
6880189,4127906,4648511,10701,1069,1978,4086,1987,9632,6615,1.0,0.0,37,7.0,1,3,63,1148.0,0.4081319272518158,0.14755260944366455
6885492,5083857,5307439,10708,5871,1992,6690,1994,4837,4018,0.0,0.0,169,6.0,5,3,28,21.0,0.5277193784713745,0.3008217215538025
6883709,6208264,4107455,10708,9217,2001,957,1978,1491,9751,0.5,0.0,3,5.0,20,1,763,1617.0,0.5854569673538208,0.015013371594250202
6885065,6329277,4929221,10708,9476,2001,5262,1990,1232,5446,1.0,0.0,5,5.0,2,5,70,686.0,0.421500563621521,0.1113876923918724
6883588,6478258,5326992,10708,9812,2002,6760,1994,896,3948,0.0,0.0,3,11.0,5,5,70,1673.0,0.607079029083252,0.19837558269500732
6886297,4853256,6395608,10715,4961,1989,9644,2002,5754,1071,0.0,0.0,22,1.0,3,3,392,1071.0,0.3257676064968109,0.3708624541759491
6889263,5638186,4895629,10715,7831,1997,5136,1990,2884,5579,0.0,0.0,7,7.0,2,4,154,63.0,0.3148852586746216,0.20699366927146912
6888521,5523803,5495275,10715,7460,1996,7362,1996,3255,3353,0.0,0.0,40,3.0,11,2,35,1239.0,0.5494892597198486,0.1794603019952774
6890153,4416585,6540503,10722,2882,1983,9952,2003,7840,770,1.0,0.0,32,1.0,3,6,14,770.0,0.6037986874580383,0.313662052154541
6890742,5985672,4727900,10722,8720,1999,4443,1988,2002,6279,0.0,0.0,10,6.0,15,4,294,504.0,0.5267447233200073,0.3293672502040863
6890865,6144083,5167999,10722,9077,2000,6179,1992,1645,4543,1.0,0.0,4,13.0,8,1,637,63.0,0.5002328157424927,0.039247266948223114
6891119,4657144,4861475,10722,4121,1987,4989,1989,6601,5733,0.5,0.0,28,2.0,4,5,266,2485.0,0.39881622791290283,0.35794198513031006
6890580,4698230,6339494,10722,4296,1987,9511,2002,6426,1211,1.0,0.0,14,3.0,3,6,84,483.0,0.5075879096984863,0.14028382301330566
6892371,6401234,4214978,10722,9651,2002,1671,1980,1071,9051,1.0,0.0,21,7.0,2,4,0,1148.0,0.5954604148864746,0.042850058525800705
6893397,5416695,4909512,10729,7075,1995,5192,1990,3654,5537,0.0,0.0,93,2.0,14,2,14,2800.0,0.5507873892784119,0.003820870304480195
6892398,5983398,4234083,10729,8720,1999,1783,1980,2009,8946,1.0,0.0,8,7.0,5,3,56,3234.0,0.6208324432373047,0.24879677593708038
6894399,5353498,4458296,10729,6858,1994,3106,1984,3871,7623,0.0,0.0,117,11.0,16,1,21,231.0,0.5715251564979553,0.35180428624153137
6893117,5128694,4137560,10729,6032,1992,1125,1979,4697,9604,1.0,0.0,18,11.0,7,1,259,63.0,0.3412681519985199,0.31207844614982605
6898781,6553559,6393268,10736,9973,2003,9637,2002,763,1099,0.5,0.0,4,3.0,24,5,63,189.0,0.2994947135448456,0.048268873244524
6898762,5109279,4200803,10736,5962,1992,1580,1980,4774,9156,0.0,0.0,31,4.0,6,1,28,5075.0,0.40592625737190247,0.057018622756004333
6896090,5511629,4603351,10736,7425,1996,3862,1986,3311,6874,1.0,0.0,11,7.0,7,4,308,2807.0,0.4153384268283844,0.09207699447870255
6895946,5069184,5756764,10736,5815,1991,8181,1998,4921,2555,1.0,0.0,10,10.0,8,3,504,98.0,0.5435147285461426,0.05305611714720726
6895795,5850755,4051683,10736,8391,1998,642,1977,2345,10094,1.0,0.0,5,15.0,10,1,42,238.0,0.45070648193359375,0.3939530849456787
6901300,5873251,5037512,10743,8454,1999,5696,1991,2289,5047,0.0,0.0,9,2.0,1,2,266,903.0,0.35771146416664124,0.21361978352069855
6900185,6030945,5706650,10743,8825,2000,8048,1998,1918,2695,0.0,0.0,3,8.0,22,7,833,98.0,0.2901981770992279,0.12690302729606628
6904592,6289511,6671240,10750,9385,2001,10225,2003,1365,525,1.0,0.0,2,2.0,13,2,511,77.0,0.4297149181365967,0.1820768266916275
6904673,4859808,5909779,10757,4982,1989,8559,1999,5775,2198,1.0,0.0,9,7.0,11,14,3745,42.0,0.342343807220459,0.20971807837486267
6910018,5385475,4503202,10764,6970,1995,3351,1985,3794,7413,0.0,0.0,44,3.0,37,1,49,2226.0,0.156672403216362,0.21847836673259735
6909691,6065118,4204424,10764,8902,2000,1608,1980,1862,9156,0.5,0.0,9,8.0,2,1,7,406.0,0.21827855706214905,0.13883216679096222
6909659,5905679,5502469,10764,8538,1999,7390,1996,2226,3374,0.0,0.0,5,7.0,5,15,42,1435.0,0.37649649381637573,0.21510876715183258
6915146,5252960,5545704,10778,6494,1993,7530,1996,4284,3248,0.0,0.0,22,2.0,9,5,28,308.0,0.5550234913825989,0.03351661190390587
6915157,5713367,5243986,10778,8069,1998,6466,1993,2709,4312,1.0,1.0,24,3.0,36,16,0,756.0,0.4812926948070526,0.21971845626831055
6913741,5419816,4486169,10778,7089,1995,3260,1984,3689,7518,0.0,0.0,16,17.0,18,5,70,1057.0,0.6660219430923462,0.1243177056312561
6916224,5352307,4385840,10785,6851,1994,2707,1983,3934,8078,0.0,0.0,23,4.0,12,1,154,3360.0,0.4306541681289673,0.21758383512496948
6918887,5419769,5551539,10792,7089,1995,7551,1996,3703,3241,1.0,0.0,14,5.0,8,3,84,1162.0,0.3794615864753723,0.07135652005672455
6918489,5779049,4207216,10792,8230,1998,1622,1980,2562,9170,1.0,0.0,5,2.0,15,1,7,8813.0,0.5056819915771484,0.04746545851230621
6921585,5400307,4549756,10799,7019,1995,3589,1985,3780,7210,1.0,0.0,7,6.0,7,3,98,217.0,0.619798481464386,0.11088500916957855
6921724,5935874,6744091,10799,8622,1999,10379,2004,2177,420,1.0,1.0,14,3.0,4,10,42,140.0,0.5720946788787842,0.3312567472457886
6922273,5293511,6681941,10799,6641,1994,10253,2004,4158,546,0.0,0.0,51,2.0,1,7,0,266.0,0.39537301659584045,0.2761800289154053
6924078,6177230,4875860,10806,9154,2001,5045,1989,1652,5761,0.5,0.0,4,11.0,3,4,735,2926.0,0.32979029417037964,0.160878986120224
6923288,6394218,6568749,10806,9644,2002,10008,2003,1162,798,1.0,1.0,24,2.0,12,11,0,70.0,0.6905159950256348,0.14375953376293182
6924476,5247384,5766097,10806,6473,1993,8202,1998,4333,2604,0.0,0.0,27,4.0,8,5,105,1162.0,0.5683090090751648,0.10590856522321701
6925338,5311447,5063457,10806,6704,1994,5787,1991,4102,5019,0.0,0.0,26,20.0,13,9,21,1498.0,0.26625150442123413,0.21083058416843414
6924719,6023212,5949019,10806,8804,2000,8650,1999,2002,2156,0.5,0.0,4,4.0,2,6,7,147.0,0.6576456427574158,0.3670143187046051
6927261,4859648,6640437,10813,4982,1989,10169,2003,5831,644,0.0,0.0,70,1.0,11,5,455,644.0,0.3862619996070862,0.23161815106868744
6926547,6276960,5238015,10813,9364,2001,6445,1993,1449,4368,1.0,0.0,7,4.0,3,6,154,3010.0,0.4328649640083313,0.1439313292503357
6928498,6397268,4369837,10813,9644,2002,2581,1983,1169,8232,1.0,0.0,10,10.0,9,2,154,203.0,0.5518759489059448,0.14230217039585114
6926775,6045620,5268328,10813,8860,2000,6550,1993,1953,4263,1.0,0.0,9,13.0,19,3,56,1407.0,0.4801294207572937,0.2711819112300873
6926853,6117258,6605830,10813,9021,2000,10085,2003,1792,728,1.0,0.0,4,1.0,13,1,126,728.0,0.3976183235645294,0.25765523314476013
6927758,5644139,4798356,10813,7852,1997,4765,1989,2961,6048,0.0,0.0,60,8.0,7,1,112,1071.0,0.4217451214790344,0.1739526242017746
6929493,4683944,5275819,10820,4233,1987,6578,1994,6587,4242,0.0,0.0,25,15.0,11,6,35,42.0,0.25659918785095215,0.24620471894741058
6929628,6444761,6247629,10820,9742,2002,9301,2001,1078,1519,0.0,0.0,1,13.0,42,11,1078,14.0,0.3374890983104706,0.1474570631980896
6931396,6109776,4955312,10820,9007,2000,5367,1990,1813,5453,0.3333333333333333,0.0,2,7.0,1,1,1148,1841.0,0.12505148351192474,0.07350098341703415
6929109,6237739,6668305,10820,9280,2001,10218,2003,1540,602,1.0,0.0,23,2.0,101,10,35,42.0,0.6082518100738525,0.20560525357723236
6929180,6181808,4651175,10820,9161,2001,4093,1987,1659,6727,1.0,0.0,4,7.0,7,8,609,1428.0,0.5076720118522644,0.2418109029531479
6931321,6263277,5235421,10820,9329,2001,6431,1993,1491,4389,0.0,0.0,4,14.0,6,2,56,175.0,0.5362268090248108,0.2727915346622467
6932004,5961248,4193010,10827,8678,1999,1531,1980,2149,9296,0.0,0.0,8,14.0,20,2,476,539.0,0.4926188290119171,0.4208385944366455
6932407,6499786,5924573,10827,9861,2002,8601,1999,966,2226,1.0,0.0,2,10.0,2,10,609,126.0,0.8520457148551941,0.3108955919742584
6932700,5344145,4430489,10827,6823,1994,2959,1984,4004,7868,1.0,0.0,25,3.0,3,2,203,896.0,0.5314921140670776,0.2732980251312256
6937148,4839645,6604320,10834,4912,1989,10085,2003,5922,749,1.0,0.0,19,2.0,6,5,168,21.0,0.597828209400177,0.08641916513442993
6935605,5966285,5316040,10834,8685,1999,6725,1994,2149,4109,0.0,1.0,16,6.0,10,2,343,1078.0,0.357744038105011,0.25587135553359985
6938089,5809282,4384085,10834,8293,1998,2693,1983,2541,8141,0.3333333333333333,0.0,43,2.0,59,3,56,2394.0,0.2985321879386902,0.11048337072134018
6937896,5578061,5286015,10834,7635,1996,6620,1994,3199,4214,1.0,0.0,22,2.0,6,8,7,2009.0,0.5917660593986511,0.23892877995967865
6938192,5355114,5504038,10834,6858,1994,7397,1996,3976,3437,0.0,0.0,39,16.0,9,14,140,70.0,0.5803900361061096,0.030509471893310547
6937187,5841396,6323576,10834,8363,1998,9462,2001,2471,1372,0.5,0.0,106,5.0,30,20,14,112.0,0.5117459297180176,0.10319961607456207
6938085,6317742,4630305,10834,9448,2001,4002,1986,1386,6832,1.0,0.0,9,10.0,7,15,105,98.0,0.4749737083911896,0.1500290334224701
6937840,6040919,4473096,10834,8846,2000,3190,1984,1988,7644,0.5,0.0,7,5.0,7,2,70,3430.0,0.5090669989585876,0.23177984356880188
6941332,5144568,6744091,10841,6088,1992,10379,2004,4753,462,1.0,0.0,15,3.0,4,10,105,182.0,0.6852306723594666,0.24208225309848785
6940538,6860806,5057555,10841,10652,2005,5766,1991,189,5075,0.0,0.0,1,16.0,7,8,189,959.0,0.3251817226409912,0.1353844404220581
6940733,4648020,6221893,10841,4079,1987,9245,2001,6762,1596,1.0,0.0,33,1.0,3,2,14,1596.0,0.5412395596504211,0.1878652125597
6939213,4810139,5111075,10841,4814,1989,5969,1992,6027,4872,1.0,0.0,6,9.0,1,10,301,889.0,0.4405602812767029,0.16158875823020935
6938946,4254986,4336812,10841,1895,1981,2371,1982,8946,8470,0.0,0.0,3,12.0,1,2,462,273.0,0.43948695063591003,0.30236491560935974
6940649,5969853,3997327,10841,8692,1999,348,1976,2149,10493,1.0,0.0,9,7.0,3,2,70,3493.0,0.4690745174884796,0.05871480703353882
6939361,6221092,5232714,10841,9245,2001,6424,1993,1596,4417,1.0,0.0,3,6.0,6,1,70,1078.0,0.4426635205745697,0.33541029691696167
6941649,5841074,4637306,10848,8363,1998,4037,1987,2485,6811,1.0,0.0,8,3.0,13,2,294,2380.0,0.48120349645614624,0.20051062107086182
6943731,4495505,6089462,10848,3309,1985,8965,2000,7539,1883,1.0,0.0,32,7.0,6,5,245,14.0,0.35950154066085815,0.05843877047300339
6944529,6374872,6510461,10848,9609,2002,9882,2003,1239,966,0.0,0.0,6,5.0,20,8,133,119.0,0.5073003768920898,0.2529718279838562
6943094,5622900,4037313,10848,7782,1997,572,1977,3066,10276,0.5,0.5,21,3.0,5,1,798,8288.0,0.5403347611427307,0.2794348895549774
6944068,5920509,5361526,10848,8587,1999,6886,1994,2261,3962,1.0,0.0,3,5.0,7,13,1141,112.0,0.41857099533081055,0.253309965133667
6947353,5923638,4296168,10855,8594,1999,2119,1981,2261,8736,1.0,0.0,5,16.0,5,1,483,2541.0,0.5782361030578613,0.15943065285682678
6947938,5274783,5096309,10855,6571,1993,5920,1992,4284,4935,1.0,0.0,50,12.0,11,4,21,1092.0,0.3718157112598419,0.03553437441587448
6947399,6466556,6702602,10855,9784,2002,10295,2004,1071,560,1.0,0.0,15,2.0,5,5,14,133.0,0.5437081456184387,0.06858135014772415
6947798,6154684,4529469,10855,9098,2000,3484,1985,1757,7371,1.0,0.0,7,14.0,11,2,119,1813.0,0.4324679970741272,0.37637436389923096
6945745,4580650,4514282,10855,3750,1986,3407,1985,7105,7448,0.0,0.0,6,2.0,3,7,1239,154.0,0.5182488560676575,0.06218891218304634
6946135,5851996,4334398,10855,8391,1998,2357,1982,2464,8498,0.5,0.0,23,7.0,12,1,21,2611.0,0.6281989812850952,0.10262098908424377
6947469,5416780,4579408,10855,7075,1995,3743,1986,3780,7112,1.0,0.0,9,28.0,15,1,140,791.0,0.4685569107532501,0.16612152755260468
6949080,6306125,4003781,10862,9427,2001,383,1977,1435,10479,0.5,0.0,10,9.0,42,1,7,175.0,0.41413435339927673,0.19101262092590332
6948645,5236342,6002322,10862,6438,1993,8748,1999,4424,2114,1.0,0.0,8,1.0,4,9,140,2114.0,0.6811637282371521,0.3270335793495178
6950912,6564304,5551888,10862,9994,2003,7551,1996,868,3311,1.0,0.0,11,4.0,10,4,14,1554.0,0.6024706363677979,0.10516216605901718
6949479,5962069,5996200,10862,8678,1999,8741,1999,2184,2121,0.5,0.0,27,1.0,2,3,77,2121.0,0.3503967821598053,0.2631760835647583
6948849,5689866,4920973,10862,7999,1997,5234,1990,2863,5628,1.0,0.0,12,5.0,9,10,77,1043.0,0.30419814586639404,0.2943750321865082
6952444,4005426,5467686,10869,390,1977,7264,1995,10479,3605,0.0,0.0,13,5.0,1,3,3808,1407.0,0.5246359705924988,0.13439901173114777
6951805,5846889,5422241,10869,8377,1998,7096,1995,2492,3773,0.0,0.0,58,21.0,7,1,7,56.0,0.04114687070250511,0.23322440683841705
6953684,5599689,5484439,10876,7705,1997,7320,1996,3171,3556,0.5,0.0,4,19.0,3,14,245,168.0,0.594200074672699,0.08011748641729355
6954097,5631872,4433553,10876,7810,1997,2980,1984,3066,7896,0.0,0.0,70,1.0,2,2,7,7896.0,0.330098420381546,0.11343609541654587
6954245,6714350,6775382,10876,10316,2004,10449,2004,560,427,0.5,0.0,3,2.0,23,8,266,49.0,0.6045672297477722,0.1957962065935135
6952890,4282659,5887731,10876,2049,1981,8489,1999,8827,2387,1.0,0.0,16,13.0,2,8,224,42.0,0.43004247546195984,0.31266406178474426
6953512,4946732,5866518,10876,5332,1990,8433,1999,5544,2443,0.0,0.0,9,4.0,18,6,336,679.0,0.531086802482605,0.25963959097862244
6957012,4718856,3989027,10883,4394,1988,306,1976,6489,10577,0.0,0.0,13,18.0,3,1,91,189.0,0.3026816248893738,0.23975832760334015
6955538,5090903,4291107,10883,5899,1992,2091,1981,4984,8792,1.0,0.0,4,18.0,8,2,945,651.0,0.5589735507965088,0.10432152450084686
6955038,5273396,5958317,10883,6571,1993,8671,1999,4312,2212,0.0,0.0,22,2.0,7,2,147,742.0,0.5855339765548706,0.2312549352645874
6957918,6196639,4722197,10890,9196,2001,4415,1988,1694,6475,0.0,0.0,7,5.0,6,4,217,490.0,0.5629866719245911,-0.032969310879707336
6959245,5751576,5098501,10890,8167,1998,5927,1992,2723,4963,0.0,0.0,43,17.0,4,3,35,42.0,0.12309056520462036,0.17467591166496277
6957733,4416449,5802485,10890,2882,1983,8279,1998,8008,2611,0.0,0.5,27,13.0,2,6,7,721.0,0.37671127915382385,0.3343161642551422
6958985,5805581,4762984,10890,8286,1998,4604,1988,2604,6286,1.0,0.0,17,22.0,17,1,266,945.0,0.4771362543106079,0.13897402584552765
6962439,5033868,4616609,10904,5682,1991,3939,1986,5222,6965,0.5,0.0,39,12.0,4,3,14,896.0,0.7431237101554871,0.14296793937683105
6963670,5860931,4169213,10904,8419,1999,1363,1979,2485,9541,0.0,0.0,27,1.0,50,1,224,9541.0,0.245536208152771,0.0806228518486023
6963866,6061686,4418243,10904,8895,2000,2889,1983,2009,8015,1.0,0.0,19,8.0,15,3,7,3584.0,0.4832693636417389,0.2467646300792694
6963301,4314251,5071468,10904,2224,1982,5822,1991,8680,5082,0.5,0.0,103,8.0,5,10,0,63.0,0.45864975452423096,0.08671534061431885
6963700,6081681,4593980,10904,8944,2000,3813,1986,1960,7091,0.5,0.0,21,3.0,4,1,98,2282.0,0.4828050136566162,0.4290392994880676
6965428,5231291,4165642,10911,6417,1993,1335,1979,4494,9576,0.0,0.0,26,27.0,10,1,35,70.0,0.31927868723869324,0.09812004119157791
6965376,4914624,5910151,10911,5206,1990,8559,1999,5705,2352,0.0,0.0,82,4.0,2,2,63,112.0,0.38467535376548767,0.2876169979572296
6966330,5404907,4693156,10918,7040,1995,4275,1987,3878,6643,1.0,0.0,38,10.0,3,7,126,77.0,0.4295555353164673,0.274529367685318
6968565,6570499,5021410,10918,10008,2003,5633,1991,910,5285,0.0,0.0,2,2.0,24,1,567,1484.0,0.41385361552238464,0.0680927038192749
6967956,6128379,4758466,10918,9042,2000,4583,1988,1876,6335,0.5,0.0,15,19.0,2,8,7,77.0,0.4531151354312897,0.1390495002269745
6966633,4855567,4393257,10918,4968,1989,2749,1983,5950,8169,0.0,0.0,30,4.0,12,4,21,7161.0,0.21130047738552094,0.06828969717025757
6967178,5334446,6537118,10918,6788,1994,9945,2003,4130,973,0.3333333333333333,0.0,57,1.0,15,9,77,973.0,0.584947943687439,0.15582378208637238
6969306,5234867,5882913,10925,6431,1993,8475,1999,4494,2450,0.0,0.0,131,1.0,10,9,21,2450.0,0.5877805948257446,0.09249445796012878
6970837,4237537,4562868,10925,1797,1980,3659,1986,9128,7266,1.0,0.0,11,2.0,4,1,525,3332.0,0.38621821999549866,0.1818232536315918
6969597,6066476,4465861,10925,8909,2000,3148,1984,2016,7777,0.5,0.0,6,8.0,5,4,420,385.0,0.2863316237926483,0.15613509714603424
6969042,4347898,6473408,10925,2441,1982,9798,2002,8484,1127,1.0,0.0,12,2.0,4,17,595,238.0,0.6347289085388184,0.3257800042629242
6970869,5835737,5839323,10925,8349,1998,8363,1998,2576,2562,1.0,0.0,61,3.0,2,5,42,1155.0,0.28403910994529724,0.008469684980809689
6972229,5051951,4301312,10932,5745,1991,2147,1981,5187,8785,0.0,0.0,16,4.0,16,2,21,7329.0,0.31756407022476196,0.16006869077682495
6975980,4366478,6371035,10939,2553,1982,9602,2002,8386,1337,0.0,0.0,25,1.0,5,2,49,1337.0,0.186035618185997,0.32576286792755127
6975094,5773959,6283338,10939,8216,1998,9378,2001,2723,1561,1.0,0.0,11,1.0,17,1,420,1561.0,0.5515925884246826,0.16655460000038147
6975987,5832437,5569433,10939,8342,1998,7607,1996,2597,3332,0.0,0.0,8,9.0,6,2,329,42.0,0.5638365745544434,0.11760107427835464
6976968,5133360,4850121,10946,6053,1992,4954,1989,4893,5992,1.0,0.0,70,8.0,6,1,63,2023.0,0.4421968460083008,0.1794290691614151
6977854,6781897,5281079,10946,10463,2004,6599,1994,483,4347,1.0,0.0,4,5.0,21,4,0,735.0,0.37310779094696045,0.2557199001312256
6976309,6557930,4672333,10946,9987,2003,4177,1987,959,6769,0.0,0.0,2,1.0,2,2,441,6769.0,0.3359659016132355,0.1370626538991928
6977020,5431208,6803039,10946,7131,1995,10512,2004,3815,434,0.0,0.0,7,1.0,4,8,357,434.0,0.6375994682312012,-0.051626332104206085
6976298,5850766,6367096,10946,8391,1998,9595,2002,2555,1351,0.0,0.0,2,5.0,23,2,1995,112.0,0.4590908885002136,0.19784751534461975
6978043,5579031,5234798,10946,7635,1996,6431,1993,3311,4515,0.0,0.0,34,7.0,16,16,14,259.0,0.36142781376838684,0.2315579056739807
6977569,6798312,4641987,10946,10498,2004,4058,1987,448,6888,1.0,0.0,1,13.0,78,1,448,245.0,0.4099804162979126,0.4154077172279358
6981050,5629732,4101575,10953,7803,1997,929,1978,3150,10024,0.0,0.0,23,11.0,11,1,105,532.0,0.4393130838871002,0.1296686828136444
6980091,6104707,5124627,10953,8993,2000,6018,1992,1960,4935,0.3333333333333333,0.0,26,15.0,17,2,0,1218.0,0.4601524770259857,0.1045435220003128
6979812,6770028,5854752,10953,10442,2004,8398,1998,511,2555,0.0,0.0,5,9.0,20,5,56,56.0,0.6318198442459106,0.15373536944389343
6980892,6606034,4068011,10953,10085,2003,740,1978,868,10213,0.0,0.0,6,3.0,59,1,217,2723.0,0.6913396120071411,0.012494847178459167
6983321,5430871,4243617,10960,7124,1995,1832,1981,3836,9128,1.0,0.0,14,13.0,1,1,112,385.0,0.2594105899333954,0.05421969294548035
6982578,6194916,4543427,10960,9189,2001,3554,1985,1771,7406,0.0,0.0,9,5.0,10,3,385,2548.0,0.548312246799469,0.07711314409971237
6982419,5959957,5947160,10960,8671,1999,8650,1999,2289,2310,0.0,0.0,8,2.0,10,3,238,1680.0,0.6845009326934814,0.17407791316509247
6985167,6371586,5062132,10967,9602,2002,5780,1991,1365,5187,1.0,0.0,19,28.0,11,5,42,420.0,0.43201208114624023,0.23161879181861877
6984499,5457030,4405786,10967,7222,1995,2819,1983,3745,8148,1.0,0.0,12,3.0,17,2,686,4312.0,0.7104985117912292,0.06344856321811676
6984232,6540755,5167917,10967,9952,2003,6179,1992,1015,4788,1.0,0.0,1,2.0,21,1,1015,3416.0,0.376325786113739,0.03176843374967575
6985037,6429700,4328547,10967,9714,2002,2315,1982,1253,8652,1.0,0.0,7,9.0,6,8,28,2730.0,0.5676690936088562,0.2553636133670807
6985437,5636211,5884917,10967,7824,1997,8482,1999,3143,2485,1.0,0.0,72,3.0,1,14,98,511.0,0.3047758936882019,0.11566033959388733
6983871,4403722,5177569,10967,2812,1983,6214,1993,8155,4753,1.0,0.0,46,18.0,3,2,245,637.0,0.6061974763870239,0.24685150384902954
6987971,6084546,4161781,10974,8951,2000,1293,1979,2023,9681,0.0,0.0,5,22.0,3,2,336,301.0,0.5986109375953674,0.20566263794898987
6986369,5662440,4375946,10974,7915,1997,2623,1983,3059,8351,0.0,0.0,11,4.0,19,2,105,5012.0,0.5562735199928284,0.25011613965034485
6986168,4282610,4508553,10974,2049,1981,3379,1985,8925,7595,0.0,0.0,16,12.0,1,2,336,1932.0,0.8030936121940613,0.29456883668899536
6988865,6722101,5612053,10981,10337,2004,7747,1997,644,3234,1.0,0.0,2,17.0,26,19,133,35.0,0.38662347197532654,0.30207398533821106
6989669,6335618,4434458,10981,9497,2002,2980,1984,1484,8001,0.5,0.0,1,3.0,10,1,1484,2233.0,0.44423383474349976,0.43016716837882996
6988642,5480045,4986057,10981,7306,1996,5500,1991,3675,5481,1.0,1.0,16,6.0,11,7,21,378.0,0.6054757237434387,0.366399884223938
6989004,5405376,5347432,10981,7040,1995,6830,1994,3941,4151,1.0,0.0,79,4.0,7,5,7,28.0,0.30754509568214417,0.23573768138885498
6992769,5631844,4638749,10988,7810,1997,4044,1987,3178,6944,1.0,0.0,18,9.0,2,4,42,2737.0,0.4604508578777313,0.4704511761665344
6992200,6838573,4424829,10988,10596,2005,2931,1984,392,8057,0.25,0.0,1,10.0,14,2,392,210.0,0.6742290258407593,0.07664912939071655
6991597,5192008,6272240,10988,6277,1993,9350,2001,4711,1638,0.0,0.0,15,3.0,1,4,133,532.0,0.26659947633743286,0.08508646488189697
6992107,5955490,5622690,10988,8664,1999,7782,1997,2324,3206,0.3333333333333333,0.3333333333333333,15,9.0,16,6,14,322.0,0.19495776295661926,0.15871116518974304
6992988,6631421,4987479,10988,10141,2003,5500,1991,847,5488,0.0,1.0,2,2.0,27,13,574,5201.0,0.6467186212539673,0.09537006169557571
6996645,5829040,4603351,10995,8335,1998,3862,1986,2660,7133,1.0,0.0,19,7.0,8,4,1120,3066.0,0.28090277314186096,0.03370730206370354
6995997,5642114,4767625,10995,7845,1997,4625,1988,3150,6370,0.0,0.0,27,25.0,4,3,147,574.0,0.5073649287223816,0.19244571030139923
6994306,5668570,5051244,10995,7929,1997,5745,1991,3066,5250,0.0,0.0,42,5.0,15,7,105,287.0,0.34068968892097473,0.10238834470510483
6994714,5824015,5261319,10995,8328,1998,6529,1993,2667,4466,1.0,0.0,45,4.0,44,1,0,924.0,0.32649311423301697,0.23875543475151062
6994789,5962075,3989873,10995,8678,1999,306,1976,2317,10689,0.0,0.0,4,9.0,32,3,630,3493.0,0.431832879781723,0.4598284065723419
6996686,5758056,3988924,10995,8181,1998,306,1976,2814,10689,1.0,0.0,46,1.0,13,2,56,10689.0,0.5407817959785461,0.07582815736532211
6996899,6198635,6197800,11002,9196,2001,9196,2001,1806,1806,0.0,0.0,37,2.0,13,1,63,868.0,0.2862362265586853,0.09389640390872955
6999524,6188732,4410497,11002,9175,2001,2847,1983,1827,8155,1.0,0.0,15,6.0,11,3,0,6230.0,0.3494807779788971,0.011582882143557072
6998566,6114650,4242823,11002,9014,2000,1832,1981,1988,9170,1.0,0.0,6,16.0,10,1,805,35.0,0.7370368838310242,0.21947838366031647
6998380,4053992,6857213,11002,656,1977,10645,2005,10346,357,0.0,0.0,5,1.0,1,3,217,357.0,0.4713708758354187,0.12727314233779907
7003615,6629179,6358601,11009,10134,2003,9574,2002,875,1435,1.0,0.0,6,4.0,4,8,49,553.0,0.3960523307323456,-0.007622276432812214
7000709,4418766,5671514,11009,2896,1983,7943,1997,8113,3066,1.0,0.0,22,4.0,4,2,42,987.0,0.42401212453842163,0.09796015918254852
7002058,6384301,4040190,11009,9623,2002,586,1977,1386,10423,0.5,0.0,1,14.0,8,1,1386,2149.0,0.9938052892684937,0.2748822569847107
7004574,4347524,5031091,11016,2434,1982,5668,1991,8582,5348,0.0,0.0,22,19.0,2,7,497,1232.0,0.5174636244773865,0.15772394835948944
7005748,6566760,4114053,11016,10001,2003,985,1978,1015,10031,1.0,0.5,2,5.0,6,1,189,1141.0,0.4575302004814148,0.2956141233444214
7005189,4379040,6693710,11016,2651,1983,10274,2004,8365,742,0.0,0.0,20,2.0,12,6,777,161.0,0.3587394654750824,0.1504816859960556
7004504,4364187,4706513,11016,2546,1982,4338,1987,8470,6678,0.0,0.0,21,6.0,1,1,63,1883.0,0.5684952735900879,0.17735014855861664
7007824,5613835,5823531,11023,7754,1997,8328,1998,3269,2695,0.0,0.0,5,5.0,7,5,266,1113.0,0.46624401211738586,0.21599292755126953
7009358,6360151,5165352,11023,9574,2002,6172,1992,1449,4851,0.5,0.0,13,9.0,6,5,21,1365.0,0.7195460796356201,0.15220344066619873
7009496,5390360,6076163,11023,6984,1995,8930,2000,4039,2093,0.0,1.0,23,2.0,3,10,42,133.0,0.40127503871917725,0.24810345470905304
7007374,6185078,4766156,11023,9168,2001,4618,1988,1855,6405,0.5,0.0,39,4.0,4,6,84,1477.0,0.496771901845932,0.09677926450967789
7011858,5709068,4917096,11030,8055,1998,5220,1990,2975,5810,0.0,0.0,3,36.0,7,8,2114,63.0,0.2997685372829437,0.18478164076805115
7012318,6072197,4298789,11030,8923,2000,2133,1981,2107,8897,1.0,0.0,18,28.0,2,3,0,21.0,0.18443246185779572,0.1018490120768547
7011809,5028634,4542559,11030,5661,1991,3554,1985,5369,7476,0.0,0.0,16,5.0,1,1,539,4865.0,0.44703158736228943,0.2008688747882843
7011251,5360992,6043700,11030,6879,1994,8853,2000,4151,2177,0.0,1.0,53,2.0,4,4,70,1834.0,0.5245212912559509,0.08558782935142517
7011161,4366971,4684290,11030,2560,1983,4233,1987,8470,6797,0.0,0.0,49,1.0,1,3,84,6797.0,0.1250234991312027,0.18870648741722107
7013552,6268678,5342635,11037,9343,2001,6816,1994,1694,4221,1.0,0.0,22,7.0,2,13,7,1190.0,0.21960844099521637,0.19066043198108673
7015875,6167358,4501844,11037,9126,2000,3344,1985,1911,7693,0.0,0.0,31,9.0,8,2,70,1267.0,0.3269428610801697,0.23340433835983276
7015719,6888375,4082865,11037,10715,2005,824,1978,322,10213,1.0,0.0,1,4.0,37,2,322,1106.0,0.9553197622299194,0.34507375955581665
7015168,5376595,4055797,11037,6935,1994,663,1977,4102,10374,0.0,0.0,42,3.0,6,1,217,6790.0,0.48400765657424927,0.03736232593655586
7014754,5618415,4929221,11037,7768,1997,5262,1990,3269,5775,1.0,0.0,9,5.0,16,5,42,1015.0,0.405226469039917,0.15321649610996246
7013601,4877210,5412781,11037,5052,1989,7061,1995,5985,3976,0.0,0.0,4,3.0,9,5,805,595.0,0.78216153383255,0.09516437351703644
7018399,6096068,5760719,11044,8979,2000,8188,1998,2065,2856,1.0,0.0,91,5.0,97,13,28,812.0,0.5750594139099121,0.11691360175609589
7018416,5658336,6282091,11044,7901,1997,9371,2001,3143,1673,1.0,0.0,39,2.0,17,8,35,1190.0,0.5965643525123596,0.3694323003292084
7018584,4594220,6285603,11044,3813,1986,9378,2001,7231,1666,0.0,0.0,17,6.0,1,8,1106,28.0,0.45065197348594666,0.27694496512413025
7019453,6090332,5286061,11044,8965,2000,6620,1994,2079,4424,0.0,0.0,13,31.0,6,19,49,574.0,0.39355963468551636,0.09887000918388367
7020275,6272219,4775414,11044,9350,2001,4660,1988,1694,6384,1.0,0.0,8,9.0,9,6,735,434.0,0.36456435918807983,0.06827320903539658
7023355,6345839,4292946,11051,9539,2002,2105,1981,1512,8946,0.0,0.0,15,2.0,5,1,168,7343.0,0.580265998840332,0.4015481472015381
7022570,5350489,4672333,11051,6844,1994,4177,1987,4207,6874,0.0,1.0,15,1.0,9,2,315,6874.0,0.38916078209877014,0.11193729937076569
7022937,5539176,5076555,11051,7509,1996,5843,1991,3542,5208,1.0,0.0,17,13.0,1,2,434,511.0,0.5618571639060974,0.22822213172912598
7021707,6087598,4011503,11051,8958,2000,432,1977,2093,10619,0.0,0.0,27,11.0,11,1,7,987.0,0.5256856679916382,0.1666775941848755
7022088,4769031,4275507,11051,4632,1988,2007,1981,6419,9044,1.0,0.0,40,7.0,1,2,105,987.0,0.43990615010261536,0.1685737520456314
7028187,4663664,5065378,11058,4142,1987,5794,1991,6916,5264,0.3333333333333333,0.0,16,2.0,5,3,1344,3759.0,0.29712602496147156,0.1209513321518898
7025159,5490572,5459755,11058,7348,1996,7229,1995,3710,3829,0.0,0.0,39,9.0,12,2,21,903.0,0.6980512142181396,0.07282248139381409
7027240,5808750,4825243,11058,8293,1998,4863,1989,2765,6195,0.5,0.0,14,13.0,4,8,28,3101.0,0.45234501361846924,0.41157066822052
7026666,6218711,5019923,11058,9238,2001,5626,1991,1820,5432,1.0,0.0,8,4.0,5,4,294,1820.0,0.5367840528488159,0.26433467864990234
7027786,5319799,4605394,11058,6732,1994,3876,1986,4326,7182,1.0,0.0,50,15.0,8,5,21,399.0,0.20271824300289154,-0.03274990990757942
7031520,4358279,5717410,11065,2504,1982,8076,1998,8561,2989,0.5,0.0,1,5.0,1,11,8561,1638.0,0.4216347336769104,0.15168094635009766
7030237,5177302,6241659,11065,6214,1993,9287,2001,4851,1778,0.0,0.0,3,8.0,1,16,1799,175.0,0.5983749628067017,0.23734180629253387
7031266,6256300,4165895,11065,9315,2001,1335,1979,1750,9730,1.0,0.0,33,6.0,5,2,21,1806.0,0.38752007484436035,0.21337944269180298
7029200,4367978,5906560,11065,2567,1983,8545,1999,8498,2520,1.0,0.0,16,4.0,1,14,329,371.0,0.4944368302822113,0.1327725201845169
7031720,5935218,4596835,11065,8622,1999,3827,1986,2443,7238,1.0,0.0,10,11.0,20,8,42,1113.0,0.6080606579780579,-0.017464114353060722
7029481,5591206,4950115,11065,7677,1997,5346,1990,3388,5719,1.0,0.0,15,21.0,3,5,56,504.0,0.517873227596283,0.30718591809272766
7030781,5835580,4188927,11065,8349,1998,1510,1980,2716,9555,0.0,0.0,24,33.0,15,2,238,70.0,0.347771018743515,0.1715734452009201
7034622,6667663,4274494,11072,10218,2003,2000,1981,854,9072,1.0,0.0,4,4.0,3,2,266,6930.0,0.4110579490661621,0.24460285902023315
7033379,5735877,6522159,11072,8132,1998,9910,2003,2940,1162,1.0,0.0,8,1.0,4,3,1281,1162.0,0.6546884179115295,0.14241746068000793
7034541,5325041,6741608,11072,6753,1994,10372,2004,4319,700,0.5,0.0,70,2.0,8,13,63,161.0,0.6019659042358398,0.14899547398090363
7034478,5543697,5206465,11072,7523,1996,6326,1993,3549,4746,0.0,0.0,15,7.0,25,8,42,875.0,0.4193776845932007,0.07033248990774155
7038001,6545115,5106256,11079,9959,2003,5955,1992,1120,5124,1.0,0.0,1,3.0,4,5,1120,329.0,0.6058747172355652,0.18858978152275085
7037639,5563702,5589425,11079,7586,1996,7670,1996,3493,3409,0.0,0.0,73,9.0,7,2,21,168.0,0.4457838535308838,0.23705971240997314
7039308,4792822,5121605,11079,4737,1988,6011,1992,6342,5068,1.0,0.0,28,25.0,8,13,7,7.0,0.2751712501049042,0.1731250137090683
7040445,5667032,4036823,11086,7929,1997,565,1977,3157,10521,1.0,0.0,23,16.0,6,1,28,7.0,0.3947787880897522,0.07769419252872467
7042396,4652884,5906800,11086,4100,1987,8545,1999,6986,2541,0.5,0.0,46,3.0,3,5,161,581.0,0.371122807264328,0.1317649632692337
7043088,5675332,4346269,11086,7950,1997,2427,1982,3136,8659,0.0,0.0,17,14.0,5,2,7,434.0,0.6436466574668884,0.1893884688615799
7040959,4817874,4600903,11086,4842,1989,3848,1986,6244,7238,0.0,0.0,21,5.0,2,2,259,1659.0,0.732170045375824,-0.06463103741407394
7044218,5079837,5029216,11093,5857,1992,5661,1991,5236,5432,0.0,0.0,26,18.0,8,3,7,35.0,0.402556836605072,0.12523221969604492
7044718,5185541,4831020,11093,6249,1993,4884,1989,4844,6209,0.0,0.0,4,5.0,4,3,490,147.0,0.4945073127746582,0.18680307269096375
7047096,6374298,6609227,11093,9602,2002,10092,2003,1491,1001,0.3333333333333333,0.5,13,2.0,12,3,77,462.0,0.5418573617935181,0.1405426561832428
7045220,6520242,4997602,11093,9910,2003,5542,1991,1183,5551,0.0,0.0,2,6.0,2,8,539,42.0,0.640485405921936,0.3965164124965668
7049164,4205428,6334255,11100,1615,1980,9497,2002,9485,1603,1.0,0.0,40,2.0,2,5,14,924.0,0.2901521921157837,0.10745692253112793
7049266,5318936,5164600,11100,6732,1994,6165,1992,4368,4935,1.0,0.0,4,6.0,12,9,3416,1274.0,0.48037347197532654,0.1513955146074295
7048891,5851376,4563606,11100,8391,1998,3659,1986,2709,7441,0.3333333333333333,0.0,10,7.0,1,4,868,70.0,0.5589066743850708,0.1543056219816208
7049034,6515343,6081026,11100,9896,2003,8944,2000,1204,2156,0.0,0.0,8,14.0,9,33,28,182.0,0.28892427682876587,0.39372751116752625
7051036,5864480,5437459,11100,8426,1999,7152,1995,2674,3948,1.0,0.0,15,5.0,8,3,161,42.0,0.4812513589859009,0.1597064882516861
7050951,5768156,5022472,11100,8202,1998,5640,1991,2898,5460,1.0,0.0,17,32.0,9,19,98,14.0,0.5290061831474304,0.236143097281456
7048241,5425452,4974248,11100,7110,1995,5444,1990,3990,5656,0.0,0.0,5,3.0,4,9,651,2394.0,0.4164818525314331,0.21718090772628784
7048781,5350728,5950675,11100,6844,1994,8657,1999,4256,2443,1.0,0.0,3,8.0,7,7,196,392.0,0.514162003993988,0.165421724319458
7054046,6003998,5868712,11107,8755,1999,8440,1999,2352,2667,1.0,0.0,4,2.0,16,3,707,833.0,0.4665284752845764,0.14986075460910797
7052304,4934950,4588638,11107,5283,1990,3785,1986,5824,7322,1.0,0.0,16,4.0,8,2,1127,2107.0,0.5095022916793823,0.22902911901474
7051808,5517593,6790912,11107,7439,1996,10484,2004,3668,623,0.5,0.0,113,1.0,8,12,0,623.0,0.4283529818058014,0.27971121668815613
7052131,6367929,5062142,11107,9595,2002,5780,1991,1512,5327,0.5,0.0,9,10.0,40,4,105,273.0,0.6529475450515747,0.048428796231746674
7052717,5202128,4772060,11107,6312,1993,4646,1988,4795,6461,1.0,0.0,68,8.0,11,4,273,21.0,0.45007288455963135,0.04658924788236618
7054463,5374976,5013421,11107,6928,1994,5605,1991,4179,5502,0.3333333333333333,0.0,97,3.0,8,2,7,847.0,0.40697211027145386,0.12363853305578232
7051699,6390054,6535748,11107,9637,2002,9938,2003,1470,1169,1.0,0.0,10,9.0,14,23,56,14.0,0.495354026556015,0.38887128233909607
7055393,5841675,6274424,11114,8363,1998,9357,2001,2751,1757,0.0,0.0,3,16.0,8,7,406,77.0,0.3004337251186371,0.24825824797153473
7058932,6021275,4539696,11114,8797,2000,3533,1985,2317,7581,1.0,0.0,21,8.0,7,2,56,5334.0,0.25359103083610535,0.23381340503692627
7056523,6010530,4599859,11114,8769,2000,3848,1986,2345,7266,1.0,0.0,61,3.0,63,2,35,1813.0,0.46081018447875977,0.20571844279766083
7056468,4968649,4464438,11114,5423,1990,3141,1984,5691,7973,1.0,0.0,9,12.0,1,6,749,203.0,0.4785146415233612,0.18623100221157074
7057415,6509757,4303960,11114,9882,2003,2161,1981,1232,8953,1.0,0.0,5,5.0,3,3,98,1463.0,0.3889170289039612,0.17896807193756104
7060500,5780296,4655665,11121,8230,1998,4114,1987,2891,7007,0.3333333333333333,0.0,6,8.0,4,3,448,2919.0,0.44670915603637695,-0.0067687612026929855
7061858,5740171,5261421,11121,8139,1998,6529,1993,2982,4592,0.0,0.0,149,13.0,5,10,42,343.0,0.290726900100708,-0.03732432797551155
7062363,5508932,4461643,11121,7411,1996,3127,1984,3710,7994,0.0,0.0,15,9.0,6,1,1071,3017.0,0.37594497203826904,0.06376894563436508
7062653,6938046,5109583,11121,10834,2005,5969,1992,287,5152,0.0,0.0,4,4.0,25,6,7,308.0,0.1718861162662506,0.21318836510181427
7061398,4850010,4806036,11121,4947,1989,4800,1989,6174,6321,0.0,0.0,23,6.0,7,6,651,4949.0,0.5154281854629517,0.18693871796131134
7059238,4718647,4683344,11121,4394,1988,4226,1987,6727,6895,0.0,0.0,13,3.0,12,3,70,5768.0,0.4780549108982086,0.19451719522476196
7060133,5846323,4529692,11121,8377,1998,3484,1985,2744,7637,1.0,0.0,1,6.0,2,7,2744,2821.0,0.6765682101249695,0.3334251046180725
7060624,6287963,4751897,11121,9385,2001,4555,1988,1736,6566,1.0,0.0,1,5.0,20,4,1736,252.0,0.32806381583213806,0.010471374727785587
7064270,6903268,5397937,11128,10750,2005,7012,1995,378,4116,0.3333333333333333,0.0,1,5.0,14,4,378,1834.0,1.0,0.24359960854053497
7063876,6751184,6753511,11128,10393,2004,10400,2004,735,728,0.0,0.0,2,1.0,6,8,525,728.0,0.7788211107254028,0.06775075197219849
7064654,5818127,6632539,11128,8314,1998,10148,2003,2814,980,0.5,0.0,33,1.0,14,18,21,980.0,0.4284256398677826,0.11084720492362976
7063625,5283732,5757532,11128,6606,1994,8181,1998,4522,2947,0.0,0.0,5,3.0,5,2,805,112.0,0.47520142793655396,0.22576084733009338
7065602,6279142,5063400,11128,9364,2001,5787,1991,1764,5341,1.0,0.0,11,17.0,17,2,371,49.0,0.27834999561309814,0.18582606315612793
7065198,6407988,5149143,11128,9665,2002,6109,1992,1463,5019,1.0,0.0,26,11.0,2,10,35,49.0,0.310176283121109,0.2939225137233734
7065006,6023256,4553040,11128,8804,2000,3603,1985,2324,7525,0.0,0.0,5,14.0,12,2,84,1253.0,0.3839784264564514,0.13381196558475494
7063679,6733474,4520534,11128,10358,2004,3442,1985,770,7686,1.0,0.0,1,4.0,29,1,770,42.0,0.5837410688400269,0.13189397752285004
7065780,5666293,6163261,11128,7922,1997,9119,2000,3206,2009,1.0,0.0,124,7.0,65,10,7,35.0,0.43286725878715515,0.22036239504814148
7065585,6424662,4743793,11128,9700,2002,4513,1988,1428,6615,0.0,0.0,2,3.0,19,3,434,98.0,0.5195241570472717,-0.0037118608597666025
7066872,5302168,5166586,11135,6676,1994,6172,1992,4459,4963,1.0,0.0,156,7.0,8,4,21,455.0,0.6773719191551208,0.2099289745092392
7067539,4170648,4778165,11135,1377,1979,4674,1988,9758,6461,0.3333333333333333,0.0,1,11.0,2,6,9758,2009.0,0.3133743703365326,0.07590775191783905
7069531,5898597,4625505,11135,8517,1999,3988,1986,2618,7147,1.0,0.0,73,3.0,17,7,0,6671.0,0.25854411721229553,0.16445620357990265
7068733,6157811,4611966,11135,9105,2000,3911,1986,2030,7224,0.5,0.0,17,25.0,42,8,119,238.0,0.3668442964553833,0.21387481689453125
7067175,6531182,5705416,11135,9931,2003,8041,1998,1204,3094,1.0,0.0,4,10.0,138,2,14,812.0,0.6418867707252502,0.07140347361564636
7066597,6102544,4181267,11135,8993,2000,1461,1980,2142,9674,1.0,0.0,8,3.0,5,2,42,917.0,0.578963041305542,0.20975056290626526
7070083,5263629,3978319,11142,6536,1993,243,1976,4606,10899,1.0,0.0,35,7.0,16,1,28,350.0,0.43688109517097473,0.13988012075424194
7070798,5639441,6152060,11142,7838,1997,9098,2000,3304,2044,0.3333333333333333,0.0,42,3.0,25,4,28,84.0,0.13422031700611115,0.2747002840042114
7072481,4975965,5841350,11142,5451,1990,8363,1998,5691,2779,0.5,0.0,10,10.0,6,17,49,91.0,0.3971409201622009,0.1817762404680252
7071052,6387739,4902073,11142,9630,2002,5164,1990,1512,5978,1.0,0.0,16,13.0,13,4,35,2338.0,0.37594443559646606,0.14064426720142365
7073175,4607325,4169213,11142,3883,1986,1363,1979,7259,9779,0.0,0.0,24,1.0,5,1,77,9779.0,0.4332261085510254,0.22596575319766998
7074871,4576994,4921942,11149,3729,1986,5234,1990,7420,5915,1.0,0.0,17,7.0,2,5,798,1589.0,0.5534261465072632,0.25825992226600647
7076335,6046565,5171770,11149,8860,2000,6193,1992,2289,4956,0.0,0.0,3,8.0,18,7,119,1722.0,0.48676183819770813,0.17608870565891266
7074653,6918178,4896129,11149,10792,2005,5136,1990,357,6013,0.0,1.0,1,6.0,20,3,357,1540.0,0.5826705098152161,0.27297866344451904
7076153,6282365,4904444,11149,9371,2001,5171,1990,1778,5978,1.0,0.0,17,2.0,12,4,21,1680.0,0.43115171790122986,0.15226814150810242
7074062,6349036,6734318,11149,9546,2002,10358,2004,1603,791,0.0,0.0,2,1.0,4,8,539,791.0,0.21402637660503387,0.14228826761245728
7076652,4858121,4384223,11149,4975,1989,2693,1983,6174,8456,1.0,0.0,126,17.0,5,4,7,70.0,0.32919421792030334,0.12546998262405396
7075844,6856547,5171000,11149,10638,2005,6193,1992,511,4956,1.0,0.0,3,9.0,7,2,42,357.0,0.45590290427207947,0.2023635357618332
7073575,5642778,5492702,11149,7852,1997,7355,1996,3297,3794,1.0,0.0,3,3.0,8,9,427,434.0,0.600851833820343,0.14521706104278564
7076128,6583899,6701641,11149,10036,2003,10295,2004,1113,854,0.0,0.0,3,1.0,6,9,70,854.0,0.6207751035690308,0.14290007948875427
7076186,5909606,5774425,11149,8552,1999,8216,1998,2597,2933,1.0,0.0,4,7.0,11,7,1204,98.0,0.5881303548812866,0.18528132140636444
7079439,6031782,5520789,11156,8825,2000,7453,1996,2331,3703,1.0,0.0,10,9.0,7,8,14,924.0,0.5396263599395752,0.1927507370710373
7078242,6500678,4362577,11156,9861,2002,2532,1982,1295,8624,1.0,0.0,10,3.0,4,3,70,5054.0,0.24408943951129913,0.33026471734046936
7077548,4739396,4209610,11156,4492,1988,1636,1980,6664,9520,0.0,0.0,51,23.0,9,1,21,1477.0,0.35719504952430725,0.0453539714217186
7079317,5446465,4383734,11156,7180,1995,2693,1983,3976,8463,0.0,0.5,31,15.0,1,2,532,1862.0,0.4957747757434845,0.2684391736984253
7077056,5996485,6299966,11156,8741,1999,9413,2001,2415,1743,0.6666666666666666,0.0,5,4.0,15,33,378,203.0,0.8073034882545471,0.1163320392370224
7080000,6035423,6792070,11156,8832,2000,10484,2004,2324,672,1.0,0.0,41,1.0,10,3,42,672.0,0.7129459977149963,0.17608408629894257
7077211,6079495,4284424,11156,8944,2000,2056,1981,2212,9100,1.0,0.0,49,1.0,45,1,7,9100.0,0.6308732032775879,0.3790426254272461
7079761,5790911,4892911,11156,8251,1998,5122,1990,2905,6034,1.0,0.0,21,19.0,1,19,21,532.0,0.4265604317188263,0.1896509826183319
7080848,5791671,6322001,11163,8258,1998,9462,2001,2905,1701,1.0,0.0,9,1.0,7,3,133,1701.0,0.35700082778930664,0.22400692105293274
7082415,6314169,4565951,11163,9441,2001,3673,1986,1722,7490,0.0,0.0,14,2.0,1,8,7,6958.0,0.3674475848674774,0.22887681424617767
7082201,6850621,4027382,11163,10624,2005,523,1977,539,10640,1.0,0.0,2,10.0,15,2,238,4165.0,1.0000001192092896,0.054194431751966476
7082510,6374324,5885890,11163,9602,2002,8482,1999,1561,2681,1.0,0.0,6,11.0,9,13,35,679.0,0.4137096703052521,0.23770397901535034
7082402,5790974,6292837,11163,8251,1998,9392,2001,2912,1771,0.0,1.0,120,1.0,2,12,7,1771.0,0.5410609245300293,0.29678648710250854
7085743,5126728,5227999,11170,6025,1992,6403,1993,5145,4767,0.5,0.0,26,8.0,20,4,14,3003.0,0.34617775678634644,0.12072303146123886
7085616,5730801,4702586,11170,8118,1998,4317,1987,3052,6853,0.0,0.0,79,3.0,29,1,49,5495.0,0.3864598572254181,0.2011776566505432
7085953,6279138,4222047,11170,9364,2001,1713,1980,1806,9457,1.0,0.0,9,18.0,34,2,63,1295.0,0.5205004811286926,0.24616628885269165
7084121,5681811,6919562,11170,7971,1997,10792,2005,3199,378,0.5,0.0,41,2.0,20,1,0,168.0,0.45551714301109314,-0.07162460684776306
7083612,6396901,5162710,11170,9644,2002,6158,1992,1526,5012,0.0,0.0,3,8.0,7,7,112,1085.0,0.31880277395248413,0.21099653840065002
7087008,6086525,6768901,11177,8958,2000,10435,2004,2219,742,1.0,0.0,13,2.0,4,9,105,280.0,0.44853267073631287,0.18016253411769867
7086597,6069700,6492545,11177,8916,2000,9840,2002,2261,1337,0.0,0.0,13,1.0,6,2,7,1337.0,0.4744250476360321,0.32643789052963257
7087290,5453168,4306467,11177,7208,1995,2182,1981,3969,8995,0.0,0.0,15,20.0,3,3,777,756.0,0.3039849102497101,0.16157925128936768
7089116,6351218,6760327,11177,9553,2002,10414,2004,1624,763,1.0,0.0,10,4.0,12,18,7,77.0,0.668077826499939,0.09687063843011856
7090623,5362290,6714778,11184,6886,1994,10316,2004,4298,868,1.0,0.0,10,4.0,15,11,14,175.0,0.6747509837150574,0.12436646968126297
7090188,5944383,5953262,11184,8643,1999,8657,1999,2541,2527,0.5,0.0,11,1.0,21,4,126,2527.0,0.6263411641120911,0.22220537066459656
7093675,6622796,4496494,11191,10127,2003,3316,1985,1064,7875,1.0,0.0,15,2.0,59,2,7,5481.0,0.3370364010334015,0.16572406888008118
7095131,6137187,6495567,11191,9063,2000,9847,2002,2128,1344,1.0,0.0,32,1.0,13,3,0,1344.0,0.9999999403953552,0.14863283932209015
7093875,5360250,5156796,11191,6879,1994,6137,1992,4312,5054,0.0,0.0,10,8.0,17,4,133,84.0,0.7098925113677979,0.07873620092868805
7095590,5499153,4195844,11191,7376,1996,1552,1980,3815,9639,1.0,1.0,17,3.0,2,3,1267,7112.0,0.5056336522102356,0.22225421667099
7093798,6595466,4285013,11191,10064,2003,2056,1981,1127,9135,1.0,0.0,2,6.0,5,1,462,3535.0,0.35131216049194336,0.13594985008239746
7097826,5093349,4553464,11198,5906,1992,3610,1985,5292,7588,0.5,0.0,18,3.0,2,1,42,154.0,0.5822219252586365,0.058644652366638184
7097645,5041113,5430716,11198,5710,1991,7124,1995,5488,4074,1.0,0.0,50,12.0,3,14,14,42.0,0.413251131772995,0.16749730706214905
7096692,5714199,5205810,11198,8069,1998,6326,1993,3129,4872,0.0,0.0,5,12.0,9,13,294,70.0,0.40273037552833557,0.14228425920009613
7099170,6584003,4117660,11198,10036,2003,1006,1978,1162,10192,1.0,0.0,17,2.0,11,3,28,7203.0,0.45789098739624023,0.06705557554960251
7101372,6102909,4585732,11205,8993,2000,3771,1986,2212,7434,1.0,0.0,15,7.0,14,3,0,4102.0,0.6953818202018738,0.20715755224227905
7101742,6407406,5304683,11205,9665,2002,6683,1994,1540,4522,1.0,0.0,39,3.0,4,2,42,3304.0,0.41703835129737854,0.1578424721956253
7101612,5519085,4388833,11205,7446,1996,2728,1983,3759,8477,0.0,0.0,57,14.0,11,2,63,98.0,0.48720863461494446,0.11281883716583252
7103380,5896369,4166650,11205,8510,1999,1342,1979,2695,9863,1.0,0.0,45,15.0,8,1,126,721.0,0.4290831685066223,0.18316566944122314
7103059,5471628,5199988,11205,7271,1995,6305,1993,3934,4900,0.0,0.0,25,5.0,20,8,7,1764.0,0.21369457244873047,0.039805613458156586
7101737,6331453,5513139,11205,9483,2001,7425,1996,1722,3780,0.5,0.0,51,17.0,5,3,14,98.0,0.6086387634277344,0.35931313037872314
7105866,6392257,6846070,11212,9637,2002,10617,2005,1575,595,1.0,0.0,46,1.0,73,10,63,595.0,0.9878065586090088,-0.0077966791577637196
7106786,6313786,5078048,11212,9441,2001,5850,1992,1771,5362,0.5,0.0,30,2.0,5,5,21,4508.0,0.38020631670951843,0.0454273484647274
7104986,4116198,5331548,11212,999,1978,6774,1994,10213,4438,1.0,1.0,167,16.0,3,10,21,98.0,0.5847361087799072,0.16580557823181152
7104006,5099605,6738410,11212,5934,1992,10365,2004,5278,847,1.0,0.0,6,2.0,6,16,490,91.0,0.5563732981681824,0.07008474320173264
7109003,5643763,5704569,11219,7852,1997,8041,1998,3367,3178,0.6666666666666666,0.0,5,6.0,1,10,140,623.0,0.20208026468753815,0.1402437537908554
7113152,5448314,6530563,11226,7187,1995,9931,2003,4039,1295,0.0,0.0,123,2.0,4,8,7,7.0,0.6067179441452026,0.17617101967334747
7113520,5425026,4011513,11226,7103,1995,432,1977,4123,10794,1.0,1.0,74,8.0,6,1,434,2534.0,0.5576088428497314,0.17464043200016022
7114100,6182195,5733314,11226,9161,2001,8125,1998,2065,3101,1.0,0.0,6,5.0,21,13,91,385.0,0.7132628560066223,0.10042376071214676
7113429,6337805,6274343,11226,9504,2002,9357,2001,1722,1869,1.0,0.0,24,2.0,8,14,0,945.0,0.47069379687309265,0.20090296864509583
7115051,4870776,4424262,11233,5024,1989,2924,1984,6209,8309,0.0,0.0,6,14.0,3,4,2611,210.0,0.17507533729076385,0.03420449048280716
7116017,5621529,4362898,11233,7775,1997,2532,1982,3458,8701,0.5,0.0,16,6.0,11,1,28,3647.0,0.5324207544326782,0.35528838634490967
7116781,5337361,5474459,11233,6795,1994,7285,1995,4438,3948,0.0,0.0,171,4.0,21,1,0,462.0,0.48500633239746094,0.08958854526281357
7114964,6350134,4651779,11233,9553,2002,4100,1987,1680,7133,0.5,0.0,20,7.0,5,2,63,1855.0,0.6971642374992371,0.23209169507026672
7115428,6806658,4826964,11233,10519,2004,4870,1989,714,6363,0.5,0.0,3,2.0,3,7,406,4942.0,0.6604014039039612,0.15177033841609955
7118652,5146203,5788796,11240,6095,1992,8251,1998,5145,2989,0.3333333333333333,0.0,5,18.0,6,26,245,28.0,0.4755702614784241,0.15417782962322235
7119524,5532914,4499423,11240,7488,1996,3330,1985,3752,7910,0.0,0.0,33,6.0,2,5,420,196.0,0.534740149974823,0.25029411911964417
7118942,5161728,6836113,11240,6158,1992,10589,2004,5082,651,0.0,0.0,39,4.0,12,8,210,35.0,0.3713056147098541,0.1729324460029602
7120477,6675027,4596113,11240,10232,2004,3827,1986,1008,7413,1.0,0.0,1,5.0,14,2,1008,2310.0,0.9792766571044922,0.17239628732204437
7119573,5880598,5062633,11240,8468,1999,5787,1991,2772,5453,1.0,0.0,70,18.0,4,16,21,7.0,0.23294900357723236,0.09115277230739594
7119945,5515076,4390601,11240,7432,1996,2735,1983,3808,8505,0.0,0.0,57,20.0,1,4,21,2716.0,0.2139013111591339,0.17671264708042145
7118551,5246420,4709307,11240,6473,1993,4345,1987,4767,6895,1.0,0.0,21,9.0,14,4,287,140.0,0.617483913898468,0.2021070122718811
7123622,5734650,6777298,11247,8125,1998,10456,2004,3122,791,1.0,0.0,13,2.0,4,7,147,497.0,0.4775127172470093,0.11847937852144241
7123657,6285716,4152120,11247,9378,2001,1216,1979,1869,10031,1.0,0.0,11,18.0,2,3,196,2625.0,0.7556840181350708,0.12118081003427505
7121926,6527818,6752244,11247,9924,2003,10400,2004,1323,847,0.5,0.0,9,1.0,1,13,147,847.0,0.2891349196434021,0.1808510273694992
7124754,5507599,5071434,11254,7411,1996,5822,1991,3843,5432,0.0,0.0,9,6.0,30,3,21,1610.0,0.3160243332386017,0.0987272709608078
7126269,6249082,6567117,11254,9301,2001,10001,2003,1953,1253,0.5,0.0,8,6.0,2,15,385,91.0,0.4215227961540222,0.18978552520275116
7126716,6236486,4509474,11254,9273,2001,3386,1985,1981,7868,0.0,0.0,11,10.0,18,2,182,567.0,0.468742311000824,0.2527226507663727
7127532,6476935,5033991,11254,9805,2002,5682,1991,1449,5572,0.0,0.0,3,13.0,36,6,357,1687.0,0.6238754987716675,0.2577716112136841
7125711,5932315,6383633,11254,8615,1999,9623,2002,2639,1631,0.0,0.0,51,3.0,9,24,7,224.0,0.4426785409450531,0.2601237893104553
7127154,5657072,4111493,11254,7894,1997,978,1978,3360,10276,1.0,0.0,59,16.0,24,1,14,343.0,0.4371417462825775,0.2781411111354828
7125025,6328328,5801558,11254,9476,2001,8279,1998,1778,2975,1.0,0.0,13,7.0,9,4,105,1071.0,0.7474972605705261,0.12330074608325958
7127988,5626074,4491195,11261,7796,1997,3288,1985,3465,7973,0.5,0.0,9,3.0,7,5,224,7007.0,0.5925310850143433,0.19511395692825317
7128400,6692108,4148041,11261,10274,2004,1188,1979,987,10073,1.0,0.0,2,11.0,3,1,42,70.0,0.9630964398384094,0.5917531847953796
7130104,5061049,4439724,11261,5780,1991,3008,1984,5481,8253,0.3333333333333333,0.0,332,4.0,10,1,14,5502.0,0.4492435157299042,0.22509540617465973
7129547,5434093,5221381,11261,7138,1995,6382,1993,4123,4879,1.0,0.0,117,11.0,9,7,7,84.0,0.5494941473007202,0.20886237919330597
7132869,6940322,5850888,11268,10841,2005,8391,1998,427,2877,1.0,0.0,1,2.0,5,6,427,1162.0,0.4229176640510559,0.10044866055250168
7132712,4337474,4522780,11268,2371,1982,3449,1985,8897,7819,1.0,0.0,14,12.0,1,8,147,3661.0,0.4420163631439209,0.18294300138950348
7132591,6815587,4916008,11268,10540,2004,5213,1990,728,6055,1.0,0.0,1,9.0,1,4,728,721.0,0.9806112051010132,0.08844547718763351
7134924,5505641,4967433,11275,7404,1996,5423,1990,3871,5852,1.0,0.0,5,14.0,6,9,791,70.0,0.6006647944450378,0.22920876741409302
7135720,5290393,5886682,11275,6634,1994,8482,1999,4641,2793,0.0,0.0,113,3.0,6,6,28,2121.0,0.4416089951992035,0.09707276523113251
7137592,6742741,6334046,11282,10379,2004,9490,2001,903,1792,1.0,0.0,2,4.0,3,10,161,420.0,0.4106837213039398,0.0765928402543068
7139422,5619429,4096521,11282,7768,1997,901,1978,3514,10381,1.0,0.0,37,4.0,13,2,14,2002.0,0.2743982970714569,0.18736588954925537
7137737,4832507,4328017,11282,4891,1989,2315,1982,6391,8967,1.0,0.0,9,3.0,3,4,1036,6447.0,0.6015328168869019,0.2278236299753189
7139797,6223165,5232061,11282,9245,2001,6424,1993,2037,4858,1.0,0.0,29,8.0,56,8,42,1001.0,0.42975664138793945,0.22721467912197113
7138014,6197181,4236398,11282,9196,2001,1797,1980,2086,9485,0.0,0.0,68,15.0,8,2,7,2037.0,0.5850740075111389,0.23305672407150269
7142639,6148061,4435080,11289,9084,2000,2987,1984,2205,8302,1.0,0.0,30,4.0,9,1,84,245.0,0.5349996089935303,0.19104735553264618
7141061,5306286,4657992,11289,6690,1994,4121,1987,4599,7168,1.0,0.0,130,3.0,5,3,14,1827.0,0.25323739647865295,0.26232728362083435
7141518,6358909,3989873,11289,9574,2002,306,1976,1715,10983,0.0,1.0,7,9.0,14,3,98,3787.0,0.21701236069202423,0.5335339307785034
7142688,4823908,4338347,11289,4863,1989,2378,1982,6426,8911,0.0,0.0,23,7.0,1,1,70,3101.0,0.4193994998931885,0.14901615679264069
7144385,4529402,4093850,11296,3484,1985,887,1978,7812,10409,1.0,0.0,10,14.0,7,2,3626,1435.0,0.4709356725215912,0.14837577939033508
7144152,6470289,5358186,11296,9791,2002,6872,1994,1505,4424,1.0,0.0,20,5.0,8,2,126,1449.0,0.6563518047332764,0.07591582089662552
7149760,6918082,4379727,11303,10785,2005,2658,1983,518,8645,1.0,0.0,2,18.0,8,5,56,315.0,0.5582551956176758,0.146992027759552
7147650,5855569,5460930,11303,8405,1999,7236,1995,2898,4067,1.0,0.0,2,3.0,6,11,1351,1372.0,0.5761478543281555,0.09869411587715149
7147576,6648774,5413862,11303,10183,2003,7068,1995,1120,4235,1.0,0.0,7,4.0,20,2,14,1344.0,0.6568818092346191,0.18762555718421936
7147760,5348620,6162519,11303,6837,1994,9119,2000,4466,2184,0.0,0.0,72,3.0,16,2,0,245.0,0.09169607609510422,0.3080809414386749
7154598,5166515,6602213,11317,6172,1992,10078,2003,5145,1239,0.0,0.0,24,2.0,4,8,252,252.0,0.3594661056995392,0.1309133768081665
7155241,5828882,6687013,11317,8335,1998,10260,2004,2982,1057,0.0,0.0,37,6.0,5,3,7,147.0,0.4074975550174713,0.17859400808811188
7153601,5993986,4516331,11317,8734,1999,3421,1985,2583,7896,1.0,0.0,22,8.0,43,1,28,2107.0,0.5972763299942017,0.22846518456935883
7153301,4705517,5926375,11317,4331,1987,8601,1999,6986,2716,1.0,0.0,128,12.0,5,6,14,126.0,0.3255265951156616,0.1351384073495865
7155675,5682511,4431010,11317,7971,1997,2966,1984,3346,8351,0.5,0.0,63,8.0,7,1,105,4704.0,0.5484651327133179,0.24037934839725494
7152901,5251949,5501454,11317,6494,1993,7390,1996,4823,3927,1.0,0.0,9,2.0,11,21,546,182.0,0.46413135528564453,0.22000524401664734
7156823,5312577,6501549,11324,6711,1994,9861,2002,4613,1463,0.0,0.0,24,1.0,10,3,14,1463.0,0.5042468309402466,0.2048763632774353
7158698,5214728,5103568,11324,6354,1993,5948,1992,4970,5376,0.3333333333333333,0.0,13,11.0,4,5,910,119.0,0.6537445783615112,0.24633491039276123
7155765,5081728,5940700,11324,5864,1992,8629,1999,5460,2695,1.0,0.0,19,6.0,2,6,448,497.0,0.4288122057914734,0.15228724479675293
7160262,5918602,5536169,11331,8587,1999,7502,1996,2744,3829,1.0,1.0,3,5.0,3,15,56,119.0,0.40676388144493103,0.28267794847488403
7160378,4915856,4537057,11331,5213,1990,3526,1985,6118,7805,0.5,0.0,18,3.0,6,5,14,1981.0,0.5893645286560059,0.27318525314331055
7159325,5362046,4195780,11331,6886,1994,1552,1980,4445,9779,0.0,0.0,57,22.0,3,3,21,833.0,0.1704399734735489,0.2595335841178894
7160543,5342613,4961817,11331,6816,1994,5395,1990,4515,5936,0.5,0.0,8,6.0,3,2,0,3430.0,0.4143162667751312,0.08126083016395569
7161513,5280500,4699568,11331,6592,1994,4303,1987,4739,7028,0.0,0.0,72,4.0,4,4,49,1757.0,0.2552143931388855,0.17919375002384186
7161791,6377438,5502469,11331,9609,2002,7390,1996,1722,3941,1.0,0.0,22,8.0,85,15,56,91.0,0.46803680062294006,0.3156929910182953
7160566,5675153,6865300,11331,7950,1997,10659,2005,3381,672,0.3333333333333333,0.0,23,1.0,4,27,448,672.0,0.49940595030784607,0.12214680761098862
7163081,5141074,4599208,11338,6081,1992,3841,1986,5257,7497,0.5,0.0,5,8.0,1,1,938,91.0,0.534135103225708,0.028200946748256683
7162797,5013226,4557911,11338,5605,1991,3631,1985,5733,7707,0.0,0.0,5,5.0,1,9,686,35.0,0.35276129841804504,0.15344183146953583
7164188,6136666,5682273,11338,9063,2000,7971,1997,2275,3367,1.0,0.0,46,37.0,5,27,7,98.0,0.40173065662384033,0.11014895886182785
7162973,5718187,4871653,11338,8083,1998,5024,1989,3255,6314,1.0,0.0,7,9.0,14,6,119,3339.0,0.6232714653015137,0.3062748312950134
7163585,5902763,5710864,11338,8531,1999,8055,1998,2807,3283,0.0,0.0,27,2.0,15,5,35,7.0,0.10859332233667374,0.024736639112234116
7168022,6493334,4288552,11345,9840,2002,2077,1981,1505,9268,0.5,0.0,6,16.0,7,3,161,1372.0,0.254872590303421,-4.217028617858887e-06
7166578,6630450,4244784,11345,10141,2003,1839,1981,1204,9506,0.5,0.0,5,4.0,10,2,42,2590.0,0.6063123345375061,0.04164537787437439
7167181,6697063,6281704,11345,10281,2004,9371,2001,1064,1974,0.5,0.0,14,7.0,7,6,7,329.0,0.6049904227256775,0.14659355580806732
7165919,6641341,5810739,11345,10169,2003,8300,1998,1176,3045,1.0,0.0,5,13.0,10,1,252,63.0,0.4316731095314026,0.11411909759044647
7169865,6433112,5318330,11352,9721,2002,6732,1994,1631,4620,0.5,0.0,2,5.0,10,1,1155,1302.0,0.635087788105011,0.20027890801429749
7170522,5606709,4988755,11352,7726,1997,5507,1991,3626,5845,0.5,0.0,3,3.0,4,5,1939,2569.0,0.5106440782546997,-0.009618092328310013
7168140,4670327,4783773,11352,4170,1987,4695,1988,7182,6657,0.0,0.0,19,18.0,2,6,1232,224.0,0.5997934937477112,0.1773768961429596
7168549,5272805,6744484,11352,6571,1993,10379,2004,4781,973,0.0,0.0,25,2.0,3,9,224,14.0,0.46136415004730225,0.2924477756023407
7168350,5816809,5505988,11352,8314,1998,7404,1996,3038,3948,0.0,0.0,12,4.0,47,3,0,1925.0,0.38058263063430786,0.23077547550201416
7171194,5343493,5399847,11352,6816,1994,7019,1995,4536,4333,1.0,0.0,39,19.0,3,5,70,91.0,0.48172298073768616,0.29980936646461487
7171635,4615011,4035070,11352,3925,1986,558,1977,7427,10794,1.0,0.0,181,5.0,2,1,7,1309.0,0.547283947467804,0.24437342584133148
7170214,5134334,4457927,11352,6053,1992,3106,1984,5299,8246,1.0,0.0,21,17.0,8,3,140,119.0,0.2569148540496826,0.21433404088020325
7169202,6315130,6686611,11352,9448,2001,10260,2004,1904,1092,1.0,0.0,3,1.0,10,7,98,1092.0,0.5928365588188171,-0.007265307474881411
7173222,6182712,4810180,11359,9168,2001,4814,1989,2191,6545,0.0,0.0,21,8.0,17,2,21,875.0,0.3097216486930847,0.21638594567775726
7172357,6237609,4258426,11359,9280,2001,1909,1981,2079,9450,0.0,0.0,8,5.0,10,10,0,2982.0,0.38827165961265564,0.1783566176891327
7172024,5425559,5544915,11359,7110,1995,7530,1996,4249,3829,0.0,0.0,62,10.0,9,9,0,77.0,0.44302427768707275,0.06466459482908249
7173425,5363845,4081707,11359,6893,1994,817,1978,4466,10542,0.0,0.0,33,15.0,3,1,7,1456.0,0.44993269443511963,0.32380375266075134
7171989,5890520,4291107,11359,8496,1999,2091,1981,2863,9268,0.5,0.0,19,19.0,51,2,147,392.0,0.5945209860801697,0.04364846274256706
7176185,6420425,5432764,11366,9693,2002,7131,1995,1673,4235,0.0,0.0,2,2.0,7,3,91,2877.0,0.3460645377635956,0.14188651740550995
7176391,5801339,5111075,11366,8279,1998,5969,1992,3087,5397,0.5,0.0,14,9.0,4,10,140,420.0,0.5912317633628845,0.25270742177963257
7176025,5824517,4427906,11366,8328,1998,2945,1984,3038,8421,1.0,0.0,30,8.0,4,1,140,371.0,0.5057553648948669,0.03529495745897293
7174896,6893392,4336032,11366,10729,2005,2364,1982,637,9002,1.0,0.0,11,8.0,38,1,28,329.0,0.5123735070228577,0.22594872117042542
7174714,6876097,5337428,11366,10687,2005,6802,1994,679,4564,0.0,0.0,2,3.0,27,4,392,1015.0,0.41214749217033386,0.24634240567684174
7176880,5625460,5969247,11366,7789,1997,8692,1999,3577,2674,0.0,0.0,21,5.0,5,1,14,245.0,0.4254666864871979,0.313551127910614
7175901,5117283,5908443,11366,5990,1992,8552,1999,5376,2814,0.0,0.0,31,14.0,5,10,210,189.0,0.26747673749923706,0.23174244165420532
7176317,4851045,4449094,11366,4954,1989,3057,1984,6412,8309,0.0,0.0,93,2.0,8,2,7,7042.0,0.17170704901218414,0.1882423758506775
7180507,5477012,4383442,11373,7292,1995,2693,1983,4081,8680,0.0,0.0,218,1.0,8,3,0,8680.0,0.45735791325569153,0.26212260127067566
7181519,6751677,5969786,11373,10393,2004,8692,1999,980,2681,1.0,0.0,6,5.0,10,13,21,448.0,0.4469587504863739,0.08196055889129639
7180981,5682412,4335435,11373,7971,1997,2357,1982,3402,9016,1.0,0.0,16,6.0,76,1,70,4333.0,0.6418057680130005,0.06399939209222794
7179698,5733641,4445446,11373,8125,1998,3043,1984,3248,8330,0.0,0.0,39,10.0,6,2,21,2709.0,0.3848719000816345,0.22623291611671448
7179262,5258031,5441811,11373,6515,1993,7166,1995,4858,4207,1.0,0.0,195,5.0,11,5,7,609.0,0.33964547514915466,0.12616054713726044
7182210,4500146,5587224,11380,3337,1985,7663,1996,8043,3717,1.0,0.0,31,13.0,3,10,21,273.0,0.5198251008987427,0.1328549087047577
7182075,5044337,4983873,11380,5724,1991,5486,1991,5656,5894,0.5,0.0,5,7.0,9,7,35,1029.0,0.5793938040733337,0.14862775802612305
7184601,5481553,6295534,11380,7306,1996,9399,2001,4074,1981,0.0,1.0,60,6.0,3,3,238,168.0,0.5285941362380981,0.20303668081760406
7182298,6679459,6412486,11380,10246,2004,9679,2002,1134,1701,1.0,0.0,1,2.0,8,14,1134,966.0,0.5065104365348816,0.11472444236278534
7184850,5946212,5454975,11380,8643,1999,7215,1995,2737,4165,0.0,0.0,21,3.0,4,14,98,1344.0,0.3769439160823822,0.055211108177900314
7182574,6231311,4664722,11380,9266,2001,4149,1987,2114,7231,0.5,0.0,12,8.0,7,4,273,1995.0,0.5083568096160889,0.22862696647644043
7187364,6941160,6152060,11387,10841,2005,9098,2000,546,2289,0.0,0.0,2,4.0,12,4,105,91.0,0.42760053277015686,0.13773421943187714
7186181,5421009,5131821,11387,7089,1995,6046,1992,4298,5341,0.0,0.0,168,10.0,1,7,42,1001.0,0.3804529905319214,0.17017467319965363
7186307,6319343,4249890,11387,9455,2001,1867,1981,1932,9520,0.3333333333333333,0.0,1,11.0,4,1,1932,3514.0,0.40307265520095825,0.29697147011756897
7189473,6210827,4247035,11394,9224,2001,1853,1981,2170,9541,1.0,0.0,8,2.0,51,1,581,6328.0,0.3852544128894806,0.2634184658527374
7190230,6310512,5446003,11394,9434,2001,7180,1995,1960,4214,0.5,0.0,7,10.0,14,1,217,49.0,0.24247145652770996,0.1935008466243744
7193578,6667721,4324518,11401,10218,2003,2294,1982,1183,9107,1.0,0.0,3,12.0,10,4,112,420.0,0.43422144651412964,0.39141273498535156
7193894,5059554,4904673,11401,5773,1991,5171,1990,5628,6230,0.0,0.0,39,3.0,7,2,70,3451.0,0.29472437500953674,-0.0440107136964798
7194192,6640045,4195516,11401,10162,2003,1552,1980,1239,9849,1.0,0.0,2,2.0,6,1,938,1225.0,0.32897916436195374,0.23108288645744324
7192956,6521657,7004092,11401,9910,2003,11016,2006,1491,385,0.5,0.0,10,1.0,34,20,168,385.0,0.6689940690994263,0.06927213072776794
7194600,6301696,6490456,11401,9413,2001,9833,2002,1988,1568,1.0,0.0,49,5.0,13,4,14,112.0,0.6120167374610901,0.030306292697787285
7194536,6332141,4643542,11401,9483,2001,4065,1987,1918,7336,1.0,0.0,8,8.0,27,2,105,224.0,0.542425274848938,0.2674427032470703
7196103,6337344,4150732,11408,9504,2002,1209,1979,1904,10199,1.0,0.0,9,13.0,2,1,315,245.0,0.8309012055397034,0.07983402907848358
7195923,4925545,5269696,11408,5248,1990,6557,1993,6160,4851,0.5,0.0,4,4.0,4,6,1547,1232.0,0.3715442717075348,0.03522135689854622
7197768,6101378,3978357,11408,8986,2000,243,1976,2422,11165,0.5,0.0,18,11.0,7,2,21,1435.0,0.2817463278770447,0.13058100640773773
7195423,4408978,6142517,11408,2840,1983,9077,2000,8568,2331,0.5,0.0,10,8.0,6,11,91,189.0,0.3469313085079193,0.22367915511131287
7195886,6057117,4313025,11408,8888,2000,2217,1982,2520,9191,0.3333333333333333,0.0,8,14.0,1,5,84,14.0,0.7942444682121277,0.09782709181308746
7196870,5639509,4561298,11408,7838,1997,3652,1985,3570,7756,0.0,0.0,37,13.0,2,1,378,364.0,0.3442098796367645,0.20780758559703827
7198510,5295078,5374267,11415,6648,1994,6928,1994,4767,4487,0.0,0.0,103,21.0,10,7,98,700.0,0.20882803201675415,0.21586960554122925
7199444,5543737,4237346,11415,7523,1996,1797,1980,3892,9618,0.0,0.0,69,2.0,4,1,21,8827.0,0.3416348397731781,0.2710567116737366
7199573,4556840,4571812,11415,3624,1985,3708,1986,7791,7707,1.0,0.0,25,5.0,11,8,679,2310.0,0.49913808703422546,0.05962950736284256
7200736,6449709,4088276,11415,9749,2002,859,1978,1666,10556,1.0,0.0,8,19.0,21,1,0,105.0,0.682866632938385,0.15866084396839142
7203735,6466970,4023151,11422,9784,2002,495,1977,1638,10927,1.0,0.0,35,20.0,15,1,14,287.0,0.43691685795783997,0.22105520963668823
7201027,4926662,4218078,11422,5255,1990,1692,1980,6167,9730,1.0,0.0,3,5.0,3,1,1498,1792.0,0.4935559630393982,0.08258049190044403
7203616,6525657,4876789,11422,9917,2003,5052,1989,1505,6370,0.0,0.5,12,2.0,6,4,84,3948.0,0.5386911630630493,0.1740298718214035
7203311,6202211,4768608,11422,9203,2001,4632,1988,2219,6790,1.0,0.0,16,17.0,62,2,35,1659.0,0.4640166163444519,0.25052428245544434
7202031,5837443,4515830,11422,8356,1998,3414,1985,3066,8008,1.0,0.0,3,2.0,1,10,119,7112.0,0.3505765497684479,0.13289988040924072
7201324,4672182,4621390,11422,4177,1987,3967,1986,7245,7455,1.0,0.0,49,8.0,11,1,147,399.0,0.3839990496635437,0.3181816339492798
7206417,4829570,4022885,11429,4877,1989,495,1977,6552,10934,1.0,0.0,54,8.0,6,1,42,1652.0,0.5333245396614075,-0.013343111611902714
7204025,5960549,4380907,11429,8678,1999,2672,1983,2751,8757,1.0,0.0,4,6.0,16,2,637,840.0,0.45997312664985657,0.10353927314281464
7205696,4993290,4902696,11429,5528,1991,5164,1990,5901,6265,1.0,0.0,9,4.0,1,10,126,2744.0,0.528393566608429,-0.05757903307676315
7205939,4426712,4149755,11429,2938,1984,1202,1979,8491,10227,0.0,0.0,115,12.0,5,1,21,1372.0,0.4816112518310547,0.16741667687892914
7209473,6292840,5281504,11436,9392,2001,6599,1994,2044,4837,0.5,0.0,19,11.0,9,1,35,469.0,0.4789420962333679,0.3202645480632782
7208492,5318976,4339246,11436,6732,1994,2385,1982,4704,9051,1.0,0.0,16,5.0,3,2,336,1386.0,0.49426862597465515,0.2555994987487793
7208190,5873904,5599284,11436,8454,1999,7705,1997,2982,3731,1.0,1.0,173,3.0,30,7,0,1127.0,0.2314646691083908,0.16197296977043152
7207445,5997731,6466197,11436,8741,1999,9784,2002,2695,1652,0.0,0.0,6,3.0,16,10,371,56.0,0.3795193135738373,0.21923963725566864
7210206,4632880,4807636,11443,4016,1986,4807,1989,7427,6636,0.0,0.0,15,14.0,2,12,77,1365.0,0.3445853590965271,0.10658594965934753
7211923,6046659,4085350,11443,8860,2000,838,1978,2583,10605,0.0,0.0,84,5.0,3,1,21,1379.0,0.25844672322273254,0.24531424045562744
7212617,5608786,4266543,11443,7733,1997,1958,1981,3710,9485,1.0,0.0,481,36.0,6,1,0,749.0,0.6784778237342834,0.02407340705394745
7211171,5990377,4315404,11443,8727,1999,2238,1982,2716,9205,0.0,0.0,91,11.0,63,3,49,1421.0,0.3908267915248871,0.26258260011672974
7216204,6496925,5602811,11450,9847,2002,7712,1997,1603,3738,1.0,0.0,13,5.0,24,1,35,574.0,0.34111320972442627,0.4370921552181244
7215090,6270172,5750498,11450,9350,2001,8167,1998,2100,3283,0.5,0.0,16,13.0,9,5,21,280.0,0.3242111802101135,0.1451423466205597
7216012,5730299,6931925,11450,8118,1998,10827,2005,3332,623,0.5,0.0,9,1.0,2,10,707,623.0,0.33393236994743347,0.2098279744386673
7215339,5619341,4052965,11450,7768,1997,649,1977,3682,10801,0.0,0.0,14,15.0,4,1,350,1204.0,0.47740638256073,0.33539336919784546
7217470,5976725,4202681,11457,8706,1999,1594,1980,2751,9863,1.0,0.0,28,18.0,3,3,154,6496.0,0.594421923160553,0.27381062507629395
7218403,6312373,4689209,11457,9441,2001,4254,1987,2016,7203,1.0,0.0,20,1.0,4,7,14,7203.0,0.6381120085716248,0.07518025487661362
7219087,5943660,5633117,11457,8636,1999,7817,1997,2821,3640,0.0,0.0,12,2.0,16,28,301,1323.0,0.2460501790046692,0.07299919426441193
7217356,5755942,5542850,11457,8181,1998,7523,1996,3276,3934,0.0,0.0,81,4.0,74,31,35,1001.0,0.41754278540611267,0.18143101036548615
7218724,6310948,4644480,11457,9434,2001,4065,1987,2023,7392,1.0,0.0,5,16.0,8,1,70,1967.0,0.5838903188705444,0.1488189548254013
7221363,6416208,6466197,11464,9686,2002,9784,2002,1778,1680,0.0,1.0,20,3.0,63,10,49,84.0,0.36286479234695435,0.31781336665153503
7220800,6479222,4128962,11464,9812,2002,1076,1978,1652,10388,0.0,0.0,5,9.0,15,1,182,812.0,0.4164499342441559,0.2729644179344177
7220990,6686755,3993837,11464,10260,2004,327,1976,1204,11137,0.0,0.0,4,8.0,2,1,525,1386.0,0.25348639488220215,0.14213122427463531
7221920,6710669,5055134,11464,10309,2004,5759,1991,1155,5705,0.0,0.0,2,6.0,2,4,714,203.0,0.6633511185646057,0.1797189712524414
7219733,6660080,4285034,11464,10204,2003,2056,1981,1260,9408,0.0,0.0,16,11.0,40,1,14,1197.0,0.20236924290657043,0.11141885817050934
7222723,6152291,4019656,11471,9098,2000,481,1977,2373,10990,1.0,1.0,18,12.0,8,1,70,2198.0,0.6083847284317017,0.2938148081302643
7222979,6224221,6638047,11471,9252,2001,10162,2003,2219,1309,1.0,0.0,8,2.0,3,1,70,56.0,0.5285668969154358,0.310172975063324
7222583,5143289,5621705,11471,6088,1992,7775,1997,5383,3696,1.0,0.0,22,3.0,1,14,7,2002.0,0.6408668160438538,0.2725154459476471
7225436,6141794,4616473,11471,9070,2000,3939,1986,2401,7532,1.0,0.0,19,4.0,4,7,77,3024.0,0.5786224603652954,0.19133247435092926
7224044,5572070,5080195,11471,7614,1996,5857,1992,3857,5614,1.0,0.0,32,16.0,2,5,308,182.0,0.4611060917377472,0.18821494281291962
7228104,4178550,4862629,11478,1440,1979,4996,1989,10038,6482,1.0,0.0,13,13.0,2,3,721,189.0,0.5595145225524902,0.13271670043468475
7230816,6144547,5525037,11485,9077,2000,7467,1996,2408,4018,1.0,0.0,23,4.0,16,5,14,329.0,0.4716435968875885,0.12318116426467896
7231661,5819271,5980081,11485,8314,1998,8713,1999,3171,2772,0.5,0.3333333333333333,92,6.0,22,5,14,441.0,0.31271591782569885,0.14451313018798828
7230165,5545816,4963830,11485,7530,1996,5402,1990,3955,6083,0.6666666666666666,0.0,19,9.0,4,13,28,413.0,0.47124218940734863,-0.06965451687574387
7230480,4847864,4366344,11485,4940,1989,2553,1982,6545,8932,0.0,0.0,22,13.0,2,2,49,21.0,0.32120200991630554,0.12204691022634506
7232798,6124361,4060238,11492,9035,2000,698,1977,2457,10794,0.5,0.0,7,11.0,1,1,504,483.0,0.45045509934425354,0.046245213598012924
7234529,6047949,4714249,11499,8867,2000,4373,1987,2632,7126,0.0,0.0,2,4.0,1,2,2205,1680.0,0.5821359157562256,0.3063179552555084
7234542,7124825,6693319,11499,11254,2006,10274,2004,245,1225,1.0,0.0,1,3.0,15,18,245,14.0,0.35001856088638306,0.15503118932247162
7235707,5932495,5461366,11499,8615,1999,7236,1995,2884,4263,0.5,0.0,25,5.0,10,3,42,2065.0,0.4658881723880768,0.09941266477108002
7239581,4521847,6491865,11506,3442,1985,9840,2002,8064,1666,0.3333333333333333,0.0,77,1.0,25,12,84,1666.0,0.39332252740859985,0.10930190235376358
7240289,5388993,4954532,11506,6984,1995,5360,1990,4522,6146,0.0,0.0,50,19.0,12,2,168,175.0,0.36833375692367554,0.10861455649137497
7240118,6678733,4841499,11506,10239,2004,4919,1989,1267,6587,1.0,0.0,16,32.0,27,6,35,1701.0,0.4575454890727997,0.16566121578216553
7239147,6392416,5929748,11506,9637,2002,8608,1999,1869,2898,0.5,0.0,4,22.0,10,7,266,14.0,0.3859110176563263,0.11652323603630066
7241866,6153590,4752829,11513,9098,2000,4555,1988,2415,6958,1.0,0.0,3,6.0,2,9,112,4053.0,0.16329869627952576,0.08274438977241516
7240663,4807495,4386169,11513,4807,1989,2707,1983,6706,8806,0.0,0.0,23,10.0,8,5,14,2996.0,0.4960651099681854,0.10241245478391647
7240459,4197952,4983814,11513,1566,1980,5486,1991,9947,6027,0.0,0.0,13,20.0,2,3,1092,84.0,0.5044154524803162,0.18739408254623413
7242456,6133986,4986708,11513,9056,2000,5500,1991,2457,6013,1.0,0.0,125,1.0,23,3,7,6013.0,0.5732207894325256,0.13236719369888306
7240908,4678445,4951750,11513,4205,1987,5353,1990,7308,6160,0.0,0.0,14,12.0,1,9,91,203.0,0.4185941815376282,0.14445917308330536
7245698,7127028,4071305,11520,11254,2006,761,1978,266,10759,0.0,0.0,1,2.0,3,2,266,9982.0,0.6265930533409119,0.2588052749633789
7245132,6551491,4333136,11520,9973,2003,2343,1982,1547,9177,0.0,0.0,5,14.0,15,2,14,2128.0,0.5256990194320679,-0.00691258767619729
7246015,6534993,4729257,11520,9938,2003,4450,1988,1582,7070,0.0,0.0,21,25.0,3,2,84,399.0,0.3614332675933838,0.20985697209835052
7246335,7039536,4130219,11520,11079,2006,1083,1978,441,10437,1.0,0.0,1,6.0,12,1,441,511.0,0.6779236793518066,0.07827569544315338
7246212,6665780,5802825,11520,10211,2003,8286,1998,1309,3234,1.0,0.0,9,6.0,4,11,28,833.0,0.4919443130493164,0.1886967420578003
7245741,6813371,5334775,11520,10533,2004,6788,1994,987,4732,1.0,0.0,1,3.0,9,17,987,371.0,0.5319157838821411,0.11017158627510071
7247531,5318921,5701159,11527,6732,1994,8027,1997,4795,3500,1.0,0.0,9,5.0,2,1,2632,7.0,0.392524778842926,0.23940977454185486
7247970,6841919,5094364,11527,10603,2005,5913,1992,924,5614,1.0,0.0,4,4.0,6,4,35,2156.0,0.6753652095794678,0.1559464931488037
7246572,4503809,5360326,11527,3358,1985,6879,1994,8169,4648,1.0,0.0,2,2.0,2,4,483,3297.0,0.6393015384674072,0.3167339265346527
7249000,6560543,5543174,11527,9987,2003,7523,1996,1540,4004,0.0,0.0,8,12.0,16,17,315,1001.0,0.5029516816139221,0.16659103333950043
7250904,6583758,5754722,11534,10036,2003,8174,1998,1498,3360,0.5,0.0,4,12.0,11,4,238,455.0,0.5412209630012512,0.2653377056121826
7250176,4525352,4384002,11534,3463,1985,2693,1983,8071,8841,1.0,0.0,10,3.0,2,3,287,1939.0,0.5215824842453003,0.16693109273910522
7254223,5444768,4379152,11541,7173,1995,2651,1983,4368,8890,1.0,0.0,67,8.0,13,4,7,147.0,0.5492837429046631,-0.035975079983472824
7252631,5342298,4384002,11541,6816,1994,2693,1983,4725,8848,1.0,0.0,44,3.0,23,3,77,1946.0,0.4585643410682678,0.013286197558045387
7254287,6417892,5894936,11541,9686,2002,8510,1999,1855,3031,0.0,0.0,14,5.0,80,9,70,609.0,0.26264140009880066,0.18822935223579407
7251850,6557203,4195248,11541,9987,2003,1545,1980,1554,9996,1.0,0.0,2,3.0,1,4,147,4578.0,0.4852844774723053,0.09929975867271423
7253109,4514437,6219318,11541,3407,1985,9238,2001,8134,2303,0.0,0.0,48,4.0,5,4,392,427.0,0.3410375118255615,0.013722117990255356
7252146,5545824,5665942,11541,7530,1996,7922,1997,4011,3619,0.0,0.0,23,2.0,12,52,35,2800.0,0.35959210991859436,0.22395651042461395
7255197,4539947,4225437,11548,3540,1985,1734,1980,8008,9814,0.5,0.0,25,10.0,2,1,182,1953.0,0.5415583848953247,0.2121947705745697
7255685,5211629,6032079,11548,6347,1993,8825,2000,5201,2723,1.0,1.0,44,2.0,5,99,448,133.0,0.5967725515365601,0.35759884119033813
7257645,6802000,4121022,11548,10505,2004,1020,1978,1043,10528,0.0,0.0,15,4.0,7,1,21,4004.0,0.22543206810951233,0.15173526108264923
7257079,6377640,5798969,11548,9609,2002,8272,1998,1939,3276,0.25,0.0,54,17.0,12,3,14,637.0,0.3835209012031555,0.2525709867477417
7257383,6498927,4399807,11548,9854,2002,2791,1983,1694,8757,0.5,0.0,26,6.0,7,4,91,6797.0,0.47205641865730286,0.18106640875339508
7257844,5796841,4852341,11548,8265,1998,4961,1989,3283,6587,0.5,0.0,58,2.0,12,5,0,5103.0,0.4125508666038513,0.1783287078142166
7257450,6494888,5484727,11548,9847,2002,7320,1996,1701,4228,1.0,0.0,22,5.0,26,7,63,42.0,0.41276827454566956,0.26875701546669006
7260623,6895586,4543946,11555,10729,2005,3561,1985,826,7994,0.5,0.0,7,4.0,22,4,14,4144.0,0.18081343173980713,0.14418217539787292
7258602,7118457,4398252,11555,11240,2006,2777,1983,315,8778,1.0,0.0,1,23.0,28,4,315,231.0,0.7616810202598572,0.06869924068450928
7259652,5368428,4286525,11555,6907,1994,2070,1981,4648,9485,0.0,0.0,39,7.0,4,2,49,812.0,0.15674516558647156,0.0724659189581871
7261812,6812030,7000271,11562,10533,2004,11009,2006,1029,553,1.0,0.0,7,1.0,20,13,112,553.0,0.46027353405952454,0.13570700585842133
7261472,6634796,4955479,11562,10155,2003,5367,1990,1407,6195,1.0,0.0,5,13.0,9,9,441,3080.0,0.5165342688560486,0.37087032198905945
7261744,5188639,4046745,11562,6263,1993,614,1977,5299,10948,1.0,0.0,14,4.0,6,2,28,4893.0,0.4062218964099884,0.1855451613664627
7261520,5613832,4350392,11562,7754,1997,2455,1982,3808,9107,1.0,0.0,20,3.0,4,1,28,1330.0,0.5059088468551636,0.11475887149572372
7262803,6670991,5085223,11562,10225,2003,5878,1992,1337,5684,0.3333333333333333,0.0,5,15.0,18,7,182,217.0,0.5304643511772156,0.20984087884426117
7261721,5989273,4281396,11562,8727,1999,2035,1981,2835,9527,1.0,0.0,4,1.0,8,3,14,9527.0,0.473088800907135,0.2531074285507202
7264002,5374287,6890526,11569,6928,1994,10722,2005,4641,847,1.0,0.5,44,1.0,18,9,91,847.0,0.20348437130451202,0.23377080261707306
7266414,6102887,5225192,11569,8993,2000,6396,1993,2576,5173,1.0,1.0,35,10.0,20,6,35,35.0,0.3148115873336792,0.11559829860925674
7265076,5945369,4305369,11569,8643,1999,2175,1981,2926,9394,1.0,0.0,19,7.0,2,1,224,2198.0,0.5201329588890076,0.22953791916370392
7265036,6090666,4180609,11569,8965,2000,1454,1979,2604,10115,1.0,0.0,57,31.0,4,5,14,1603.0,0.5713483691215515,0.21786971390247345
7265674,5483827,5895798,11569,7320,1996,8510,1999,4249,3059,0.0,0.0,83,1.0,36,3,28,3059.0,0.3984515964984894,0.13377654552459717
7266401,5011284,4419915,11569,5598,1991,2903,1983,5971,8666,0.5,0.0,21,6.0,2,1,1533,77.0,0.4486845135688782,0.21552181243896484
7264563,4659080,5499390,11569,4128,1987,7376,1996,7441,4193,1.0,0.0,5,18.0,3,6,2618,1918.0,0.8075543642044067,0.22838948667049408
7267253,4909700,4386374,11576,5192,1990,2707,1983,6384,8869,1.0,0.0,31,7.0,6,8,7,3255.0,0.4435688257217407,0.17832525074481964
7267587,4787867,6454990,11576,4716,1988,9763,2002,6860,1813,1.0,0.0,11,1.0,3,2,0,1813.0,0.3503512740135193,0.23408831655979156
7267357,6257613,5532343,11576,9322,2001,7488,1996,2254,4088,0.5,0.0,4,3.0,17,5,112,1673.0,0.4482654929161072,0.04306995868682861
7267675,5649923,4899851,11576,7873,1997,5157,1990,3703,6419,1.0,0.0,23,5.0,16,1,91,1904.0,0.18491406738758087,0.09743224829435349
7272640,6757706,5301515,11583,10407,2004,6676,1994,1176,4907,1.0,0.0,2,9.0,10,3,532,469.0,0.5720266699790955,0.19919486343860626
7270087,4633853,4988578,11583,4023,1987,5507,1991,7560,6076,0.0,0.0,11,19.0,2,4,392,1169.0,0.6139681935310364,0.17773525416851044
7270641,5983501,6695573,11583,8720,1999,10281,2004,2863,1302,0.0,0.0,8,1.0,3,14,0,1302.0,0.5627238154411316,0.3535807728767395
7270932,6492019,6712395,11583,9840,2002,10316,2004,1743,1267,0.0,0.0,3,1.0,23,11,112,1267.0,0.19978222250938416,0.14978325366973877
7271108,5654238,7047073,11583,7887,1997,11093,2006,3696,490,1.0,0.0,54,1.0,7,4,0,490.0,0.7368192672729492,0.13245393335819244
7270273,5984186,5026079,11583,8720,1999,5654,1991,2863,5929,1.0,0.0,29,9.0,29,1,7,280.0,0.5593465566635132,0.309131383895874
7274007,6415501,4338347,11590,9686,2002,2378,1982,1904,9212,0.5,0.0,10,7.0,34,1,140,3402.0,0.20578698813915253,0.018120799213647842
7274910,6061614,4976748,11590,8895,2000,5458,1990,2695,6132,0.0,0.0,13,4.0,30,3,224,1638.0,0.45414796471595764,0.14024239778518677
7274782,5870549,4217580,11590,8440,1999,1685,1980,3150,9905,1.0,0.0,145,2.0,22,6,7,77.0,0.4741799235343933,0.3055891990661621
7278029,5448045,6645466,11597,7187,1995,10176,2003,4410,1421,0.5,0.0,83,9.0,19,4,49,112.0,0.47365280985832214,0.014436491765081882
7275400,6898951,6347089,11597,10743,2005,9539,2002,854,2058,1.0,0.0,1,7.0,97,4,854,392.0,1.0000001192092896,0.08303830027580261
7277183,5323012,4293663,11597,6746,1994,2105,1981,4851,9492,0.0,0.0,9,12.0,11,2,49,1694.0,0.27187153697013855,0.07145079225301743
7275400,6136766,6115003,11597,9063,2000,9014,2000,2534,2583,0.0,0.0,34,11.0,33,7,77,77.0,0.4274045526981354,0.3076842427253723
7276069,5092867,7082177,11597,5906,1992,11163,2006,5691,434,1.0,0.0,37,1.0,3,6,168,434.0,0.6772210001945496,0.1268165558576584
7276017,5683331,4424487,11597,7978,1997,2924,1984,3619,8673,1.0,0.0,6,18.0,25,2,77,259.0,0.4433148205280304,-0.024704571813344955
7277099,5396567,4753693,11597,7005,1995,4562,1988,4592,7035,0.0,0.0,69,6.0,4,2,49,77.0,0.3201056122779846,0.20104631781578064
7277064,5451972,4958034,11597,7201,1995,5374,1990,4396,6223,1.0,0.0,12,3.0,3,1,147,2331.0,0.4680280387401581,0.06137274578213692
7277924,6701314,4127033,11597,10288,2004,1062,1978,1309,10535,1.0,0.0,11,3.0,6,1,84,3381.0,0.580115556716919,0.19399596750736237
7278983,5999849,5635947,11604,8741,1999,7824,1997,2863,3780,0.5,0.0,15,17.0,11,4,91,231.0,0.11255373805761337,0.15706177055835724
7278911,6116998,4381041,11604,9021,2000,2672,1983,2583,8932,0.3333333333333333,0.0,27,6.0,5,2,35,427.0,0.48269715905189514,0.1431996077299118
7278496,6571873,4488698,11604,10015,2003,3274,1984,1589,8330,1.0,0.0,4,4.0,12,5,217,819.0,0.5522566437721252,0.2548637390136719
7279521,5554670,4035628,11604,7558,1996,558,1977,4046,11046,1.0,0.0,63,19.0,17,3,63,2947.0,0.3273504972457886,0.12745258212089539
7278562,4671445,4516331,11604,4177,1987,3421,1985,7427,8183,1.0,0.0,93,8.0,7,1,49,2394.0,0.52488774061203,0.2754483222961426
7279453,4414130,6993214,11604,2868,1983,10988,2006,8736,616,0.3333333333333333,0.0,46,1.0,3,3,693,616.0,0.2814883589744568,0.1934313029050827
7280455,7126897,6195102,11604,11254,2006,9189,2001,350,2415,1.0,0.0,2,1.0,11,13,126,2415.0,0.5495253801345825,0.23640982806682587
7282525,6288266,4288381,11611,9385,2001,2077,1981,2226,9534,0.0,0.0,3,1.0,12,1,357,9534.0,0.29756009578704834,0.2939889132976532
7282447,5126006,6249921,11611,6025,1992,9308,2001,5586,2303,0.0,0.0,49,2.0,2,15,0,1687.0,0.6332024335861206,0.4150899052619934
7281607,4433752,5419614,11611,2980,1984,7089,1995,8631,4522,0.3333333333333333,0.0,7,9.0,1,13,1554,168.0,0.3002776801586151,0.42160454392433167
7282400,5883012,4677561,11611,8475,1999,4198,1987,3136,7413,1.0,0.0,21,16.0,5,4,28,2044.0,0.46543294191360474,-0.031081844121217728
7286764,5898515,5508571,11618,8517,1999,7411,1996,3101,4207,0.3333333333333333,0.0,56,16.0,6,3,42,70.0,0.2865337133407593,0.20017102360725403
7284769,5461566,6788844,11618,7236,1995,10477,2004,4382,1141,0.5,0.0,7,4.0,21,10,770,112.0,0.6219039559364319,-0.039964187890291214
7285860,6751519,5056578,11618,10393,2004,5766,1991,1225,5852,0.0,0.0,7,5.0,4,6,413,2618.0,0.2903001606464386,0.2364744246006012
7285166,6171386,5520316,11618,9140,2001,7453,1996,2478,4165,0.5,0.0,19,21.0,10,7,0,168.0,0.6582818031311035,0.03805330768227577
7285444,6692991,4887013,11618,10274,2004,5094,1989,1344,6524,1.0,0.0,3,5.0,6,6,266,455.0,0.5888899564743042,0.24167963862419128
7286750,5999698,7132429,11618,8741,1999,11268,2006,2877,350,1.0,0.0,80,1.0,3,54,0,350.0,0.22562846541404724,-0.039406996220350266
7288463,5985770,6142667,11625,8720,1999,9077,2000,2905,2548,1.0,0.0,17,6.0,10,22,42,301.0,0.3650286793708801,0.05875498428940773
7290186,6415344,5707423,11625,9679,2002,8048,1998,1946,3577,0.0,0.0,18,7.0,27,19,77,1484.0,0.3957073390483856,0.13086844980716705
7292183,6268824,6054574,11632,9343,2001,8881,2000,2289,2751,1.0,0.0,15,7.0,3,2,154,182.0,0.5211873650550842,0.1536799818277359
7292151,5711304,4150580,11632,8062,1998,1209,1979,3570,10423,0.0,0.0,16,23.0,8,1,252,252.0,0.37067845463752747,0.19116365909576416
7293277,5691778,4038673,11632,7999,1997,572,1977,3633,11060,0.5,0.0,14,16.0,6,1,147,3374.0,0.41572627425193787,0.1009579449892044
7291171,5676702,6247412,11632,7957,1997,9301,2001,3675,2331,1.0,0.0,83,2.0,5,2,42,483.0,0.43949371576309204,0.12840571999549866
7292815,6127654,4422173,11632,9042,2000,2910,1983,2590,8722,0.5,0.0,3,2.0,6,1,385,6230.0,0.32065507769584656,0.35785749554634094
7291793,6344618,5892076,11632,9532,2002,8496,1999,2100,3136,1.0,0.0,6,4.0,7,12,175,2170.0,0.45676189661026,0.24109356105327606
7291063,6458014,4656412,11632,9770,2002,4114,1987,1862,7518,1.0,0.0,23,7.0,18,1,49,707.0,0.634290874004364,0.16953349113464355
7295574,6188671,4364114,11639,9175,2001,2539,1982,2464,9100,1.0,0.0,33,6.0,3,5,21,2352.0,0.3513469099998474,0.22482122480869293
7295023,6729019,4180609,11639,10351,2004,1454,1979,1288,10185,0.0,0.0,25,31.0,37,5,21,1673.0,0.6613649725914001,0.07356704026460648
7295387,5117306,4697196,11639,5990,1992,4289,1987,5649,7350,0.5,0.0,35,15.0,8,6,14,1834.0,0.5615267753601074,0.13114777207374573
7296121,6330643,6268598,11639,9476,2001,9343,2001,2163,2296,1.0,0.0,8,3.0,6,9,35,1022.0,0.5604621767997742,0.401908814907074
7295329,6922254,6971315,11639,10799,2005,10932,2005,840,707,0.5,0.0,4,2.0,6,16,84,280.0,0.38280898332595825,0.10160008072853088
7296692,5858252,4521244,11646,8412,1999,3442,1985,3234,8204,1.0,0.0,3,4.0,17,2,658,2044.0,0.5014705061912537,0.24501173198223114
7296924,5409312,4338762,11646,7054,1995,2385,1982,4592,9261,1.0,0.0,6,4.0,2,8,889,546.0,0.3642147481441498,0.22949202358722687
7296897,5489984,6631599,11646,7341,1996,10148,2003,4305,1498,0.0,0.0,17,2.0,18,12,126,350.0,0.37860730290412903,0.286281555891037
7297958,4792900,5525112,11646,4737,1988,7467,1996,6909,4179,0.0,0.0,42,11.0,8,18,7,791.0,0.5149640440940857,0.12658214569091797
7297716,5196428,4973152,11646,6291,1993,5444,1990,5355,6202,0.3333333333333333,0.0,7,4.0,7,5,1694,3458.0,0.2414332926273346,0.12443005293607712
7298271,4796074,5338059,11646,4751,1989,6802,1994,6895,4844,0.0,0.0,71,30.0,5,5,63,707.0,0.16318073868751526,0.11428181827068329
7300580,5556654,6932318,11653,7565,1996,10827,2005,4088,826,0.0,0.0,10,1.0,9,9,434,826.0,0.637259304523468,0.37557321786880493
7302628,6347124,5418732,11653,9539,2002,7082,1995,2114,4571,0.0,0.0,7,10.0,5,4,35,637.0,0.42899277806282043,0.19639068841934204
7302157,6335831,4771531,11653,9497,2002,4646,1988,2156,7007,1.0,0.0,19,16.0,13,3,7,1029.0,0.39054542779922485,0.2659986615180969
7299881,5507343,6486530,11653,7411,1996,9826,2002,4242,1827,1.0,0.0,76,8.0,6,40,21,105.0,0.3705984055995941,0.2367655485868454
7304787,6683333,5197247,11660,10253,2004,6298,1993,1407,5362,0.0,0.0,38,8.0,148,4,56,308.0,0.39298301935195923,0.17270459234714508
7305348,5410474,4366291,11660,7054,1995,2553,1982,4606,9107,0.5,0.0,21,7.0,1,2,14,7357.0,0.3115883469581604,0.19926203787326813
7305549,6408390,7035926,11660,9665,2002,11072,2006,1995,588,1.0,1.0,15,2.0,26,32,7,294.0,0.16084586083889008,0.2516646087169647
7306747,5998521,5368644,11667,8741,1999,6907,1994,2926,4760,0.0,0.0,7,2.0,13,9,392,1155.0,0.38344302773475647,0.10597346723079681
7308087,6092053,6837234,11667,8965,2000,10596,2005,2702,1071,0.0,0.0,44,1.0,5,30,7,1071.0,0.5364112257957458,0.22129617631435394
7306619,6846317,4021346,11667,10617,2005,488,1977,1050,11179,1.0,0.0,6,7.0,6,1,126,3493.0,0.4219697117805481,0.26332777738571167
7308110,5721788,4948471,11667,8090,1998,5339,1990,3577,6328,0.0,0.0,279,3.0,9,4,7,5257.0,0.5204097032546997,-0.04413651302456856
7306624,5769816,5996593,11667,8209,1998,8741,1999,3458,2926,1.0,0.0,209,7.0,19,6,0,1386.0,0.5092147588729858,0.19105671346187592
7308498,6360254,4446376,11667,9574,2002,3043,1984,2093,8624,1.0,0.0,59,6.0,5,2,7,378.0,0.4645801782608032,0.20594613254070282
7308242,4220977,5460353,11667,1706,1980,7236,1995,9961,4431,1.0,0.0,43,18.0,2,6,35,539.0,0.31010645627975464,0.23747371137142181
7306158,5845267,6675737,11667,8370,1998,10239,2004,3297,1428,0.0,0.0,106,1.0,4,2,7,1428.0,0.2841695547103882,0.22465988993644714
7307816,5680275,5763110,11667,7964,1997,8195,1998,3703,3472,1.0,0.0,13,5.0,6,4,441,140.0,0.770439863204956,0.3306620121002197
7307007,5648277,4846072,11667,7866,1997,4940,1989,3801,6727,1.0,0.0,148,3.0,5,1,7,2618.0,0.4430491626262665,0.12644091248512268
7311442,4655737,4913646,11681,4114,1987,5206,1990,7567,6475,0.0,0.0,15,2.0,1,3,315,3437.0,0.24449403584003448,0.403719425201416
7313715,5991850,4707095,11681,8727,1999,4338,1987,2954,7343,1.0,0.0,5,2.0,11,1,350,3066.0,0.5934553742408752,0.19580601155757904
7311411,6761468,4681454,11681,10421,2004,4219,1987,1260,7462,1.0,0.0,2,8.0,2,4,322,112.0,0.5619391202926636,0.4422321021556854
7312162,4778561,4308292,11681,4674,1988,2189,1981,7007,9492,0.0,0.0,80,5.0,39,3,0,6433.0,0.3351183831691742,0.3010364770889282
7313430,4803976,4720015,11681,4793,1989,4401,1988,6888,7280,1.0,0.0,59,6.0,6,1,49,1043.0,0.5077563524246216,0.18683169782161713
7312632,5724276,5930235,11681,8097,1998,8608,1999,3584,3073,0.0,0.0,39,15.0,4,4,147,98.0,0.42480283975601196,0.3476376533508301
7311831,5102547,5102627,11681,5941,1992,5941,1992,5740,5740,0.0,0.0,10,6.0,1,5,35,2226.0,0.4594692289829254,0.23143687844276428
7311470,4260296,5693408,11681,1923,1981,8006,1997,9758,3675,0.5,0.0,25,5.0,2,9,301,2128.0,0.393377423286438,0.16720984876155853
7311205,5448844,3989873,11681,7194,1995,306,1976,4487,11375,0.5,0.0,19,10.0,1,3,112,392.0,0.26954495906829834,0.25800901651382446
7312762,5471224,4226947,11681,7271,1995,1741,1980,4410,9940,1.0,0.0,21,3.0,3,2,147,2954.0,0.4385553300380707,0.04261723533272743
7313915,5887484,4369577,11688,8489,1999,2581,1983,3199,9107,0.0,0.0,30,8.0,6,3,133,3213.0,0.20302660763263702,0.3477010726928711
7314285,5337190,4082595,11688,6795,1994,824,1978,4893,10864,1.0,0.0,21,17.0,3,1,28,427.0,0.5938833951950073,0.1935337334871292
7313936,6601415,5872117,11688,10078,2003,8447,1999,1610,3241,1.0,0.0,8,5.0,10,5,196,203.0,0.580053985118866,0.06788206845521927
7314402,5853317,5243199,11688,8398,1998,6459,1993,3290,5229,1.0,0.0,39,18.0,4,5,301,1862.0,0.7227873802185059,0.27458664774894714
7317697,6751298,5808896,11695,10393,2004,8293,1998,1302,3402,1.0,0.0,3,6.0,10,3,567,343.0,0.2956617772579193,0.23434992134571075
7317841,4692806,4942543,11695,4268,1987,5311,1990,7427,6384,0.0,0.5,70,2.0,5,9,343,2646.0,0.4402591288089752,0.14298518002033234
7317633,6570211,4409362,11695,10008,2003,2840,1983,1687,8855,0.5,0.0,9,2.0,9,3,231,5005.0,0.2996687889099121,0.12694087624549866
7317233,6417078,4867799,11695,9686,2002,5010,1989,2009,6685,0.5,0.0,28,13.0,17,4,0,588.0,0.32671478390693665,0.320239782333374
7318141,5717903,5799619,11695,8076,1998,8279,1998,3619,3416,1.0,0.0,65,3.0,4,7,14,2583.0,0.44475001096725464,0.18038663268089294
7318617,6375055,5243710,11702,9609,2002,6466,1993,2093,5236,1.0,0.0,20,7.0,14,2,280,1449.0,0.6162405014038086,0.2798951268196106
7320069,6415031,4217863,11702,9679,2002,1692,1980,2023,10010,0.5,0.0,34,10.0,3,7,42,5670.0,0.6121664047241211,0.07667608559131622
7319319,5815091,4623987,11702,8307,1998,3974,1986,3395,7728,0.0,0.0,41,5.0,16,5,35,4837.0,0.5172461271286011,0.3647814095020294
7321096,7179996,5325371,11709,11373,2007,6753,1994,336,4956,0.0,0.0,1,5.0,4,7,336,105.0,0.3342679440975189,0.28670594096183777
7322994,6110187,5680793,11716,9007,2000,7971,1997,2709,3745,1.0,0.0,61,1.0,28,1,56,3745.0,0.4674610495567322,0.2843106687068939
7324528,5953405,4905482,11716,8657,1999,5178,1990,3059,6538,1.0,0.0,23,4.0,5,3,63,420.0,0.378256618976593,0.15263985097408295
7323140,5883211,4093334,11716,8475,1999,887,1978,3241,10829,0.0,0.0,14,6.0,6,1,133,4158.0,0.17725439369678497,0.28700459003448486
7326865,4143254,6441928,11723,1160,1979,9735,2002,10563,1988,1.0,0.0,4,2.0,1,5,2079,434.0,0.4824140667915344,0.15719249844551086
7327783,4945505,6849803,11723,5325,1990,10624,2005,6398,1099,0.0,0.0,15,8.0,4,8,679,273.0,0.5837909579277039,0.1564766764640808
7328233,5768506,4429198,11723,8202,1998,2952,1984,3521,8771,1.0,0.0,48,5.0,5,2,231,4368.0,0.4387146830558777,0.19515284895896912
7325813,6851682,4839011,11723,10631,2005,4912,1989,1092,6811,0.3333333333333333,0.0,1,17.0,15,5,1092,980.0,0.7227323651313782,0.14413243532180786
7330096,6370884,4490981,11730,9602,2002,3288,1985,2128,8442,0.0,0.0,8,16.0,10,2,49,210.0,0.14988546073436737,0.22616180777549744
7330193,6606166,4194703,11730,10085,2003,1545,1980,1645,10185,0.25,0.0,1,24.0,6,1,1645,119.0,0.6481114029884338,0.06747434288263321
7330818,5884271,4332663,11730,8475,1999,2343,1982,3255,9387,1.0,0.0,110,5.0,39,4,7,217.0,0.21061386168003082,0.09343186765909195
7328851,6970259,6752244,11730,10925,2005,10400,2004,805,1330,1.0,0.0,3,1.0,12,13,105,1330.0,0.31065258383750916,0.2506689131259918
7329279,4501030,4055133,11730,3344,1985,663,1977,8386,11067,1.0,0.0,58,11.0,2,1,28,525.0,0.4821113646030426,0.28300362825393677
7332540,5104921,4021527,11737,5948,1992,488,1977,5789,11249,1.0,0.0,22,13.0,17,1,175,1638.0,0.48399588465690613,0.2113552689552307
7334124,5819045,5302599,11737,8314,1998,6676,1994,3423,5061,0.0,0.0,15,6.0,10,3,448,112.0,0.19751296937465668,0.010464686900377274
7333130,4857998,4750490,11737,4975,1989,4548,1988,6762,7189,1.0,0.0,35,14.0,5,2,112,1078.0,0.5518715977668762,0.16621844470500946
7331454,7150345,4100094,11737,11310,2006,922,1978,427,10815,0.3333333333333333,0.0,1,16.0,4,1,427,2135.0,0.4982934594154358,0.16925650835037231
7334773,6783114,4989276,11744,10470,2004,5514,1991,1274,6230,1.0,0.0,1,1.0,36,3,1274,6230.0,0.613808274269104,0.3891424238681793
7334581,5059208,6154151,11744,5773,1991,9098,2000,5971,2646,1.0,0.0,17,11.0,2,15,623,35.0,0.4897523522377014,0.16664014756679535
7334389,5269137,3978923,11744,6557,1993,250,1976,5187,11494,1.0,0.0,8,8.0,4,1,1379,6111.0,0.4398127496242523,0.3220110535621643
7334386,5481852,4341032,11744,7313,1996,2399,1982,4431,9345,1.0,0.0,28,2.0,4,2,7,5425.0,0.27283620834350586,0.15062987804412842
7335029,6717797,4161781,11744,10323,2004,1293,1979,1421,10451,0.0,0.0,2,24.0,7,2,952,399.0,0.44053539633750916,0.3303636312484741
7338440,4947896,4184056,11751,5339,1990,1475,1980,6412,10276,0.0,0.0,29,6.0,7,2,490,2030.0,0.7867517471313477,0.2556259334087372
7340400,5563579,4895620,11751,7586,1996,5136,1990,4165,6615,0.0,0.0,33,5.0,10,3,35,231.0,0.7135826349258423,0.07524057477712631
7338550,5240312,4226554,11751,6452,1993,1741,1980,5299,10010,0.0,0.0,2,13.0,4,1,2786,1470.0,0.25099295377731323,0.37771013379096985
7338496,5507832,5609631,11751,7411,1996,7740,1997,4340,4011,1.0,1.0,7,5.0,14,4,203,273.0,0.3598272502422333,0.22453951835632324
7339502,5740201,4832659,11751,8139,1998,4891,1989,3612,6860,0.0,0.0,18,2.0,7,3,175,3066.0,0.5357103943824768,0.2826332151889801
7338044,6250632,7110143,11751,9308,2001,11219,2006,2443,532,1.0,0.0,34,1.0,20,9,35,532.0,0.7334209084510803,0.24556393921375275
7341598,4309994,4266804,11758,2203,1982,1958,1981,9555,9800,1.0,0.0,56,5.0,3,1,0,224.0,0.3947639763355255,0.20509672164916992
7343291,5467134,6716666,11758,7257,1995,10323,2004,4501,1435,0.0,0.0,70,2.0,6,6,7,798.0,0.4933532178401947,0.07803148031234741
7346798,6359815,4371672,11765,9574,2002,2588,1983,2191,9177,0.0,0.0,18,6.0,2,1,112,4592.0,0.47258323431015015,0.25355347990989685
re40156,6063079,5749212,11765,8902,2000,8167,1998,2863,3598,1.0,0.0,49,7.0,125,13,28,2170.0,0.5062751173973083,0.11993225663900375
7345670,6217444,6945383,11765,9238,2001,10855,2005,2527,910,0.0,0.0,16,2.0,9,27,119,287.0,0.33795517683029175,0.2001650184392929
7346722,5754807,6667000,11765,8174,1998,10218,2003,3591,1547,1.0,0.0,15,1.0,26,5,658,1547.0,0.5525188446044922,0.14327511191368103
7343920,5972024,6644049,11765,8699,1999,10176,2003,3066,1589,0.0,0.0,31,7.0,8,6,84,133.0,0.454683393239975,0.07872114330530167
7345822,5699194,4169129,11765,8020,1997,1363,1979,3745,10402,1.0,0.0,52,3.0,13,1,84,7973.0,0.6923331022262573,0.2052251398563385
7346744,6148378,5040353,11765,9084,2000,5710,1991,2681,6055,1.0,0.0,16,9.0,3,9,21,833.0,0.5068669319152832,0.08657531440258026
7344956,6075280,6452502,11765,8930,2000,9756,2002,2835,2009,1.0,0.0,24,10.0,4,8,644,49.0,0.46919554471969604,0.29471418261528015
7346374,5751251,6515067,11765,8167,1998,9896,2003,3598,1869,0.0,0.0,3,2.0,17,42,1519,259.0,0.23575688898563385,0.06799238175153732
7349532,5099507,4674107,11772,5927,1992,4184,1987,5845,7588,1.0,0.0,40,22.0,3,6,98,42.0,0.4949406087398529,0.2803744673728943
7353313,5867480,5675368,11779,8433,1999,7950,1997,3346,3829,0.3333333333333333,0.0,29,2.0,5,4,21,1792.0,0.26838311553001404,0.12050823122262955
7350417,7194901,5059838,11779,11408,2007,5773,1991,371,6006,1.0,0.0,1,21.0,25,9,371,2100.0,0.683665931224823,0.26507505774497986
7351421,6103255,5711191,11779,8993,2000,8062,1998,2786,3717,0.3333333333333333,0.0,21,2.0,14,7,28,1554.0,0.3193182051181793,0.052503205835819244
7350311,4618378,4655849,11779,3946,1986,4114,1987,7833,7665,0.5,0.0,2,15.0,2,5,238,98.0,0.550168514251709,0.2960580587387085
7352220,4547719,5649378,11779,3575,1985,7873,1997,8204,3906,0.0,0.0,14,11.0,6,4,525,126.0,0.4089817702770233,0.09118318557739258
7352373,4675532,4015223,11779,4191,1987,453,1977,7588,11326,0.0,0.0,35,19.0,3,1,581,147.0,0.24372205138206482,0.27975964546203613
7352492,7064860,6886177,11779,11128,2006,10708,2005,651,1071,0.5,0.0,3,4.0,7,5,91,322.0,0.42584705352783203,0.24638204276561737
7352374,6466618,5196791,11779,9784,2002,6291,1993,1995,5488,0.0,0.0,31,16.0,28,9,14,1652.0,0.4642114043235779,0.12985749542713165
7354118,6450587,5142556,11786,9756,2002,6081,1992,2030,5705,1.0,0.0,9,9.0,31,3,133,154.0,0.5031511783599854,0.19127510488033295
7354035,5020784,5029216,11786,5633,1991,5661,1991,6153,6125,0.0,0.0,33,26.0,3,3,21,217.0,0.591590940952301,0.18233175575733185
7356343,6928101,4266295,11786,10813,2005,1951,1981,973,9835,0.5,1.0,5,5.0,7,2,182,1281.0,0.4012925922870636,0.25563332438468933
7358615,6673697,4463430,11793,10232,2004,3134,1984,1561,8659,1.0,0.0,10,22.0,7,10,77,3276.0,0.5427895784378052,0.3167014420032501
7356880,6128122,4231103,11793,9042,2000,1762,1980,2751,10031,0.0,0.0,40,8.0,5,1,154,770.0,0.3698502779006958,0.20695336163043976
7360007,6882082,6532849,11793,10701,2005,9938,2003,1092,1855,0.5,0.0,4,2.0,10,3,21,546.0,0.5577744245529175,0.23908531665802002
7358007,5156930,7060414,11793,6137,1992,11121,2006,5656,672,0.3333333333333333,0.0,5,3.0,2,15,1106,133.0,0.6301835179328918,0.3385893404483795
7361181,6287322,4324787,11800,9385,2001,2294,1982,2415,9506,1.0,0.5,7,4.0,78,2,637,2611.0,0.5215542316436768,0.1459684818983078
7363650,6304881,4509498,11800,9420,2001,3386,1985,2380,8414,0.0,0.0,42,2.0,36,4,7,6209.0,0.4082431495189667,0.2670694887638092
7365186,5451514,4154175,11807,7201,1995,1230,1979,4606,10577,0.5,0.0,47,2.0,3,1,147,5656.0,0.5332704782485962,0.10441182553768158
7365752,4481594,4566199,11807,3232,1984,3680,1986,8575,8127,0.6666666666666666,0.0,58,12.0,2,1,133,1547.0,0.5321848392486572,0.18959344923496246
7365100,6187823,5544915,11807,9175,2001,7530,1996,2632,4277,0.3333333333333333,0.0,47,10.0,7,9,7,189.0,0.5273081064224243,0.1011175587773323
7366606,5892463,5196880,11807,8496,1999,6291,1993,3311,5516,0.0,0.0,24,13.0,7,4,105,21.0,0.5913239121437073,0.21533545851707458
7364042,5397413,5089716,11807,7012,1995,5892,1992,4795,5915,0.0,0.0,36,3.0,19,9,98,3766.0,0.3080955743789673,0.019892871379852295
7365680,5014066,5705950,11807,5605,1991,8041,1998,6202,3766,1.0,0.0,60,9.0,16,10,231,189.0,0.38337814807891846,0.1320168524980545
re40279,5058605,4492277,11807,5773,1991,3295,1985,6034,8512,1.0,0.0,44,7.0,8,2,42,7.0,0.5331449508666992,0.08873678743839264
7364918,3999946,6221496,11807,362,1976,9245,2001,11445,2562,0.3333333333333333,0.0,90,3.0,1,12,175,637.0,0.36394351720809937,0.25195831060409546
7365057,6927291,4052251,11807,10813,2005,642,1977,994,11165,0.0,0.0,1,7.0,17,1,994,2051.0,0.5364550948143005,-0.049946680665016174
7366606,6664922,4635915,11807,10211,2003,4030,1987,1596,7777,0.5,0.0,14,5.0,13,1,14,637.0,0.3552837669849396,0.021932872012257576
7364176,4865350,7011038,11807,5003,1989,11030,2006,6804,777,1.0,0.0,4,1.0,6,32,1036,777.0,0.6316853761672974,0.25155842304229736
7369550,6052751,4228551,11814,8874,2000,1755,1980,2940,10059,0.5,0.0,20,2.0,10,2,119,4305.0,0.45671987533569336,0.13745702803134918
7367684,6233971,5015335,11814,9273,2001,5612,1991,2541,6202,0.0,0.0,9,2.0,15,1,112,2555.0,0.5235440135002136,0.12838518619537354
7371174,6217022,6768892,11821,9238,2001,10435,2004,2583,1386,0.5,0.0,9,7.0,14,3,154,217.0,0.35781508684158325,0.40851065516471863
7372036,4744768,5374899,11821,4520,1988,6928,1994,7301,4893,0.0,0.0,20,2.0,14,1,1456,7.0,0.3773886561393738,0.25163722038269043
7371338,6645452,6666885,11821,10176,2003,10218,2003,1645,1603,0.0,0.0,4,7.0,30,7,70,245.0,0.42597007751464844,-0.1544160395860672
7373490,5822603,4489634,11821,8321,1998,3281,1984,3500,8540,1.0,0.0,23,8.0,5,1,14,49.0,0.4243197441101074,0.22440330684185028
7373644,5961596,6975823,11821,8678,1999,10939,2005,3143,882,1.0,0.0,27,3.0,4,8,14,336.0,0.4509375989437103,0.2032572478055954
7371162,6585584,4468683,11821,10043,2003,3162,1984,1778,8659,0.5,0.0,2,6.0,6,2,1099,4746.0,0.7347778081893921,0.29144731163978577
7376432,5220366,4712522,11828,6375,1993,4366,1987,5453,7462,0.0,0.0,49,3.0,4,9,7,6790.0,0.4949152171611786,0.16160893440246582
7375864,6564028,5345264,11828,9994,2003,6823,1994,1834,5005,0.0,1.0,2,19.0,5,6,392,105.0,0.5013106465339661,0.3394208252429962
7376410,4612518,4456418,11828,3911,1986,3099,1984,7917,8729,1.0,0.0,61,8.0,6,2,119,3136.0,0.4248078763484955,0.19747066497802734
7373743,6302555,4171646,11828,9420,2001,1391,1979,2408,10437,0.0,0.0,10,11.0,3,1,112,4480.0,0.7086564302444458,0.14342240989208221
7375539,5456001,5592357,11828,7222,1995,7677,1997,4606,4151,0.0,0.0,34,10.0,5,19,35,1267.0,0.5747894048690796,0.34785038232803345
7379555,5259032,7229882,11835,6515,1993,11485,2007,5320,350,1.0,0.0,49,1.0,20,9,378,350.0,0.43599480390548706,0.27749988436698914
7377450,5344069,5558213,11835,6823,1994,7572,1996,5012,4263,0.0,0.0,23,4.0,8,3,308,1134.0,0.4709676504135132,0.1809210479259491
7380008,5678041,5579779,11835,7957,1997,7642,1996,3878,4193,1.0,0.0,287,5.0,2,26,21,406.0,0.5432438850402832,0.17009682953357697
7378675,6211526,4191762,11835,9224,2001,1524,1980,2611,10311,0.0,0.0,10,5.0,11,1,287,3430.0,0.36055415868759155,0.1675950437784195
7377076,7032417,5008607,11835,11072,2006,5584,1991,763,6251,1.0,0.0,1,3.0,5,4,763,84.0,0.5811047554016113,0.29747992753982544
7379883,6121819,4538464,11835,9028,2000,3533,1985,2807,8302,1.0,0.0,53,6.0,1,3,0,2800.0,0.36921167373657227,0.04269690439105034
7383333,5088045,5201901,11842,5885,1992,6312,1993,5957,5530,1.0,0.0,94,26.0,8,6,0,210.0,0.2946157157421112,0.14451730251312256
7381394,6800388,6191759,11842,10505,2004,9182,2001,1337,2660,0.0,0.0,2,4.0,4,40,413,63.0,0.6214403510093689,-0.031621940433979034
7382660,6522580,7099499,11842,9910,2003,11198,2006,1932,644,1.0,0.0,121,2.0,15,5,7,14.0,0.3724924623966217,0.06059513986110687
7382110,7136762,5789816,11842,11275,2006,8251,1998,567,3591,0.0,0.0,3,10.0,6,4,63,532.0,0.5132603049278259,0.22800736129283905
7383091,5824029,4628215,11842,8328,1998,3995,1986,3514,7847,1.0,0.0,38,13.0,18,7,56,133.0,0.5199142694473267,0.2880834639072418
7382144,4923405,4228685,11842,5241,1990,1755,1980,6601,10087,0.0,1.0,10,7.0,2,3,1113,903.0,0.28335633873939514,0.1520339846611023
7380490,6408972,5934992,11842,9672,2002,8622,1999,2170,3220,0.0,0.0,9,7.0,13,4,7,1729.0,0.39475777745246887,0.13539400696754456
7382647,6778426,6738410,11842,10456,2004,10365,2004,1386,1477,1.0,0.0,3,4.0,3,16,287,63.0,0.4965553283691406,-0.0023003872483968735
7381249,6992051,4811378,11842,10988,2006,4814,1989,854,7028,0.5,0.0,1,24.0,7,4,854,315.0,0.4245099723339081,0.25358736515045166
7384924,6784161,4909253,11849,10470,2004,5192,1990,1379,6657,1.0,0.5,7,6.0,4,1,42,784.0,0.6965653300285339,0.06279262155294418
7386621,5790669,4594447,11849,8251,1998,3813,1986,3598,8036,0.5,0.0,9,5.0,4,1,105,5922.0,0.4265407919883728,-0.0220220685005188
7386339,6470207,6400528,11849,9791,2002,9651,2002,2058,2198,1.0,0.0,44,1.0,133,5,28,2198.0,0.2778470814228058,0.26982831954956055
7386473,5155857,4729467,11849,6130,1992,4450,1988,5719,7399,1.0,0.0,14,8.0,9,4,399,2051.0,0.30603596568107605,0.18927450478076935
7385477,5055968,4361817,11849,5759,1991,2525,1982,6090,9324,0.0,1.0,51,3.0,3,2,77,5495.0,0.2916254699230194,0.39983808994293213
7386931,6091169,6627600,11856,8965,2000,10134,2003,2891,1722,1.0,0.0,29,1.0,5,25,49,1722.0,0.4866864085197449,0.08242617547512054
7389100,4320536,5870155,11856,2266,1982,8440,1999,9590,3416,1.0,1.0,75,20.0,4,16,7,7.0,0.32809147238731384,0.19201210141181946
7387277,6237873,4769359,11856,9280,2001,4632,1988,2576,7224,1.0,0.0,11,4.0,3,1,336,161.0,0.6428465247154236,0.16334445774555206
7394459,6529183,4384671,11870,9924,2003,2700,1983,1946,9170,0.0,0.0,8,6.0,9,3,35,1827.0,0.47622206807136536,0.19985729455947876
7393557,4166876,5651324,11870,1342,1979,7880,1997,10528,3990,0.0,0.0,49,4.0,3,3,91,427.0,0.5204718112945557,0.08610842376947403
7394690,5313421,5866518,11870,6711,1994,8433,1999,5159,3437,0.0,0.0,166,6.0,18,6,7,224.0,0.41922953724861145,0.05804130807518959
7395383,6105099,4038989,11870,8993,2000,579,1977,2877,11291,1.0,0.0,6,10.0,20,1,49,378.0,0.5184652209281921,0.21635784208774567
7395249,6224542,4961216,11870,9252,2001,5388,1990,2618,6482,0.0,0.0,16,23.0,9,9,168,21.0,0.4602554440498352,0.4001671075820923
7393535,5968525,4316339,11870,8692,1999,2245,1982,3178,9625,0.5,0.0,4,10.0,7,1,126,875.0,0.5052388906478882,0.12720921635627747
7393813,6508306,6448958,11870,9882,2003,9749,2002,1988,2121,0.0,0.0,35,8.0,17,7,63,77.0,0.47633904218673706,0.09844907373189926
7393029,5492207,7172011,11870,7355,1996,11359,2007,4515,511,0.0,0.0,10,1.0,9,4,357,511.0,0.639954686164856,0.35824158787727356
7396512,4784834,4101820,11877,4702,1988,929,1978,7175,10948,1.0,0.0,4,8.0,2,2,1897,1498.0,0.4105980396270752,0.09288391470909119
7395708,6298879,4095120,11877,9413,2001,894,1978,2464,10983,0.0,0.0,2,10.0,6,1,84,504.0,0.34990546107292175,0.1055043563246727
7396210,6048173,6270549,11877,8867,2000,9350,2001,3010,2527,1.0,0.0,6,12.0,2,52,602,28.0,0.4273233115673065,0.12494336813688278
7396026,6123343,6134632,11877,9035,2000,9056,2000,2842,2821,1.0,0.0,6,5.0,14,8,210,1190.0,0.5168445706367493,0.348636269569397
7398115,4651746,6382420,11877,4100,1987,9623,2002,7777,2254,1.0,0.0,18,6.0,10,8,518,28.0,0.37040600180625916,0.07898547500371933
7395860,5585333,4198680,11877,7656,1996,1566,1980,4221,10311,0.0,0.0,27,9.0,12,5,21,4690.0,0.45231160521507263,0.08497459441423416
7398770,4683725,4266804,11884,4233,1987,1958,1981,7651,9926,0.0,0.0,19,5.0,3,1,105,350.0,0.6168004274368286,0.17115820944309235
7400274,5530845,4864567,11884,7481,1996,4996,1989,4403,6888,0.0,0.0,57,28.0,28,7,14,819.0,0.27974656224250793,0.261158287525177
7400128,6664847,4987793,11884,10211,2003,5507,1991,1673,6377,1.0,0.0,5,8.0,21,8,28,2079.0,0.5560621023178101,0.3322297930717468
7405444,5877070,4441304,11898,8461,1999,3022,1984,3437,8876,1.0,0.0,198,3.0,6,1,28,518.0,0.32583510875701904,0.3455869257450104
7406817,4890446,5984777,11905,5115,1990,8720,1999,6790,3185,1.0,1.0,17,8.0,2,2,602,84.0,0.8309107422828674,0.2964499592781067
7407811,5708247,5069531,11905,8048,1998,5815,1991,3857,6090,1.0,0.0,96,6.0,18,11,42,819.0,0.4829382300376892,0.3531329929828644
7406866,5367217,4592095,11905,6900,1994,3799,1986,5005,8106,0.0,0.0,40,11.0,14,1,91,1981.0,0.4015468657016754,0.2950516641139984
7407538,6149719,4942318,11905,9091,2000,5311,1990,2814,6594,0.5,0.0,27,17.0,28,7,56,2352.0,0.6029751896858215,0.15493781864643097
7406854,6469303,4735832,11905,9791,2002,4478,1988,2114,7427,1.0,0.0,21,19.0,13,8,84,1134.0,0.4272230565547943,0.1317741870880127
7409571,5832282,4091618,11905,8342,1998,880,1978,3563,11025,0.0,0.0,5,10.0,10,1,259,511.0,0.40801987051963806,0.3056052029132843
7407737,5017263,6681806,11905,5619,1991,10253,2004,6286,1652,0.0,0.0,11,3.0,4,5,1029,763.0,0.3808797001838684,0.1209198534488678
7410048,6085896,6340069,11912,8958,2000,9518,2002,2954,2394,0.5,0.0,5,2.0,6,3,588,2086.0,0.6411707401275635,0.17050562798976898
7411645,6226063,4756142,11912,9252,2001,4576,1988,2660,7336,1.0,0.0,2,2.0,2,3,133,4991.0,0.26765206456184387,0.17579621076583862
7411369,6531843,4013182,11912,9931,2003,446,1977,1981,11466,1.0,0.0,12,2.0,14,1,469,105.0,0.5702894926071167,0.04102782905101776
7412062,6704870,3977610,11912,10295,2004,243,1976,1617,11669,0.0,0.0,1,9.0,8,1,1617,5467.0,0.28707191348075867,0.16654452681541443
7412149,5973679,5077675,11912,8699,1999,5843,1991,3213,6069,0.0,0.0,41,14.0,16,3,7,1393.0,0.3883959650993347,0.18995210528373718
7415439,5917908,5949169,11919,8580,1999,8650,1999,3339,3269,0.0,0.0,13,1.0,11,3,119,3269.0,0.35598844289779663,0.11347829550504684
7414542,6553285,5102530,11919,9973,2003,5941,1992,1946,5978,0.0,0.0,4,3.0,6,13,84,259.0,0.321671724319458,0.08884689956903458
7415066,6865395,5139156,11919,10659,2005,6074,1992,1260,5845,0.0,0.0,12,5.0,11,7,7,175.0,0.29234829545021057,0.09666815400123596
7415530,6253264,4751897,11919,9308,2001,4555,1988,2611,7364,0.5,0.0,18,5.0,14,4,35,1050.0,0.5274124145507812,0.16020651161670685
7415617,5335346,5105044,11919,6788,1994,5948,1992,5131,5971,0.0,0.0,165,5.0,9,10,14,56.0,0.3149978518486023,0.06957049667835236
7413010,5501275,4542559,11919,7390,1996,3554,1985,4529,8365,1.0,0.0,117,5.0,11,1,14,5754.0,0.3555446267127991,0.20560896396636963
7414275,5327012,5006315,11919,6760,1994,5577,1991,5159,6342,1.0,0.0,21,5.0,1,3,70,1918.0,0.483409583568573,0.2253255546092987
7416437,6258085,4051127,11926,9322,2001,635,1977,2604,11291,0.0,0.0,16,3.0,18,1,21,3990.0,0.31308919191360474,0.2133989781141281
7418577,5835764,4468938,11926,8349,1998,3169,1984,3577,8757,1.0,0.0,25,8.0,3,4,35,294.0,0.5198392868041992,0.18187713623046875
7417782,6300154,7055662,11926,9413,2001,11114,2006,2513,812,0.0,0.0,7,1.0,8,14,28,812.0,0.5408838987350464,0.38294553756713867
7416557,6709456,4911094,11926,10309,2004,5199,1990,1617,6727,1.0,0.0,32,9.0,62,1,28,2086.0,0.3520994484424591,0.1734556406736374
7417310,5262927,6360603,11926,6529,1993,9581,2002,5397,2345,0.0,0.0,59,2.0,24,7,105,1400.0,0.4586222767829895,0.31872794032096863
7418959,5725282,4839768,11933,8104,1998,4912,1989,3829,7021,0.0,0.0,3,14.0,5,4,2751,196.0,0.5187621712684631,0.05710451677441597
7419570,6410097,4656554,11933,9672,2002,4114,1987,2261,7819,0.0,0.0,4,5.0,2,7,553,2135.0,0.38523244857788086,-0.003634069114923477
7421724,5570295,4100229,11933,7607,1996,922,1978,4326,11011,0.5,0.0,138,13.0,13,2,0,2128.0,0.2524714469909668,0.09687899053096771
7420796,6762925,5093937,11933,10421,2004,5913,1992,1512,6020,1.0,0.0,5,8.0,1,6,399,49.0,0.32398858666419983,0.23469418287277222
7419617,5673081,6956036,11933,7943,1997,10883,2005,3990,1050,0.0,0.0,6,2.0,5,13,224,525.0,0.13825030624866486,0.2088405340909958
7419947,4973422,6966640,11933,5444,1990,10918,2005,6489,1015,0.3333333333333333,0.0,35,1.0,1,5,497,1015.0,0.26464182138442993,0.19904093444347382
7423535,5483244,4082380,11940,7313,1996,824,1978,4627,11116,0.0,0.0,14,2.0,3,2,182,3675.0,0.4652441442012787,0.1453067809343338
7423465,6310653,5340255,11940,9434,2001,6809,1994,2506,5131,0.5,0.0,8,7.0,2,5,161,1771.0,0.4681665003299713,0.25724080204963684
7423269,6852974,5240029,11940,10631,2005,6452,1993,1309,5488,0.0,0.0,4,6.0,10,1,91,2954.0,0.36333855986595154,0.20060589909553528
7423002,5637654,4093141,11940,7831,1997,887,1978,4109,11053,0.0,0.0,5,6.0,21,1,1988,3402.0,0.4626285433769226,0.1929072141647339
7425770,7081700,4685248,11947,11163,2006,4240,1987,784,7707,0.5,0.0,1,5.0,6,5,784,2156.0,0.37662649154663086,0.23578128218650818
7426288,6118889,6925127,11947,9021,2000,10806,2005,2926,1141,1.0,0.0,14,1.0,7,14,105,1141.0,0.5797643661499023,0.27988797426223755
7425930,5549108,4497285,11947,7544,1996,3323,1985,4403,8624,0.0,0.0,84,12.0,31,5,231,133.0,0.30183690786361694,0.24679675698280334
7428644,5644784,5170322,11954,7852,1997,6186,1992,4102,5768,1.0,0.0,94,6.0,4,4,14,945.0,0.4004782438278198,0.3273865878582001
7427539,5728592,5362262,11954,8111,1998,6886,1994,3843,5068,1.0,1.0,13,6.0,13,2,329,1820.0,0.6189731955528259,0.010891436599195004
7426755,4817210,5413284,11954,4842,1989,7068,1995,7112,4886,1.0,0.0,21,4.0,3,10,427,2366.0,0.519385576248169,0.2657027840614319
7427013,5943247,4184202,11954,8636,1999,1475,1980,3318,10479,0.5,0.5,2,13.0,9,2,2373,2611.0,0.6714617013931274,0.26833346486091614
7428166,5978267,4217020,11954,8706,1999,1685,1980,3248,10269,1.0,0.0,13,9.0,8,2,42,1407.0,0.5588486790657043,0.35046514868736267
7430083,6437930,6451213,11961,9728,2002,9756,2002,2233,2205,1.0,0.0,3,3.0,3,12,14,196.0,0.3999677300453186,0.22389823198318481
7430561,6640249,4493471,11961,10162,2003,3302,1985,1799,8659,1.0,0.0,29,14.0,116,3,7,49.0,0.20826907455921173,0.15761294960975647
7429689,5702378,4210457,11961,8034,1997,1643,1980,3927,10318,1.0,0.0,33,19.0,4,2,196,203.0,0.6222063899040222,0.2788577377796173
7428812,6446482,4286863,11961,9749,2002,2070,1981,2212,9891,0.0,0.0,13,10.0,29,1,21,1078.0,0.5463539361953735,0.38650327920913696
7430073,6525866,7136074,11961,9917,2003,11275,2006,2044,686,0.5,0.0,20,1.0,36,6,7,686.0,0.8481289744377136,0.2919962406158447
7430201,4460993,5045975,11961,3120,1984,5724,1991,8841,6237,1.0,0.0,19,29.0,7,20,203,329.0,0.3968420624732971,0.24820749461650848
7433488,6310956,4359174,11968,9434,2001,2511,1982,2534,9457,1.0,0.0,35,14.0,4,5,161,630.0,0.5783336758613586,0.1293041706085205
7434191,6202182,5297843,11968,9203,2001,6662,1994,2765,5306,0.0,0.0,40,7.0,19,2,28,2310.0,0.26174476742744446,0.09100262820720673
7431613,6864462,5704716,11968,10659,2005,8041,1998,1309,3927,0.0,0.0,3,4.0,14,3,42,147.0,0.393539160490036,0.15064245462417603
7433498,7120278,4321762,11968,11240,2006,2280,1982,728,9688,1.0,0.0,5,9.0,2,3,161,252.0,0.1421838402748108,0.18549446761608124
7431771,4528214,4757614,11968,3477,1985,4583,1988,8491,7385,1.0,0.0,12,16.0,6,4,1323,231.0,0.42788952589035034,0.31188708543777466
7433406,4520356,5741303,11968,3435,1985,8146,1998,8533,3822,0.0,0.0,40,7.0,4,4,133,546.0,0.3253747522830963,0.0778462216258049
7434178,6874128,4155672,11968,10680,2005,1237,1979,1288,10731,0.0,0.0,2,6.0,4,1,77,3871.0,0.2323566973209381,0.27678388357162476
7433188,6459581,5382957,11968,9770,2002,6956,1995,2198,5012,0.5,0.0,29,5.0,28,6,77,742.0,0.5176780819892883,0.10173391550779343
7431719,6183434,4054834,11968,9168,2001,656,1977,2800,11312,1.0,0.0,41,7.0,17,1,7,6342.0,0.37304607033729553,0.24020826816558838
7437313,6553178,4744184,11975,9973,2003,4520,1988,2002,7455,0.0,0.0,40,7.0,24,2,35,3010.0,0.34448662400245667,0.26198524236679077
7435837,6716987,6824939,11975,10323,2004,10561,2004,1652,1414,0.5,0.0,3,6.0,9,16,84,112.0,0.40650227665901184,0.07038290798664093
7434988,5349859,4952916,11975,6844,1994,5353,1990,5131,6622,1.0,0.5,142,15.0,6,4,7,511.0,0.6076865196228027,0.41572269797325134
7437445,5617540,7111015,11975,7761,1997,11219,2006,4214,756,1.0,1.0,79,1.0,6,12,35,756.0,0.4576081931591034,0.21223287284374237
7436346,5592477,7011402,11975,7677,1997,11030,2006,4298,945,0.5,0.0,127,1.0,21,3,126,945.0,0.3992583751678467,0.12246637046337128
7438454,4389698,5044639,11982,2728,1983,5724,1991,9254,6258,1.0,0.0,56,1.0,2,1,91,6258.0,0.5399887561798096,0.2810199558734894
7438718,6110187,4955429,11982,9007,2000,5367,1990,2975,6615,1.0,0.0,71,7.0,28,4,0,1946.0,0.462830513715744,0.40169790387153625
7440132,6763343,5502469,11982,10421,2004,7390,1996,1561,4592,1.0,0.0,32,8.0,3,15,7,742.0,0.40671011805534363,0.1525600254535675
7441667,4645602,5801728,11989,4072,1987,8279,1998,7917,3710,0.5,0.0,35,9.0,13,4,630,84.0,0.5461469888687134,0.3650303781032562
7443388,6115762,5452904,11989,9014,2000,7208,1995,2975,4781,0.0,0.0,17,7.0,15,4,7,756.0,0.42970287799835205,0.348569393157959
7446700,7084810,4923745,11996,11170,2006,5241,1990,826,6755,1.0,0.0,2,5.0,4,4,196,742.0,0.6239829063415527,0.05734168365597725
7445282,6550856,5314282,11996,9973,2003,6718,1994,2023,5278,0.0,0.0,11,10.0,12,6,133,140.0,0.6419751048088074,0.2427264302968979
7447588,5999126,4870840,11996,8741,1999,5024,1989,3255,6972,0.0,0.0,69,6.0,5,3,0,70.0,0.19570092856884003,0.15035738050937653
7447172,6356795,3983977,11996,9567,2002,278,1976,2429,11718,0.0,0.0,5,7.0,2,1,217,3325.0,0.5673119425773621,0.14981906116008759
7447072,5644539,4716832,11996,7852,1997,4387,1988,4144,7609,1.0,0.0,54,13.0,16,4,0,84.0,0.9948087930679321,0.10568765550851822
7446410,5289062,4223012,11996,6627,1994,1720,1980,5369,10276,0.0,0.0,36,3.0,16,3,7,8148.0,0.20725584030151367,0.05835958942770958
7445639,6540786,4089659,11996,9952,2003,866,1978,2044,11130,1.0,0.0,2,2.0,3,4,476,10115.0,0.487464040517807,0.08173871040344238
7449407,6204200,4927969,12003,9210,2001,5255,1990,2793,6748,1.0,0.0,24,3.0,5,2,56,1862.0,0.3831372857093811,0.20461857318878174
7450295,5499037,4444095,12003,7376,1996,3036,1984,4627,8967,0.0,0.0,62,31.0,5,3,42,329.0,0.36075714230537415,0.1314825862646103
7451106,5970475,5815960,12003,8692,1999,8314,1998,3311,3689,1.0,0.0,168,8.0,30,2,0,91.0,0.4735547602176666,0.29148009419441223
7452411,4597781,4038954,12010,3834,1986,579,1977,8176,11431,1.0,0.0,42,3.0,3,1,112,4368.0,0.4572281837463379,0.19357310235500336
7451765,6592594,4235079,12010,10057,2003,1790,1980,1953,10220,0.5,0.0,15,14.0,11,2,35,532.0,0.6904597878456116,0.40890565514564514
7454754,7249176,4378247,12010,11527,2007,2644,1983,483,9366,1.0,0.0,3,2.0,13,3,56,7609.0,0.37644410133361816,0.31852084398269653
7451506,5335384,4559003,12010,6795,1994,3638,1985,5215,8372,0.0,0.0,40,6.0,6,7,987,1246.0,0.3247619867324829,0.19984707236289978
7452668,5756291,5904981,12010,8181,1998,8538,1999,3829,3472,0.5,0.0,36,2.0,2,5,35,798.0,0.3690420687198639,-0.0007340834126807749
7452382,7344708,4107369,12010,11765,2008,957,1978,245,11053,0.0,0.0,1,3.0,6,1,245,9982.0,0.6816831827163696,0.4124913513660431
7456969,4934816,4433124,12017,5283,1990,2973,1984,6734,9044,1.0,0.0,53,3.0,6,2,175,854.0,0.5160362720489502,0.16859224438667297
7455617,4756211,4085734,12017,4576,1988,845,1978,7441,11172,1.0,0.0,84,6.0,4,2,0,2821.0,0.4528580605983734,0.3087671399116516
7456723,6922128,6015060,12017,10799,2005,8783,2000,1218,3234,1.0,0.0,2,4.0,7,6,903,1057.0,0.3924610912799835,0.12788328528404236
7455134,5908077,5769814,12017,8552,1999,8209,1998,3465,3808,1.0,0.0,18,5.0,35,14,147,910.0,0.6450710892677307,0.08181403577327728
7458101,6212410,3984044,12017,9224,2001,278,1976,2793,11739,0.3333333333333333,0.0,9,16.0,9,1,182,105.0,0.2829535901546478,0.1459205001592636
7458763,7422406,6845373,12024,11940,2008,10610,2005,84,1414,0.0,0.0,1,3.0,87,10,84,665.0,0.6130735278129578,0.10249214619398117
7461286,5576645,3983000,12024,7628,1996,271,1976,4396,11753,0.0,0.0,86,4.0,8,1,98,336.0,0.32345500588417053,-0.06321147829294205
7460503,5519706,4718551,12024,7446,1996,4394,1988,4578,7630,1.0,0.0,77,14.0,1,5,35,973.0,0.5017651915550232,0.271382212638855
7461539,5695925,4402321,12031,8013,1997,2805,1983,4018,9226,0.5,0.0,5,5.0,9,1,154,2772.0,0.15692758560180664,0.12604399025440216
7462915,6025280,5683608,12031,8811,2000,7978,1997,3220,4053,1.0,0.0,75,12.0,3,71,0,42.0,0.4205131232738495,0.2741844952106476
7462171,4693712,6283338,12031,4275,1987,9378,2001,7756,2653,1.0,0.0,8,1.0,3,1,1253,2653.0,0.7810176610946655,0.2926464378833771
7464574,5709913,6668210,12038,8055,1998,10218,2003,3983,1820,0.0,0.0,19,3.0,284,6,56,189.0,0.38729965686798096,0.18141160905361176
7464490,4837949,4027309,12038,4912,1989,516,1977,7126,11522,1.0,0.0,56,4.0,1,1,294,1834.0,0.53462153673172,0.1622188836336136
7466722,6570890,4219971,12038,10008,2003,1706,1980,2030,10332,1.0,0.0,23,7.0,14,1,28,728.0,0.32290413975715637,0.15181170403957367
7467133,6182142,4905616,12038,9161,2001,5178,1990,2877,6860,1.0,0.0,160,1.0,5,3,7,6860.0,0.426093190908432,0.26056239008903503
7466099,5734373,5414810,12038,8125,1998,7068,1995,3913,4970,0.0,0.0,280,9.0,124,13,14,2268.0,0.40786212682724,0.22954511642456055
7466313,6629065,5232061,12038,10134,2003,6424,1993,1904,5614,0.5,0.0,26,9.0,6,8,105,672.0,0.6287900805473328,0.14835970103740692
7468926,5276646,5472511,12045,6578,1994,7278,1995,5467,4767,1.0,0.0,81,10.0,8,9,7,1414.0,0.37604865431785583,0.2331957370042801
7468658,6356841,4055358,12045,9567,2002,663,1977,2478,11382,0.0,0.0,21,10.0,9,1,154,4410.0,0.512800395488739,0.05527103319764137
7467588,6860510,5457982,12045,10652,2005,7229,1995,1393,4816,1.0,0.0,3,10.0,13,1,63,168.0,0.34564918279647827,0.05935629457235336
7468545,7029953,4968443,12045,11065,2006,5423,1990,980,6622,1.0,0.0,2,8.0,4,3,567,4109.0,0.4599684476852417,0.20194420218467712
7468364,5292879,5561381,12045,6641,1994,7579,1996,5404,4466,0.5,0.0,2,9.0,23,12,812,7.0,0.703112006187439,0.12585963308811188
7467749,5713327,4611247,12045,8069,1998,3904,1986,3976,8141,1.0,0.0,15,14.0,18,11,357,203.0,0.4790918529033661,0.199197456240654
7468042,5672173,4524288,12045,7943,1997,3456,1985,4102,8589,1.0,0.0,31,15.0,128,3,119,77.0,0.5424646139144897,0.21461012959480286
7468042,5183463,7172751,12045,6242,1993,11359,2007,5803,686,1.0,0.3333333333333333,91,1.0,5,24,308,686.0,0.4307054877281189,0.10189221799373627
7469844,6790011,4839654,12052,10484,2004,4912,1989,1568,7140,0.0,0.0,3,14.0,8,4,189,658.0,0.4174730181694031,0.19901135563850403
7470506,5705500,5240200,12052,8041,1998,6452,1993,4011,5600,0.0,0.0,9,15.0,15,7,728,1946.0,0.6000567674636841,0.218455970287323
7470421,6506762,6125161,12052,9875,2003,9035,2000,2177,3017,0.5,0.0,64,5.0,3,12,7,420.0,0.2768254578113556,0.07146076112985611
7471503,6912113,4644791,12052,10771,2005,4072,1987,1281,7980,1.0,0.0,2,14.0,4,3,833,315.0,0.4883051812648773,0.2907825708389282
7473190,7220189,5769190,12059,11464,2007,8209,1998,595,3850,1.0,0.0,3,4.0,32,11,175,1848.0,0.9865695238113403,0.10868392884731293
7477263,6639611,4668134,12066,10162,2003,4163,1987,1904,7903,0.5,0.0,12,7.0,18,1,14,273.0,0.3473469316959381,0.25844666361808777
7475828,5179524,5910906,12066,6221,1993,8559,1999,5845,3507,0.5,0.0,22,7.0,14,10,266,1246.0,0.43783074617385864,0.08923806995153427
7477924,7003338,4403297,12066,11009,2006,2805,1983,1057,9261,1.0,0.0,18,21.0,103,10,14,539.0,0.28495359420776367,0.2262783944606781
7480848,6904464,5445299,12073,10750,2005,7180,1995,1323,4893,0.0,0.0,4,9.0,6,6,581,259.0,0.339885413646698,0.29487287998199463
7479872,4953851,6982675,12073,5360,1990,10960,2006,6713,1113,0.0,0.0,41,5.0,3,2,168,112.0,0.38393187522888184,0.08627073466777802
7478454,6431185,6684387,12073,9721,2002,10253,2004,2352,1820,1.0,0.0,13,2.0,5,6,84,182.0,0.41364985704421997,0.21636386215686798
7480949,5279010,4281719,12080,6592,1994,2042,1981,5488,10038,1.0,0.0,127,3.0,41,1,0,8428.0,0.4989742934703827,0.4676753580570221
7483686,5159710,6479947,12080,6144,1992,9812,2002,5936,2268,1.0,0.0,71,1.0,4,16,56,2268.0,0.2980130612850189,0.18012239038944244
7481705,6173955,4309524,12080,9147,2001,2196,1982,2933,9884,0.5,0.0,187,5.0,20,2,21,5600.0,0.38990721106529236,0.0254522655159235
7482212,5444282,4257073,12080,7173,1995,1902,1981,4907,10178,1.0,0.0,40,9.0,3,4,14,301.0,0.6270685195922852,0.3617660701274872
7483524,6819760,5908085,12080,10547,2004,8552,1999,1533,3528,1.0,0.0,19,6.0,5,8,42,525.0,0.23883825540542603,0.310422420501709
7484429,5318159,3981942,12087,6732,1994,264,1976,5355,11823,1.0,0.0,17,7.0,5,1,686,6356.0,0.4598549008369446,0.37607255578041077
7487148,5099436,5107922,12087,5927,1992,5962,1992,6160,6125,1.0,0.0,113,12.0,12,2,14,105.0,0.47124943137168884,0.2315828651189804
7484712,6520485,4008539,12087,9910,2003,418,1977,2177,11669,1.0,0.0,8,16.0,6,1,280,70.0,0.3507593870162964,0.26042330265045166
7486780,5943677,5907955,12087,8636,1999,8552,1999,3451,3535,0.0,0.0,58,3.0,3,4,28,931.0,0.1721956580877304,0.23423916101455688
7487302,5892962,5606487,12087,8496,1999,7726,1997,3591,4361,1.0,0.0,71,6.0,6,5,49,1960.0,0.34836170077323914,0.1837039738893509
7485926,5610083,5149143,12087,7740,1997,6109,1992,4347,5978,1.0,0.0,40,13.0,5,10,406,98.0,0.5256016850471497,0.3636229336261749
7485109,6245026,6044767,12087,9294,2001,8860,2000,2793,3227,1.0,0.0,31,2.0,26,6,28,1911.0,0.6593794226646423,0.20311059057712555
7486429,4566935,5095947,12087,3680,1986,5920,1992,8407,6167,0.0,0.0,291,20.0,2,5,7,63.0,0.5083602070808411,-0.019269313663244247
7487210,4686698,4133679,12087,4240,1987,1104,1979,7847,10983,0.0,0.0,118,15.0,15,3,56,371.0,0.21597756445407867,0.10694606602191925
7490162,6950434,5424844,12094,10862,2005,7103,1995,1232,4991,0.3333333333333333,0.5,6,13.0,18,3,49,21.0,0.36056292057037354,0.39537501335144043
7489643,7240364,6843829,12094,11506,2007,10610,2005,588,1484,0.3333333333333333,0.0,5,1.0,23,14,112,1484.0,0.4269380569458008,-0.016474533826112747
7488036,5475886,5698123,12094,7292,1995,8020,1997,4802,4074,1.0,0.0,14,6.0,9,8,14,826.0,0.2577410340309143,0.2518933117389679
7491438,6100208,4018346,12101,8986,2000,474,1977,3115,11627,0.5,0.0,14,6.0,100,1,231,413.0,0.5272745490074158,0.2556929290294647
7492575,5806948,6482249,12101,8293,1998,9819,2002,3808,2282,0.0,0.0,12,4.0,31,1,231,161.0,0.42696434259414673,0.14312174916267395
7493122,5881094,4328641,12101,8468,1999,2322,1982,3633,9779,1.0,0.0,16,8.0,22,3,273,98.0,0.4867981970310211,0.3253670334815979
7494982,5952490,5392173,12108,8657,1999,6991,1995,3451,5117,0.3333333333333333,0.0,6,10.0,2,4,315,455.0,0.4143857955932617,0.07507879287004471
7496518,6701313,4684672,12108,10288,2004,4233,1987,1820,7875,1.0,0.0,5,10.0,7,7,98,1792.0,0.5920384526252747,0.25834906101226807
7496766,7209562,4848481,12108,11436,2007,4947,1989,672,7161,0.5,0.0,1,4.0,4,4,672,1001.0,0.5018410086631775,0.1110449805855751
7494094,6227498,4617090,12108,9259,2001,3939,1986,2849,8169,1.0,0.0,14,6.0,15,2,42,224.0,0.5443900227546692,0.15611335635185242
7495564,6507279,4024390,12108,9875,2003,502,1977,2233,11606,1.0,0.0,41,13.0,23,2,14,1953.0,0.4423898458480835,0.20911641418933868
7496674,6310886,7185805,12108,9434,2001,11387,2007,2674,721,0.0,0.5,25,3.0,17,23,21,245.0,0.49250155687332153,0.3935130834579468
7498828,5952842,5380724,12115,8657,1999,6949,1995,3458,5166,1.0,0.0,31,1.0,3,3,14,5166.0,0.3499271869659424,0.0005389750003814697
7498651,5914499,4686803,12115,8573,1999,4247,1987,3542,7868,1.0,0.0,8,9.0,4,4,364,1260.0,0.45311588048934937,0.33244407176971436
7502738,6532444,4253475,12122,9931,2003,1888,1981,2191,10234,0.5,0.0,27,10.0,12,1,49,329.0,0.5282219648361206,0.11691846698522568
7503046,6292822,4012569,12122,9392,2001,439,1977,2730,11683,1.0,0.0,49,2.0,16,2,14,2317.0,0.2501664459705353,0.0650409460067749
7500979,4485816,4288552,12122,3260,1984,2077,1981,8862,10045,1.0,0.0,150,16.0,1,3,28,2149.0,0.35541167855262756,0.0673556923866272
7501679,6881629,4403297,12122,10701,2005,2805,1983,1421,9317,1.0,0.0,2,21.0,8,10,707,595.0,0.6217634081840515,0.17636819183826447
7500975,5849022,5596478,12122,8384,1998,7691,1997,3738,4431,1.0,0.0,64,3.0,7,2,21,2359.0,0.3950505554676056,0.269753634929657
7501355,6391803,4555670,12122,9637,2002,3617,1985,2485,8505,1.0,0.0,64,8.0,5,1,0,497.0,0.3572433292865753,0.13254155218601227
7501572,4137098,4412265,12122,1125,1979,2854,1983,10997,9268,0.5,0.0,10,20.0,3,2,119,441.0,0.3559436798095703,0.10660387575626373
7502418,5031195,4329153,12122,5668,1991,2322,1982,6454,9800,0.0,0.0,58,6.0,5,3,112,504.0,0.5499722361564636,0.22858381271362305
7502457,4899373,5459417,12122,5150,1990,7229,1995,6972,4893,1.0,0.0,221,3.0,4,3,35,2485.0,0.4236500561237335,0.14726927876472473
7505856,6275008,6554231,12129,9357,2001,9980,2003,2772,2149,0.0,0.0,37,8.0,3,9,7,56.0,0.5330786108970642,0.20040620863437653
7505269,5842514,4492055,12129,8370,1998,3295,1985,3759,8834,0.5,0.0,59,2.0,14,2,70,6531.0,0.5835279226303101,0.0074515026062726974
7503327,4347205,4172510,12129,2434,1982,1398,1979,9695,10731,0.0,0.0,49,13.0,1,2,70,126.0,0.446005254983902,0.1785467267036438
7506357,6477575,5346653,12129,9805,2002,6830,1994,2324,5299,1.0,0.0,51,3.0,6,3,14,2471.0,0.3151065707206726,0.06361845135688782
7507989,7029980,6826938,12136,11065,2006,10568,2004,1071,1568,1.0,0.0,1,1.0,24,9,1071,1568.0,0.4869105815887451,0.2622596323490143
7507367,6896271,4360620,12136,10736,2005,2518,1982,1400,9618,0.0,0.0,4,3.0,4,2,84,2233.0,0.44710394740104675,0.09785319119691849
7509572,5642520,4659248,12136,7845,1997,4128,1987,4291,8008,1.0,0.0,12,10.0,3,5,854,2359.0,0.4261507987976074,0.19179196655750275
7507660,6379748,4782292,12136,9616,2002,4688,1988,2520,7448,0.3333333333333333,0.0,53,4.0,22,1,14,3759.0,0.3596939146518707,0.1739317923784256
7506932,5237950,5215365,12136,6445,1993,6361,1993,5691,5775,0.0,0.0,24,7.0,2,5,1421,1190.0,0.465976744890213,0.3577980101108551
7508777,6199045,4353260,12136,9196,2001,2476,1982,2940,9660,1.0,0.0,143,4.0,18,3,7,1134.0,0.6086509227752686,0.11228824406862259
7510250,5724226,6755425,12143,8097,1998,10407,2004,4046,1736,0.0,0.0,10,3.0,6,7,749,476.0,0.4235176742076874,0.3114301860332489
7512401,5859979,5876208,12143,8412,1999,8461,1999,3731,3682,0.0,0.0,62,12.0,35,20,7,105.0,0.4343155026435852,0.04664115607738495
7512737,6412045,5248666,12143,9672,2002,6480,1993,2471,5663,1.0,0.0,22,10.0,4,7,42,476.0,0.4820225238800049,-0.05117490142583847
7510528,6589169,4675612,12143,10050,2003,4191,1987,2093,7952,1.0,0.0,5,44.0,25,3,98,7.0,0.35443487763404846,0.16246040165424347
7511702,6543947,4163789,12143,9959,2003,1314,1979,2184,10829,0.0,0.0,5,6.0,18,2,273,2422.0,0.263075590133667,0.0437006838619709
7510284,6191826,4564380,12143,9182,2001,3666,1986,2961,8477,0.0,0.0,22,2.0,11,6,35,1946.0,0.462288498878479,0.18224647641181946
7516002,6723211,4015208,12150,10337,2004,453,1977,1813,11697,0.0,0.0,9,25.0,52,1,49,924.0,0.33035898208618164,0.26169246435165405
7516363,6434736,4216495,12150,9721,2002,1678,1980,2429,10472,0.0,0.0,67,3.0,1,3,56,6209.0,0.3102355897426605,0.10327636450529099
7516176,6311327,4669399,12150,9434,2001,4170,1987,2716,7980,1.0,0.0,60,10.0,15,2,0,1330.0,0.13753746449947357,0.10950405895709991
7513313,5375661,5924573,12150,6935,1994,8601,1999,5215,3549,1.0,0.0,108,11.0,23,10,21,525.0,0.49205878376960754,0.40017735958099365
7519119,6188335,5865972,12157,9175,2001,8433,1999,2982,3724,0.0,0.0,8,6.0,3,4,14,189.0,0.4415915012359619,0.10538225620985031
7518500,6862454,5292672,12157,10652,2005,6641,1994,1505,5516,0.0,0.0,2,12.0,11,8,889,364.0,0.5295367240905762,0.10781703889369965
7519390,5881369,6222576,12157,8468,1999,9245,2001,3689,2912,1.0,0.0,24,5.0,4,2,35,1085.0,0.6150504946708679,0.06512884050607681
7517395,5709936,5086093,12157,8055,1998,5878,1992,4102,6279,0.0,0.0,9,10.0,6,14,28,1120.0,0.1394702047109604,0.2912043333053589
7523390,5206951,6592909,12164,6326,1993,10057,2003,5838,2107,1.0,0.0,181,1.0,9,1,14,2107.0,0.31980013847351074,0.05866217985749245
7521593,6307125,4098480,12164,9427,2001,915,1978,2737,11249,1.0,0.0,6,26.0,2,1,357,49.0,0.36337360739707947,0.04838089272379875
7520332,6585051,4068986,12164,10043,2003,747,1978,2121,11417,1.0,0.0,13,3.0,8,2,21,8260.0,0.41808050870895386,0.3313155472278595
7522948,5584296,5010871,12164,7656,1996,5598,1991,4508,6566,1.0,1.0,47,3.0,38,3,49,4732.0,0.3735327422618866,0.2272493690252304
7523399,4575579,5180484,12164,3722,1986,6228,1993,8442,5936,0.0,0.0,57,3.0,1,14,56,1463.0,0.3211953639984131,0.12008748948574066
7520125,5765368,7121130,12164,8202,1998,11247,2006,3962,917,1.0,0.0,8,1.0,6,5,322,917.0,0.6389380693435669,0.17608168721199036
7522953,6132387,6705629,12164,9056,2000,10302,2004,3108,1862,1.0,0.0,13,6.0,18,11,49,245.0,0.5202754735946655,0.13950808346271515
7522253,6055035,7020830,12164,8881,2000,11044,2006,3283,1120,0.5,0.0,150,1.0,5,9,7,1120.0,0.6181668043136597,0.08262278139591217
7522561,6748234,4385584,12164,10386,2004,2707,1983,1778,9457,1.0,0.0,7,11.0,6,1,154,1519.0,0.3339308202266693,0.145501047372818
7524282,6954674,5286061,12171,10876,2005,6620,1994,1295,5551,1.0,0.0,5,35.0,270,19,231,70.0,0.21589571237564087,0.1027691438794136
7525543,6532017,5734658,12171,9931,2003,8125,1998,2240,4046,1.0,0.0,9,8.0,8,7,273,7.0,0.34107866883277893,0.032557301223278046
7526128,5768417,5551436,12171,8202,1998,7551,1996,3969,4620,1.0,0.0,11,13.0,10,2,196,77.0,0.6290783882141113,0.2291533499956131
7523634,6523386,4776796,12171,9917,2003,4667,1988,2254,7504,1.0,0.0,1,10.0,1,1,2254,294.0,0.4920675456523895,0.32250264286994934
7526533,5787247,4088628,12171,8244,1998,859,1978,3927,11312,0.5,0.0,66,5.0,9,1,35,1162.0,0.450898677110672,0.1479104608297348
7528503,6314378,6038990,12178,9441,2001,8846,2000,2737,3332,0.0,0.0,8,5.0,10,1,245,609.0,0.39727848768234253,0.19074910879135132
7527995,5619365,7354626,12178,7768,1997,11786,2008,4410,392,0.0,0.0,108,1.0,10,6,28,392.0,0.25339698791503906,0.31543606519699097
7529585,5797970,4550672,12178,8272,1998,3596,1985,3906,8582,1.0,0.0,82,8.0,15,1,49,903.0,0.470136821269989,0.25171297788619995
7530050,5878407,7379235,12178,8461,1999,11835,2008,3717,343,1.0,0.0,4,1.0,6,7,133,343.0,0.3162526488304138,0.16039703786373138
7527201,6762865,4240607,12178,10421,2004,1818,1980,1757,10360,0.0,0.0,8,3.0,5,1,35,5579.0,0.23654437065124512,0.06272992491722107
7529242,6704874,4169972,12178,10295,2004,1370,1979,1883,10808,0.0,0.0,64,20.0,24,1,7,210.0,0.3655050992965698,0.2040477693080902
7529586,6480743,7330008,12178,9812,2002,11730,2008,2366,448,1.0,0.0,73,1.0,2,1,49,448.0,0.3141025900840759,0.19048301875591278
7531098,6241649,6261024,12185,9287,2001,9329,2001,2898,2856,0.0,0.0,12,2.0,8,17,154,1988.0,0.5437908172607422,0.10065997391939163
7531224,5692110,5927652,12185,7999,1997,8608,1999,4186,3577,0.0,0.0,5,3.0,7,2,1715,3017.0,0.3214282691478729,0.12865190207958221
7530629,5330028,4000329,12185,6774,1994,362,1976,5411,11823,1.0,0.0,19,5.0,3,3,7,2114.0,0.5600244402885437,0.16672785580158234
7530177,7141965,7020300,12185,11289,2006,11044,2006,896,1141,1.0,0.0,1,1.0,3,1,896,1141.0,0.3510027527809143,0.17584583163261414
7532231,6989856,4277428,12185,10981,2006,2014,1981,1204,10171,0.5,0.0,2,8.0,11,1,504,63.0,0.530004620552063,0.11646920442581177
7531319,6589761,6802681,12185,10050,2003,10512,2004,2135,1673,0.5,0.0,2,1.0,1,8,266,1673.0,0.5167902708053589,0.14784760773181915
7533820,5304787,7206184,12192,6683,1994,11429,2007,5509,763,1.0,0.0,106,1.0,4,25,7,763.0,0.36792874336242676,0.22225463390350342
7535376,4429219,6814123,12192,2952,1984,10540,2004,9240,1652,0.0,0.0,18,1.0,5,14,707,1652.0,0.34526798129081726,0.14133845269680023
7536181,6353897,4676575,12192,9560,2002,4198,1987,2632,7994,0.0,0.0,25,18.0,9,3,126,791.0,0.22769400477409363,0.24516722559928894
7533626,5286438,5094364,12192,6620,1994,5913,1992,5572,6279,0.0,0.0,18,4.0,18,4,364,2821.0,0.5208581686019897,0.24127209186553955
7535373,7054162,4557617,12192,11107,2006,3631,1985,1085,8561,0.0,0.0,5,25.0,20,5,84,1883.0,0.5806941390037537,0.12147234380245209
7534231,5242414,6509175,12192,6459,1993,9882,2003,5733,2310,1.0,0.0,13,2.0,3,9,1540,1533.0,0.5117964148521423,0.04429202154278755
7537012,5427767,6353883,12199,7117,1995,9560,2002,5082,2639,1.0,0.0,44,11.0,16,9,70,364.0,0.3786090612411499,0.09777352213859558
7537588,5403311,4867303,12199,7033,1995,5010,1989,5166,7189,1.0,0.0,462,10.0,30,13,21,2163.0,0.564077615737915,0.21600519120693207
7536981,6572837,4603554,12199,10015,2003,3869,1986,2184,8330,0.0,0.0,5,3.0,11,13,77,7196.0,0.6506280899047852,0.33926641941070557
7539503,6512930,7059893,12199,9889,2003,11121,2006,2310,1078,1.0,0.0,37,1.0,11,10,35,1078.0,0.4030248522758484,0.20074918866157532
7542657,5541738,6510967,12206,7516,1996,9889,2003,4690,2317,0.5,0.0,123,3.0,8,12,14,994.0,0.7351521849632263,0.13359035551548004
7542850,5266799,4825004,12206,6543,1993,4863,1989,5663,7343,1.0,0.0,17,13.0,5,4,462,7.0,0.5631454586982727,-0.016271015629172325
7540828,5429563,4656554,12206,7124,1995,4114,1987,5082,8092,1.0,0.0,16,5.0,5,7,189,2408.0,0.5225915312767029,0.14120523631572723
7540994,6730699,4400428,12206,10351,2004,2791,1983,1855,9415,0.0,0.0,11,5.0,8,3,112,511.0,0.29986661672592163,0.17383049428462982
7542942,6038292,6141205,12206,8839,2000,9070,2000,3367,3136,0.0,0.0,48,32.0,4,25,63,21.0,0.35864928364753723,0.1727478802204132
7542609,6330344,4965727,12206,9476,2001,5409,1990,2730,6797,0.5,0.5,13,4.0,9,1,147,3178.0,0.5734645128250122,0.3192934989929199
7545897,6408338,4207186,12213,9665,2002,1622,1980,2548,10591,1.0,0.0,15,4.0,8,2,147,1575.0,0.6122229099273682,0.17432630062103271
7546457,5421006,5546362,12213,7089,1995,7530,1996,5124,4683,1.0,0.5,304,6.0,26,2,7,728.0,0.5887347459793091,0.08242549747228622
7546435,5581767,7048283,12213,7642,1996,11100,2006,4571,1113,1.0,0.0,114,2.0,8,5,35,910.0,0.45939645171165466,0.26859554648399353
7547162,4344723,4927413,12220,2420,1982,5255,1990,9800,6965,1.0,0.0,10,12.0,5,35,252,826.0,0.5962034463882446,0.029552076011896133
7546730,6551050,4333489,12220,9973,2003,2350,1982,2247,9870,0.0,0.5,3,5.0,30,2,42,1085.0,0.4828023910522461,0.4033201336860657
7547904,5324401,5225970,12220,6753,1994,6396,1993,5467,5824,1.0,0.0,100,8.0,7,2,21,427.0,0.3738960921764374,0.26209232211112976
7548866,5948040,4713738,12220,8650,1999,4366,1987,3570,7854,0.5,0.0,468,7.0,22,7,14,2562.0,0.5796906352043152,0.17602919042110443
7552443,5836014,5231284,12227,8349,1998,6417,1993,3878,5810,1.0,0.0,67,5.0,12,11,0,7.0,0.14810864627361298,0.19382689893245697
7551572,5163131,4488363,12227,6158,1992,3274,1984,6069,8953,0.0,0.0,405,13.0,8,2,0,28.0,0.3116254210472107,0.16336236894130707
7550649,6504080,4181551,12227,9868,2003,1461,1980,2359,10766,0.3333333333333333,0.0,3,6.0,1,1,203,4403.0,0.549550473690033,-0.011717120185494423
7551810,5335305,4487189,12227,6788,1994,3267,1984,5439,8960,1.0,0.0,20,2.0,43,8,294,8225.0,0.5844182968139648,0.08507673442363739
7551854,7170393,4893387,12227,11352,2007,5129,1990,875,7098,0.5,0.0,4,5.0,10,4,7,630.0,0.48892372846603394,0.04987357556819916
7555776,7007301,5381742,12234,11016,2006,6956,1995,1218,5278,1.0,0.0,7,5.0,6,18,14,231.0,0.4075356423854828,0.12961898744106293
7554711,6028689,6792836,12234,8818,2000,10491,2004,3416,1743,0.5,0.0,141,3.0,4,8,7,315.0,0.3192294239997864,0.18904875218868256
7554439,6965313,7366497,12234,10911,2005,11807,2008,1323,427,1.0,0.0,6,1.0,21,3,28,427.0,0.39277172088623047,0.2252124398946762
7552775,7188547,5798951,12234,11394,2007,8272,1998,840,3962,0.0,0.0,4,5.0,74,6,91,315.0,0.6509857773780823,0.33134880661964417
7554574,5418899,5971411,12234,7082,1995,8699,1999,5152,3535,0.0,0.0,17,12.0,2,4,196,315.0,0.4447742998600006,0.08776415884494781
7556638,6461373,7121631,12241,9777,2002,11247,2006,2464,994,1.0,0.0,10,2.0,10,16,98,203.0,0.8904101252555847,0.20317640900611877
7558020,6504675,6511447,12241,9868,2003,9889,2003,2373,2352,1.0,0.0,72,2.0,4,7,7,1848.0,0.549485445022583,0.3006124198436737
7557817,6950130,5680843,12241,10862,2005,7971,1997,1379,4270,0.0,0.0,2,4.0,21,6,364,1092.0,0.46037352085113525,0.19323423504829407
7557068,5811238,4469079,12241,8300,1998,3169,1984,3941,9072,0.3333333333333333,0.0,204,8.0,9,1,7,1540.0,0.5355163216590881,0.09454332292079926
7556089,6588498,5024288,12241,10050,2003,5647,1991,2191,6594,1.0,0.0,39,11.0,8,6,35,462.0,0.46120280027389526,0.24269774556159973
7556677,4774038,5688848,12241,4653,1988,7992,1997,7588,4249,0.0,0.0,6,3.0,2,29,1785,994.0,0.5270785689353943,0.3294079005718231
7562117,6765495,5196791,12248,10428,2004,6291,1993,1820,5957,0.0,0.0,24,16.0,35,9,28,2121.0,0.36699366569519043,0.06432456523180008
7560256,6503751,4003389,12248,9868,2003,383,1977,2380,11865,0.5,0.0,14,2.0,44,1,0,10577.0,0.24273087084293365,0.2797933518886566
7559391,5950753,6285603,12248,8657,1999,9378,2001,3591,2870,1.0,0.0,6,6.0,3,8,623,364.0,0.3651181161403656,0.07461623102426529
7562298,6360363,5186100,12248,9574,2002,6256,1993,2674,5992,1.0,0.0,35,7.0,14,3,7,420.0,0.26002463698387146,0.24869416654109955
7563324,5720726,4382739,12255,8090,1998,2686,1983,4165,9569,0.0,0.0,51,10.0,19,1,14,2051.0,0.43873080611228943,0.1913621425628662
7565461,5295246,4681412,12255,6648,1994,4219,1987,5607,8036,1.0,0.0,47,8.0,15,2,161,7.0,0.4698598086833954,0.16513226926326752
7564131,6762503,4139026,12255,10421,2004,1139,1979,1834,11116,0.5,0.0,11,11.0,10,1,7,5362.0,0.3956671953201294,0.0681062787771225
7563780,6120536,4247668,12255,9028,2000,1853,1981,3227,10402,0.5,0.5,174,2.0,39,1,0,9779.0,0.4273930788040161,0.1577666997909546
7566433,6960251,7288017,12262,10897,2005,11625,2007,1365,637,0.0,0.0,1,2.0,3,3,1365,133.0,0.5352265238761902,0.09553336352109909
7567567,5920566,4387164,12262,8587,1999,2714,1983,3675,9548,1.0,0.0,88,7.0,87,11,7,2072.0,0.5261107087135315,0.15465140342712402
7566397,4421648,5268884,12262,2910,1983,6550,1993,9352,5712,1.0,0.0,17,7.0,6,7,49,1218.0,0.5673389434814453,0.16138586401939392
7568135,6097638,4391711,12262,8979,2000,2742,1983,3283,9520,1.0,0.0,43,16.0,1,3,35,273.0,0.45562952756881714,0.14107058942317963
7570116,6784739,4615631,12269,10470,2004,3932,1986,1799,8337,1.0,0.0,3,22.0,5,11,231,3808.0,0.4808993935585022,0.42186614871025085
7568372,4392263,4427199,12269,2749,1983,2945,1984,9520,9324,0.0,0.0,29,8.0,1,4,231,1799.0,0.6388711929321289,0.23396539688110352
7568973,6354946,7072559,12269,9567,2002,11142,2006,2702,1127,0.0,0.0,15,5.0,15,6,56,28.0,0.383465975522995,0.24147608876228333
7568927,5917167,5732776,12269,8580,1999,8125,1998,3689,4144,1.0,0.0,16,6.0,9,48,161,28.0,0.0775204747915268,0.09326162934303284
7570559,5448728,6752347,12269,7187,1995,10400,2004,5082,1869,0.0,0.0,49,3.0,10,4,0,140.0,0.4399876594543457,0.2889012396335602
7569056,6152871,6727854,12269,9098,2000,10344,2004,3171,1925,1.0,0.0,45,9.0,62,3,49,91.0,0.4000997543334961,0.1692386418581009
7570876,5219079,6811582,12269,6375,1993,10533,2004,5894,1736,0.0,0.0,28,2.0,4,21,245,1071.0,0.5124019384384155,0.11710800230503082
7569922,7364946,6638757,12269,11807,2008,10162,2003,462,2107,1.0,0.0,1,2.0,113,19,462,175.0,0.5193412899971008,0.05131816118955612
7570716,5982819,4051085,12269,8713,1999,635,1977,3556,11634,0.5,0.0,28,7.0,6,1,21,2891.0,0.5050593614578247,0.11131618916988373
7569856,5475244,6940762,12269,7285,1995,10841,2005,4984,1428,1.0,0.0,22,4.0,6,3,98,140.0,0.6247115731239319,0.39681193232536316
7569508,4701428,4238671,12269,4310,1987,1804,1980,7959,10465,0.3333333333333333,0.0,33,15.0,1,1,14,287.0,0.4706924259662628,0.2999003231525421
7569126,6203952,5650877,12269,9210,2001,7873,1997,3059,4396,0.0,0.0,35,4.0,11,11,28,14.0,0.18742932379245758,0.15251052379608154
7573521,4819070,4571272,12276,4842,1989,3701,1986,7434,8575,1.0,0.0,38,10.0,1,5,0,5978.0,0.37229225039482117,0.08674892038106918
7571767,6531427,4705756,12276,9931,2003,4331,1987,2345,7945,0.5,0.0,49,12.0,22,4,70,924.0,0.42466244101524353,0.20664618909358978
7571541,6659588,6293986,12276,10204,2003,9399,2001,2072,2877,0.5,0.0,8,7.0,18,1,98,70.0,0.3877502381801605,0.21542541682720184
7571692,4945852,4387636,12276,5332,1990,2721,1983,6944,9555,1.0,0.0,15,3.0,2,3,350,3836.0,0.5117337703704834,0.2196628302335739
7572478,4599538,6900069,12276,3841,1986,10743,2005,8435,1533,0.0,0.3333333333333333,10,3.0,5,10,644,644.0,0.5003085732460022,0.5135646462440491
7572200,5432539,4842085,12276,7131,1995,4926,1989,5145,7350,0.0,0.0,66,12.0,16,8,49,238.0,0.18230992555618286,0.10326305776834488
7574706,5421009,5561676,12276,7089,1995,7579,1996,5187,4697,1.0,0.0,189,12.0,1,1,0,1771.0,0.5231427550315857,0.20651443302631378
7577108,7463890,6576643,12283,12031,2008,10022,2003,252,2261,0.25,0.0,3,2.0,13,2,0,469.0,0.4706136882305145,0.03464237600564957
7576170,6267977,4110761,12283,9343,2001,971,1978,2940,11312,0.0,0.0,1,7.0,11,2,2940,2534.0,0.3267015218734741,0.08500337600708008
7574878,6779551,6235199,12283,10463,2004,9273,2001,1820,3010,0.0,0.0,1,5.0,13,10,1820,1519.0,0.5648354887962341,0.4662347733974457
7577305,6215425,4154175,12283,9231,2001,1230,1979,3052,11053,0.0,0.0,10,2.0,4,1,35,6132.0,0.2675282955169678,0.012827694416046143
7574973,4768739,6902322,12283,4632,1988,10750,2005,7651,1533,0.0,0.0,31,3.0,5,9,1379,259.0,0.3879207372665405,0.31106775999069214
7580687,6462622,6056224,12290,9777,2002,8888,2000,2513,3402,0.5,0.0,12,2.0,5,8,70,2632.0,0.45341047644615173,0.38260987401008606
7578671,6113390,5996593,12290,9014,2000,8741,1999,3276,3549,1.0,0.0,10,8.0,21,6,1148,259.0,0.451842337846756,0.43511855602264404
7580172,6940631,5415586,12290,10841,2005,7075,1995,1449,5215,0.5,0.0,25,12.0,8,3,21,49.0,0.48959624767303467,0.039229221642017365
7578494,7055539,4287847,12290,11114,2006,2077,1981,1176,10213,1.0,0.0,3,5.0,4,1,742,336.0,0.45828524231910706,0.17707154154777527
7578828,5893886,6121303,12290,8503,1999,9028,2000,3787,3262,1.0,0.5,21,1.0,8,3,56,3262.0,0.4230392873287201,0.00540293799713254
7582024,7347795,4212933,12297,11772,2008,1657,1980,525,10640,1.0,0.0,4,11.0,47,3,329,1862.0,0.6958321332931519,0.2264997661113739
7581683,7152805,4729452,12297,11317,2006,4450,1988,980,7847,1.0,0.0,1,4.0,25,1,980,861.0,0.4991041421890259,0.3110377788543701
7582982,4452562,5577050,12297,3078,1984,7628,1996,9219,4669,1.0,0.0,16,6.0,3,3,154,70.0,0.6060354709625244,0.12646472454071045
7582445,5869293,4062555,12297,8440,1999,712,1977,3857,11585,0.5,0.0,3,20.0,8,3,413,1603.0,0.19788764417171478,0.06678836047649384
7584425,7085360,5005069,12297,11170,2006,5570,1991,1127,6727,0.0,0.0,2,21.0,7,4,728,1043.0,0.2341948300600052,0.07715356349945068
7583855,6317599,6864380,12297,9448,2001,10659,2005,2849,1638,0.0,0.0,71,2.0,7,1,14,1043.0,0.24196238815784454,-0.006411329377442598
7585413,6136185,4401406,12304,9063,2000,2798,1983,3241,9506,1.0,0.0,11,2.0,12,2,637,4963.0,0.6532195210456848,0.24930495023727417
7587239,6496730,6505421,12304,9847,2002,9875,2003,2457,2429,1.0,0.0,23,7.0,23,8,56,119.0,0.3172910511493683,0.19661016762256622
7584791,5853048,4905616,12304,8398,1998,5178,1990,3906,7126,1.0,0.0,106,2.0,21,3,28,105.0,0.6583390831947327,0.14967389404773712
7586934,6968611,5996593,12304,10925,2005,8741,1999,1379,3563,0.0,0.0,22,8.0,79,6,28,273.0,0.29055464267730713,0.297637403011322
7585444,5709488,5542179,12304,8055,1998,7523,1996,4249,4781,0.0,0.0,13,5.0,8,5,105,322.0,0.4955926239490509,0.33889102935791016
7584892,6254003,4230502,12304,9315,2001,1762,1980,2989,10542,1.0,0.0,83,12.0,7,2,7,791.0,0.4275289475917816,0.18759630620479584
7590490,6917982,6007113,12311,10785,2005,8762,1999,1526,3549,0.0,0.0,1,2.0,7,6,1526,371.0,0.2518245279788971,0.0808396115899086
7589832,6772084,4578674,12311,10442,2004,3736,1986,1869,8575,0.0,0.0,44,71.0,16,5,7,49.0,0.2895016074180603,0.284280389547348
7590000,5764096,4491883,12311,8195,1998,3288,1985,4116,9023,1.0,1.0,42,2.0,4,2,84,7581.0,0.48377707600593567,0.23002010583877563
7588574,5785709,5798616,12311,8244,1998,8272,1998,4067,4039,1.0,0.0,19,13.0,15,4,42,7.0,0.5114449262619019,0.14275404810905457
7589608,6310455,4160645,12311,9434,2001,1286,1979,2877,11025,0.0,0.0,5,35.0,10,3,210,539.0,0.24141669273376465,0.13889123499393463
7589547,6672875,6889660,12311,10232,2004,10722,2005,2079,1589,0.0,0.0,63,3.0,53,9,49,476.0,0.38166502118110657,0.14794275164604187
7587776,5562091,4760706,12311,7586,1996,4597,1988,4725,7714,0.5,0.0,25,5.0,23,3,168,2611.0,0.5213747620582581,0.34266239404678345
7590921,4998252,5420480,12311,5542,1991,7089,1995,6769,5222,0.0,0.0,27,11.0,8,2,980,427.0,0.456714004278183,0.18074758350849152
7590999,6008836,4584740,12311,8762,1999,3771,1986,3549,8540,1.0,0.0,52,5.0,27,4,49,2107.0,0.26653268933296204,0.2973290681838989
7591279,5741433,4272022,12318,8146,1998,1986,1981,4172,10332,0.0,0.0,20,13.0,7,2,21,126.0,0.43202587962150574,0.205908864736557
7593858,6970641,6699908,12318,10925,2005,10288,2004,1393,2030,0.0,0.0,3,1.0,30,115,742,2030.0,0.3179258406162262,0.025330787524580956
7594001,6343148,4825004,12318,9525,2002,4863,1989,2793,7455,1.0,0.0,17,13.0,5,4,42,119.0,0.32417258620262146,0.2623760402202606
7591113,5258069,6841996,12318,6515,1993,10603,2005,5803,1715,0.0,0.0,15,6.0,4,23,266,21.0,0.22667457163333893,0.16415615379810333
7596675,5497476,7206184,12325,7369,1996,11429,2007,4956,896,1.0,0.0,97,1.0,2,25,0,896.0,0.42550143599510193,0.2952169179916382
7601184,6599334,4523935,12339,10071,2003,3456,1985,2268,8883,1.0,0.0,13,19.0,16,4,28,2324.0,0.5756670236587524,0.2607777714729309
7600850,5874971,6353836,12339,8454,1999,9560,2002,3885,2779,1.0,0.0,13,3.0,3,12,1071,14.0,0.4370563328266144,0.22027571499347687
7602375,5233456,5767994,12339,6424,1993,8202,1998,5915,4137,0.0,0.0,206,24.0,7,1,35,378.0,0.13519790768623352,0.4294658601284027
7601270,5840412,4013327,12339,8363,1998,446,1977,3976,11893,0.0,0.0,27,16.0,34,1,35,2555.0,0.4485953450202942,0.16760122776031494
7600312,6237214,5201853,12339,9280,2001,6312,1993,3059,6027,0.3333333333333333,0.0,3,8.0,14,2,1722,77.0,0.7474621534347534,0.2743580639362335
7602374,6727881,6915161,12339,10344,2004,10778,2005,1995,1561,0.3333333333333333,0.0,67,1.0,184,18,7,1561.0,0.33017462491989136,0.18105758726596832
7600505,6394424,4125574,12339,9644,2002,1048,1978,2695,11291,1.0,0.0,9,16.0,8,1,714,721.0,0.44863778352737427,0.26043713092803955
7602702,7477642,6038133,12339,12066,2009,8839,2000,273,3500,0.3333333333333333,0.0,1,12.0,3,17,273,14.0,0.634796142578125,0.10008607804775238
7600677,4759063,4854231,12339,4583,1988,4968,1989,7756,7371,0.0,0.0,115,10.0,8,6,7,854.0,0.3503444194793701,0.17321373522281647
7606620,5803084,4271063,12346,8286,1998,1979,1981,4060,10367,1.0,0.0,29,3.0,17,1,84,7364.0,0.4015873968601227,0.17065010964870453
7605217,6342565,6353460,12346,9525,2002,9560,2002,2821,2786,0.5,0.0,56,8.0,22,18,161,14.0,0.5939658284187317,0.02607845701277256
7609925,4654474,4727488,12353,4107,1987,4436,1988,8246,7917,0.0,0.0,23,8.0,8,1,21,826.0,0.4723737835884094,0.19930057227611542
7607913,5280756,4132003,12353,6599,1994,1097,1979,5754,11256,1.0,0.0,23,6.0,15,4,21,4914.0,0.575528621673584,0.13084301352500916
7609215,4940989,4771247,12353,5304,1990,4639,1988,7049,7714,1.0,0.0,21,23.0,1,1,2380,371.0,0.5641915202140808,0.37539181113243103
7613097,5712843,4146464,12360,8062,1998,1181,1979,4298,11179,1.0,0.0,4,4.0,1,3,98,6377.0,0.5832309126853943,0.052969347685575485
7613250,7330517,6841610,12360,11730,2008,10603,2005,630,1757,1.0,0.0,1,4.0,2,4,630,105.0,0.5584717392921448,0.1802474707365036
7611372,6965078,7425216,12360,10911,2005,11947,2008,1449,413,1.0,0.0,3,1.0,3,145,119,413.0,0.2965906262397766,0.15160606801509857
7611416,5785602,6028452,12360,8244,1998,8818,2000,4116,3542,1.0,0.0,3,2.0,1,8,1008,1701.0,0.4895740747451782,0.10777612030506134
7611673,6575026,5241498,12360,10022,2003,6452,1993,2338,5908,0.5,0.0,2,4.0,14,5,1750,4004.0,0.3660385012626648,0.23535428941249847
7616997,5967986,4922534,12367,8692,1999,5234,1990,3675,7133,1.0,0.0,100,17.0,6,19,0,1155.0,0.40373435616493225,0.21291744709014893
7615871,6326697,6572592,12367,9469,2001,10015,2003,2898,2352,1.0,0.0,92,8.0,30,142,56,224.0,0.5820543766021729,0.3295516073703766
7614567,6502758,6624543,12367,9868,2003,10127,2003,2499,2240,1.0,0.0,14,5.0,18,7,21,455.0,0.6010059714317322,0.28867122530937195
7615014,5396887,6939639,12367,7012,1995,10841,2005,5355,1526,1.0,0.0,56,1.0,5,2,105,1526.0,0.329073041677475,0.1534433364868164
7618459,6179874,6029015,12374,9161,2001,8818,2000,3213,3556,1.0,0.0,107,5.0,32,11,0,476.0,0.6571465730667114,0.09362595528364182
7619752,5910842,4333557,12374,8559,1999,2350,1982,3815,10024,1.0,0.0,95,11.0,21,2,119,2485.0,0.5106443166732788,0.2925461232662201
7620427,6035189,5510204,12374,8832,2000,7418,1996,3542,4956,1.0,0.0,33,4.0,8,4,42,2023.0,0.4401121735572815,0.20626115798950195
7620378,5465418,6212299,12374,7250,1995,9224,2001,5124,3150,1.0,0.0,71,10.0,10,16,42,259.0,0.4150126874446869,0.25274622440338135
7617651,6436159,5365684,12374,9728,2002,6900,1994,2646,5474,0.0,0.0,10,5.0,18,3,119,301.0,0.09660769253969193,0.4201485514640808
7621359,7393296,5083585,12381,11870,2008,5871,1992,511,6510,1.0,0.0,3,4.0,3,1,14,1225.0,0.33934175968170166,0.31470584869384766
7624300,6886108,4771924,12381,10708,2005,4646,1988,1673,7735,1.0,0.0,7,1.0,18,1,133,7735.0,0.5850168466567993,0.1978103667497635
7621862,5803889,4367404,12381,8286,1998,2560,1983,4095,9821,0.5,0.0,15,2.0,18,2,252,70.0,0.3586307764053345,0.06793686747550964
7630134,5928801,6474366,12395,8608,1999,9805,2002,3787,2590,0.0,0.0,18,3.0,5,4,28,1652.0,0.5860970616340637,0.22738079726696014
7629484,5981772,4024390,12395,8713,1999,502,1977,3682,11893,1.0,0.0,11,13.0,2,2,35,2240.0,0.4434151351451874,0.16930314898490906
7631061,5966540,4253475,12395,8685,1999,1888,1981,3710,10507,1.0,0.0,66,10.0,10,1,21,602.0,0.43203818798065186,0.15307877957820892
7629113,6514722,6598508,12395,9896,2003,10071,2003,2499,2324,0.5,0.0,15,2.0,27,18,14,1358.0,0.11039335280656815,-0.038152698427438736
7631120,6732171,4635581,12395,10351,2004,4030,1987,2044,8365,1.0,0.0,19,12.0,1,1,7,1456.0,0.5708569288253784,0.24070316553115845
7630905,6330327,4662052,12395,9476,2001,4142,1987,2919,8253,0.5,0.0,13,7.0,7,8,203,28.0,0.4640689194202423,0.18274298310279846
7628630,4645283,6540923,12395,4072,1987,9952,2003,8323,2443,1.0,0.0,11,3.0,4,9,63,1169.0,0.22373457252979279,0.11952842772006989
7631656,6858066,5079579,12402,10645,2005,5850,1992,1757,6552,0.0,0.0,2,14.0,33,16,217,3528.0,0.3288475573062897,0.23939239978790283
7634136,5589856,4842085,12402,7670,1996,4926,1989,4732,7476,0.5,0.0,21,12.0,11,8,7,364.0,0.4623233675956726,0.20685794949531555
7631921,6234563,6746443,12402,9273,2001,10386,2004,3129,2016,0.0,0.0,11,7.0,4,25,168,35.0,0.3618532717227936,0.21030059456825256
7634777,6804818,5116659,12402,10512,2004,5990,1992,1890,6412,1.0,0.0,7,14.0,4,8,126,644.0,0.39899104833602905,0.09399868547916412
7633035,4925523,4948638,12402,5248,1990,5339,1990,7154,7063,0.0,0.0,37,5.0,15,4,833,987.0,0.4193880259990692,0.2745629847049713
7632335,4372779,4768017,12402,2595,1983,4625,1988,9807,7777,0.0,0.0,5,14.0,2,2,7,462.0,0.31632575392723083,0.050788696855306625
7631546,6928863,4426546,12402,10820,2005,2938,1984,1582,9464,0.5,0.0,3,13.0,6,3,35,49.0,0.45837023854255676,0.31463897228240967
7635676,5589395,5684922,12409,7670,1996,7978,1997,4739,4431,0.0,0.0,6,11.0,5,7,504,273.0,0.6696830987930298,-0.011356627568602562
7636596,5269305,6546433,12409,6557,1993,9959,2003,5852,2450,1.0,0.0,32,16.0,9,1,161,91.0,0.3266717791557312,0.13769817352294922
7637868,5571395,4251283,12416,7614,1996,1874,1981,4802,10542,0.0,0.0,27,10.0,17,4,14,4025.0,0.14892199635505676,0.05732985585927963
7639238,6337681,6332557,12416,9504,2002,9490,2001,2912,2926,0.5,0.0,10,2.0,27,15,42,2541.0,0.45154595375061035,0.07355346530675888
7640570,4768110,6801539,12416,4625,1988,10505,2004,7791,1911,0.5,1.0,61,3.0,7,8,14,1057.0,0.2254670262336731,0.3750075697898865
7638570,4683274,5436996,12416,4226,1987,7145,1995,8190,5271,0.5,0.0,51,10.0,2,1,105,35.0,0.618201732635498,0.18143101036548615
7638826,6352869,6826938,12416,9560,2002,10568,2004,2856,1848,0.5,0.0,26,1.0,12,9,63,1848.0,0.5854181051254272,0.21598821878433228
7636951,5488739,5365684,12416,7341,1996,6900,1994,5075,5516,1.0,0.0,25,5.0,4,3,35,343.0,0.617245614528656,0.15245462954044342
7639072,6678041,4333474,12416,10239,2004,2350,1982,2177,10066,0.5,0.0,3,4.0,3,2,42,6594.0,0.3253122866153717,0.2260696291923523
7640221,6360191,5187718,12416,9574,2002,6256,1993,2842,6160,1.0,0.0,31,3.0,5,4,0,3080.0,0.4213586747646332,0.2703428268432617
7637868,6862465,5847334,12416,10652,2005,8377,1998,1764,4039,1.0,0.0,24,6.0,82,2,14,189.0,0.32485201954841614,0.06727441400289536
7643895,4371188,3980132,12423,2588,1983,257,1976,9835,12166,0.0,0.0,17,7.0,6,1,7,1330.0,0.2418963760137558,0.15452538430690765
7641114,7036738,4361313,12423,11079,2006,2525,1982,1344,9898,1.0,0.0,11,6.0,31,2,28,3220.0,0.41510072350502014,0.11844374239444733
7642527,5698866,4741087,12423,8020,1997,4506,1988,4403,7917,0.0,0.0,115,30.0,6,3,7,196.0,0.37453335523605347,0.11183314025402069
7645284,5226911,5732776,12430,6403,1993,8125,1998,6027,4305,1.0,0.0,221,6.0,7,48,0,28.0,0.5360465049743652,0.3354324996471405
7647254,5263164,4039830,12430,6529,1993,579,1977,5901,11851,1.0,0.0,34,5.0,188,2,119,1939.0,0.5633147358894348,0.1632104367017746
7645596,6331439,4475390,12430,9483,2001,3204,1984,2947,9226,0.0,0.0,27,1.0,83,1,21,9226.0,0.2701603174209595,0.10849405825138092
7647513,6128745,5224281,12430,9042,2000,6396,1993,3388,6034,1.0,0.0,13,1.0,11,14,147,6034.0,0.3615166246891022,0.11062399297952652
7645261,5313967,4309641,12430,6718,1994,2196,1982,5712,10234,1.0,0.0,33,1.0,12,3,224,10234.0,0.4923683702945709,0.24802251160144806
7648946,6710019,4961943,12437,10309,2004,5395,1990,2128,7042,0.5,0.0,92,23.0,11,12,14,168.0,0.4208022654056549,0.21244536340236664
7650080,5428814,4339580,12437,7117,1995,2385,1982,5320,10052,1.0,0.0,22,2.0,7,1,98,6748.0,0.27247869968414307,0.051727548241615295
7648933,5498275,5660224,12437,7376,1996,7908,1997,5061,4529,0.0,0.0,8,9.0,7,1,812,252.0,0.32265740633010864,0.08608238399028778
7649710,5172282,4369453,12437,6193,1992,2574,1983,6244,9863,1.0,0.0,22,5.0,3,3,98,5397.0,0.4463781416416168,0.34573042392730713
7648869,5393693,6432957,12437,6998,1995,9721,2002,5439,2716,1.0,0.0,21,6.0,4,7,7,161.0,0.44553717970848083,-0.010510229505598545
7649947,6529634,4031964,12437,9924,2003,544,1977,2513,11893,0.5,0.0,10,18.0,8,1,42,413.0,0.4439261555671692,0.24385765194892883
7650621,5933835,5595556,12437,8615,1999,7691,1997,3822,4746,0.0,0.0,31,20.0,9,51,77,63.0,0.5631433725357056,0.17633946239948273
7649045,5120325,7231924,12437,6004,1992,11492,2007,6433,945,0.0,0.0,12,1.0,10,8,280,945.0,0.5437836050987244,0.12473646551370621
7653602,6076068,5907409,12444,8930,2000,8545,1999,3514,3899,1.0,0.0,97,2.0,47,5,0,2023.0,0.30702102184295654,0.3328525424003601
7651989,6236317,4385975,12444,9273,2001,2707,1983,3171,9737,0.0,0.0,32,28.0,16,11,21,70.0,0.3967187702655792,0.09069260954856873
7652094,6706828,4734459,12444,10302,2004,4471,1988,2142,7973,1.0,1.0,13,28.0,10,5,0,168.0,0.48048606514930725,0.6521344780921936
7651502,6520962,7467436,12444,9910,2003,12045,2008,2534,399,1.0,0.0,16,1.0,17,3,35,399.0,0.7145602703094482,0.46659955382347107
7652848,7535677,4330260,12444,12192,2009,2329,1982,252,10115,1.0,0.0,1,21.0,8,6,252,763.0,0.5296887755393982,0.11919750273227692
7650675,5440792,6171612,12444,7166,1995,9140,2001,5278,3304,1.0,0.0,18,6.0,1,3,1015,385.0,0.6586986184120178,0.14701159298419952
7650649,6918678,5258924,12444,10792,2005,6515,1993,1652,5929,0.0,0.0,5,9.0,8,7,77,2205.0,0.46686312556266785,0.15453940629959106
7657300,5947980,5413908,12451,8650,1999,7068,1995,3801,5383,1.0,0.0,17,9.0,11,2,42,329.0,0.20321454107761383,0.1477741003036499
7655004,6558384,6910558,12451,9987,2003,10771,2005,2464,1680,1.0,0.0,2,2.0,7,9,518,1134.0,0.39089348912239075,0.2757924497127533
7658751,5893592,6171612,12458,8503,1999,9140,2001,3955,3318,0.5,1.0,20,6.0,3,3,14,399.0,0.4850817322731018,0.0912567526102066
7659827,5706362,4220415,12458,8041,1998,1706,1980,4417,10752,0.0,0.0,18,13.0,7,1,56,3437.0,0.41415277123451233,0.19368106126785278
7660623,5160337,5160523,12458,6151,1992,6151,1992,6307,6307,0.5,0.0,46,5.0,4,6,7,1603.0,0.25499552488327026,0.11964783072471619
7660880,7426642,4129468,12458,11947,2008,1076,1978,511,11382,0.0,0.0,2,32.0,5,3,210,889.0,0.45399290323257446,0.09819146245718002
re41104,7030934,4160946,12458,11065,2006,1286,1979,1393,11172,1.0,0.0,5,5.0,10,1,21,1078.0,0.4020203649997711,0.09428183734416962
7659776,7253837,5756764,12458,11541,2007,8181,1998,917,4277,0.0,0.0,1,21.0,2,3,917,49.0,0.2915937900543213,0.06712983548641205
7662175,6955677,6351855,12465,10883,2005,9560,2002,1582,2905,1.0,0.0,14,2.0,11,16,42,1946.0,0.4529109299182892,0.34217649698257446
7662869,5322440,4450226,12465,6746,1994,3064,1984,5719,9401,0.3333333333333333,0.0,13,7.0,18,5,182,4242.0,0.3300812244415283,0.30220431089401245
7664607,5310610,4944023,12465,6704,1994,5318,1990,5761,7147,0.0,0.0,5,6.0,9,4,3129,98.0,0.3115636706352234,0.22213172912597656
7662179,4720286,6177441,12465,4401,1988,9154,2001,8064,3311,1.0,1.0,54,4.0,4,21,147,14.0,0.5410025119781494,0.12263355404138565
7666278,7033460,4598913,12472,11072,2006,3841,1986,1400,8631,1.0,0.0,4,4.0,14,2,287,763.0,0.4560505151748657,0.29694831371307373
7666029,7410363,6897495,12472,11912,2008,10736,2005,560,1736,0.0,0.0,2,5.0,4,17,175,154.0,0.6439600586891174,0.15760882198810577
7666164,5304152,6511720,12472,6683,1994,9889,2003,5789,2583,1.0,0.0,46,1.0,11,3,77,2583.0,0.28401368856430054,0.12471771240234375
7666907,6986901,4170826,12472,10974,2006,1384,1979,1498,11088,0.0,0.0,2,26.0,28,1,217,567.0,0.33754977583885193,0.0698670893907547
7667086,4919896,5373123,12472,5227,1990,6921,1994,7245,5551,0.0,0.0,4,11.0,6,9,161,1414.0,0.4181849956512451,-0.10333473980426788
7665731,7451983,4342856,12472,12010,2008,2406,1982,462,10066,0.5,0.0,1,3.0,1,3,462,8813.0,0.5341939330101013,0.05281424894928932
7666198,5242457,5967890,12472,6459,1993,8692,1999,6013,3780,1.0,0.0,112,8.0,7,2,0,1323.0,0.3969312310218811,0.3810829520225525
7667768,6151067,7321277,12472,9091,2000,11709,2008,3381,763,1.0,0.0,12,1.0,7,3,819,763.0,0.4817999005317688,0.26227399706840515
7672530,6037976,3990070,12479,8839,2000,306,1976,3640,12173,0.0,0.0,8,18.0,21,1,28,3143.0,0.5003402829170227,0.12214779853820801
7669454,4354374,4250367,12479,2483,1982,1867,1981,9996,10612,1.0,0.0,19,12.0,3,1,147,1197.0,0.402327299118042,0.3757702708244324
7669351,6994532,6942249,12479,10995,2006,10848,2005,1484,1631,0.0,0.0,1,4.0,8,59,1484,42.0,0.35797393321990967,0.1810467541217804
7670377,5669909,4847471,12479,7936,1997,4940,1989,4543,7539,1.0,0.0,202,4.0,15,6,14,2905.0,0.5707971453666687,0.10359109193086624
7670329,5554114,5660009,12479,7558,1996,7908,1997,4921,4571,1.0,0.0,47,8.0,25,1,210,2261.0,0.5446605086326599,0.12300751358270645
7672368,5946349,7259283,12479,8643,1999,11555,2007,3836,924,0.0,0.0,15,2.0,1,1,210,546.0,0.4421900808811188,0.09491335600614548
7674232,5840020,4427510,12486,8363,1998,2945,1984,4123,9541,1.0,0.0,126,4.0,6,1,14,7189.0,0.23286950588226318,0.09736138582229614
7675227,5798536,6108759,12486,8272,1998,9000,2000,4214,3486,1.0,0.0,49,2.0,2,27,63,126.0,0.3490331470966339,0.18298529088497162
7674259,6210404,5454462,12486,9224,2001,7215,1995,3262,5271,1.0,0.0,5,2.0,7,8,259,1792.0,0.36205145716667175,0.030789468437433243
7674178,6409602,5548654,12486,9672,2002,7537,1996,2814,4949,0.5,0.0,61,14.0,46,5,0,497.0,0.472199410200119,0.32401758432388306
7674769,4683195,6544862,12486,4226,1987,9959,2003,8260,2527,0.25,0.0,1861,12.0,1,76,0,371.0,0.0066161067225039005,0.04788808524608612
7676429,6641050,5324932,12486,10169,2003,6753,1994,2317,5733,1.0,0.0,50,2.0,14,6,0,2485.0,0.42865341901779175,0.23313768208026886
7677026,5755092,4544677,12493,8181,1998,3561,1985,4312,8932,1.0,0.0,11,30.0,7,2,518,1113.0,0.6340412497520447,0.25614723563194275
7678097,4386622,6441784,12493,2714,1983,9735,2002,9779,2758,1.0,0.0,18,6.0,5,2,266,189.0,0.3348197638988495,0.07563554495573044
7676910,5795299,5476693,12493,8265,1998,7292,1995,4228,5201,0.0,0.0,18,4.0,30,2,42,2016.0,0.34157225489616394,0.12434440851211548
7677444,6572013,4673191,12493,10015,2003,4184,1987,2478,8309,1.0,0.0,11,5.0,8,6,63,4074.0,0.43112844228744507,0.12881086766719818
7680399,5966499,7037116,12493,8685,1999,11079,2006,3808,1414,0.0,0.0,27,3.0,14,6,0,644.0,0.7547844052314758,0.22453683614730835
7678129,6267776,5346883,12493,9343,2001,6830,1994,3150,5663,1.0,0.0,65,3.0,50,2,28,1211.0,0.46547648310661316,0.09498076885938644
7684981,5946043,7034510,12500,8643,1999,11072,2006,3857,1428,0.0,0.0,96,1.0,5,14,7,1428.0,0.3788931667804718,0.06275098025798798
7682318,6973706,7048082,12500,10939,2005,11100,2006,1561,1400,0.0,0.0,22,8.0,208,18,14,98.0,0.3562391698360443,0.08403724431991577
7684866,5411540,4177387,12500,7061,1995,1433,1979,5439,11067,1.0,0.0,61,7.0,1,3,14,2065.0,0.597650408744812,0.2641918659210205
7681647,5377756,4157185,12500,6942,1995,1251,1979,5558,11249,1.0,0.0,100,2.0,7,1,7,8050.0,0.33451390266418457,0.052292875945568085
7682375,6585769,5513922,12500,10043,2003,7432,1996,2457,5068,1.0,0.0,24,5.0,41,6,14,49.0,0.5961113572120667,0.21535176038742065
7684247,5814853,5406780,12500,8307,1998,7047,1995,4193,5453,0.0,0.0,97,9.0,10,3,21,1428.0,0.464328795671463,0.10079603642225266
7685237,7194542,4490436,12500,11401,2007,3281,1984,1099,9219,0.5,0.0,1,14.0,12,3,1099,1050.0,0.43129801750183105,0.10881742835044861
7684371,6574270,5459123,12500,10015,2003,7229,1995,2485,5271,1.0,0.0,31,25.0,5,1,42,231.0,0.32826969027519226,0.0672747790813446
7681562,4674467,4008548,12500,4191,1987,418,1977,8309,12082,1.0,0.0,3,22.0,8,1,4102,42.0,0.5989975929260254,0.026158936321735382
7685613,5587854,6366108,12500,7663,1996,9588,2002,4837,2912,0.3333333333333333,0.0,41,6.0,12,4,0,721.0,0.4549559950828552,0.15197208523750305
7687059,6020196,6803543,12507,8797,2000,10512,2004,3710,1995,0.0,0.0,11,1.0,23,3,63,1995.0,0.5263693332672119,0.1435905545949936
7685847,5881576,5611455,12507,8475,1999,7747,1997,4032,4760,1.0,0.0,3,6.0,2,4,1708,595.0,0.45139801502227783,0.2817811369895935
7689476,4901887,7522514,12507,5164,1990,12164,2009,7343,343,0.0,0.0,49,3.0,5,8,35,84.0,0.5204322338104248,0.0951787531375885
7687156,6290438,6949310,12507,9392,2001,10862,2005,3115,1645,0.0,0.0,8,1.0,9,2,175,1645.0,0.2637875974178314,0.07622665911912918
7689440,5633910,4379814,12507,7817,1997,2658,1983,4690,9849,0.0,0.0,80,9.0,29,1,7,1533.0,0.5271602869033813,0.031977515667676926
7692063,6004555,6925636,12514,8755,1999,10806,2005,3759,1708,0.0,0.0,40,2.0,26,5,0,756.0,0.25839152932167053,0.12446008622646332
7693559,5991648,5842216,12514,8727,1999,8363,1998,3787,4151,1.0,0.0,35,30.0,3,8,7,651.0,0.41720154881477356,0.18287885189056396
7693721,6658117,6095883,12514,10197,2003,8979,2000,2317,3535,0.0,0.0,6,1.0,4,6,91,3535.0,0.3671346604824066,-0.0038472602609544992
7691912,6303046,4190153,12514,9420,2001,1517,1980,3094,10997,0.5,0.0,15,14.0,14,1,168,1792.0,0.5354728698730469,0.23542533814907074
7696269,4375988,4071732,12521,2623,1983,761,1978,9898,11760,0.5,0.0,5,7.0,3,1,14,2219.0,0.5645989179611206,0.1745743751525879
7694981,6767019,5887585,12521,10435,2004,8489,1999,2086,4032,1.0,0.0,5,7.0,29,14,70,1421.0,0.6140585541725159,0.2035384476184845
7694474,4918761,4789885,12521,5227,1990,4723,1988,7294,7798,0.0,0.0,19,5.0,18,5,35,2163.0,0.4205763638019562,0.24128417670726776
7698060,6188316,3988031,12521,9175,2001,299,1976,3346,12222,0.0,0.0,29,17.0,8,1,28,7.0,0.12826019525527954,0.13993069529533386
7698225,5157663,5330243,12521,6137,1992,6774,1994,6384,5747,1.0,0.0,252,9.0,6,1,21,119.0,0.3640775680541992,0.1766817718744278
7696905,5889492,4169763,12521,8489,1999,1370,1979,4032,11151,1.0,0.0,14,13.0,13,2,196,112.0,0.40861380100250244,0.20973250269889832
7701079,5502368,3987342,12528,7390,1996,292,1976,5138,12236,0.0,0.0,34,7.0,39,2,238,1246.0,0.45997491478919983,0.2968977093696594
7700451,5897365,4519289,12528,8517,1999,3435,1985,4011,9093,1.0,0.0,12,7.0,4,2,1274,1582.0,0.27454105019569397,0.17310400307178497
7701219,5986455,5471551,12528,8720,1999,7271,1995,3808,5257,1.0,0.0,29,7.0,10,10,196,1316.0,0.5698745250701904,0.22738541662693024
7699919,6749675,4410717,12528,10393,2004,2847,1983,2135,9681,1.0,0.0,11,2.0,9,4,315,8974.0,0.5859320163726807,0.29146528244018555
7698834,4586209,4130610,12528,3778,1986,1083,1978,8750,11445,1.0,0.0,10,5.0,3,1,567,10472.0,0.4909479320049286,0.11187781393527985
7701665,6005737,4308641,12528,8755,1999,2196,1982,3773,10332,1.0,0.0,21,4.0,2,1,91,56.0,0.4834687113761902,0.22291648387908936
7703636,5085138,4987462,12535,5878,1992,5500,1991,6657,7035,0.0,0.0,21,42.0,7,3,140,168.0,0.614267885684967,0.08370216190814972
re41283,5882214,4215254,12535,8475,1999,1671,1980,4060,10864,1.0,1.0,14,15.0,25,2,112,616.0,0.33794155716896057,0.17736202478408813
7707514,6484261,4775342,12535,9819,2002,4660,1988,2716,7875,1.0,0.0,171,13.0,1,2,7,567.0,0.17370323836803436,0.12812475860118866
7703346,4527678,4012556,12535,3477,1985,439,1977,9058,12096,1.0,0.0,72,4.0,3,1,35,6454.0,0.4544753432273865,0.22087362408638
7704787,6437383,4584740,12535,9728,2002,3771,1986,2807,8764,1.0,0.0,148,6.0,2,4,7,112.0,0.7641992568969727,0.18408875167369843
7707259,5790790,5055134,12535,8251,1998,5759,1991,4284,6776,1.0,0.0,322,6.0,8,4,0,1274.0,0.3670211732387543,0.19186009466648102
7706176,7339817,5001167,12535,11751,2008,5556,1991,784,6979,1.0,0.0,1,16.0,17,1,784,812.0,0.35780996084213257,0.03992176800966263
7706889,5774357,6857213,12535,8216,1998,10645,2005,4319,1890,0.0,0.0,148,5.0,60,3,0,70.0,0.2695067524909973,0.17671507596969604
7703652,7097086,6262072,12535,11198,2006,9329,2001,1337,3206,1.0,0.0,5,1.0,21,5,35,3206.0,0.5679511427879333,-0.02679392136633396
7707427,6295361,4807408,12535,9399,2001,4807,1989,3136,7728,1.0,0.0,46,2.0,2,6,0,4494.0,0.2511259615421295,0.1270521581172943
7705913,7239353,7114099,12535,11506,2007,11226,2006,1029,1309,1.0,0.0,2,3.0,25,2,28,84.0,0.43878671526908875,0.2892751395702362
7711271,6081360,5253453,12542,8944,2000,6501,1993,3598,6041,1.0,0.0,50,3.0,3,6,21,2247.0,0.47576919198036194,0.20649178326129913
7711926,4432056,4971880,12542,2966,1984,5437,1990,9576,7105,1.0,0.0,7,13.0,11,12,406,1533.0,0.4146178662776947,0.18844196200370789
7708735,4128099,4520913,12542,1069,1978,3442,1985,11473,9100,1.0,0.0,79,4.0,1,3,35,6629.0,0.3805186450481415,0.34829026460647583
7710423,5872566,5680417,12542,8447,1999,7964,1997,4095,4578,1.0,0.0,25,4.0,13,4,49,1470.0,0.36299213767051697,-0.0854656994342804
7710081,5081368,4189754,12542,5857,1992,1510,1980,6685,11032,0.3333333333333333,0.0,15,7.0,1,7,749,5222.0,0.4537266492843628,0.10486941039562225
7712049,5563996,5102872,12542,7586,1996,5941,1992,4956,6601,0.0,0.0,47,15.0,13,7,7,42.0,0.39982372522354126,0.027572819963097572
7716444,6799268,6537421,12549,10498,2004,9945,2003,2051,2604,1.0,0.0,78,6.0,3,6,42,35.0,0.3132094144821167,0.22494401037693024
7715799,5590417,4429353,12549,7670,1996,2952,1984,4879,9597,1.0,0.0,81,5.0,24,1,14,3059.0,0.5397275686264038,0.02380877174437046
7712350,5633453,7315040,12549,7817,1997,11688,2008,4732,861,1.0,1.0,6,2.0,24,6,154,595.0,0.3449210226535797,0.3013187050819397
7712527,7044222,5327002,12549,11093,2006,6760,1994,1456,5789,1.0,0.0,4,7.0,17,3,364,238.0,0.5632783770561218,0.1704632192850113
7721129,6233690,4601900,12556,9266,2001,3855,1986,3290,8701,1.0,0.0,4,5.0,17,7,1092,3157.0,0.585848331451416,0.0303763747215271
7717365,6364420,4008548,12556,9588,2002,418,1977,2968,12138,0.0,0.0,31,23.0,6,1,7,14.0,0.1386057585477829,0.2132258266210556
7717171,4623401,4762028,12556,3974,1986,4604,1988,8582,7952,0.0,0.0,108,12.0,5,1,21,21.0,0.3539269268512726,0.24727466702461243
7720746,6119945,4470119,12556,9028,2000,3169,1984,3528,9387,1.0,0.5,37,35.0,12,5,35,1344.0,0.4170103073120117,0.117564357817173
7721010,6292428,4827841,12556,9392,2001,4877,1989,3164,7679,0.0,0.0,14,10.0,5,8,42,7.0,0.3933568298816681,0.21400907635688782
7720541,5522862,4757354,12556,7460,1996,4576,1988,5096,7980,1.0,0.0,42,17.0,31,2,14,63.0,0.5662885904312134,-0.013408706523478031
7721273,6788980,6672017,12556,10477,2004,10232,2004,2079,2324,0.5,0.0,54,5.0,290,6,0,161.0,0.39928334951400757,0.12328764796257019
7724496,6456481,5699156,12563,9763,2002,8020,1997,2800,4543,1.0,0.0,49,11.0,25,9,28,532.0,0.43394625186920166,0.12811633944511414
7724468,6608733,6287164,12563,10092,2003,9385,2001,2471,3178,1.0,0.0,14,1.0,16,18,385,3178.0,0.25794047117233276,0.0659705325961113
7721958,6584309,5121697,12563,10036,2003,6011,1992,2527,6552,0.0,0.0,37,8.0,20,4,7,70.0,0.625227689743042,0.12961506843566895
7722934,6872759,4780155,12563,10680,2005,4681,1988,1883,7882,0.0,0.0,1,4.0,5,2,1883,1470.0,0.7431617379188538,0.24025192856788635
7724666,5483526,6911763,12563,7313,1996,10771,2005,5250,1792,1.0,0.0,78,4.0,6,21,378,812.0,0.29575762152671814,0.13660871982574463
7723116,5260764,5627439,12563,6522,1993,7796,1997,6041,4767,0.5,0.0,39,1.0,5,7,14,4767.0,0.4247966408729553,0.16215229034423828
7724173,7049984,5517915,12563,11100,2006,7446,1996,1463,5117,1.0,0.0,11,4.0,8,8,0,2156.0,0.6304893493652344,0.13722440600395203
7724892,4885773,6964388,12563,5087,1989,10911,2005,7476,1652,1.0,0.0,15,3.0,9,6,196,42.0,0.30758848786354065,0.1604667752981186
7729490,5937402,4606933,12570,8622,1999,3883,1986,3948,8687,0.0,0.0,56,18.0,42,3,7,1183.0,0.21973171830177307,0.06719834357500076
7728732,4796074,7193607,12570,4751,1989,11401,2007,7819,1169,0.0,0.0,82,1.0,5,37,42,1169.0,0.1483166664838791,0.2811067998409271
7730215,5812776,5316661,12570,8300,1998,6725,1994,4270,5845,1.0,0.0,233,2.0,12,18,0,3878.0,0.413659930229187,0.05360456183552742
7729793,5373451,4882285,12570,6921,1994,5073,1989,5649,7497,1.0,0.0,11,1.0,3,2,84,7497.0,0.5683910846710205,0.009797015227377415
7734744,5408614,4611604,12577,7047,1995,3911,1986,5530,8666,1.0,0.0,69,9.0,8,6,938,665.0,0.38654825091362,0.050986576825380325
7731717,7255694,6600501,12577,11548,2007,10071,2003,1029,2506,1.0,0.0,8,5.0,379,7,14,84.0,0.6475828886032104,0.1623629480600357
7734888,6862661,4640060,12577,10652,2005,4051,1987,1925,8526,1.0,0.0,3,16.0,8,1,392,196.0,0.43243494629859924,0.2045900970697403
7734058,7142225,6420486,12577,11289,2006,9693,2002,1288,2884,0.3333333333333333,0.0,6,22.0,3,13,91,21.0,0.4133240878582001,0.1778729259967804
7733793,6038231,5389391,12577,8839,2000,6984,1995,3738,5593,0.5,0.0,24,12.0,9,7,35,238.0,0.5510067939758301,0.2113998830318451
7732112,6444386,5408026,12577,9742,2002,7047,1995,2835,5530,1.0,0.0,14,4.0,11,15,147,658.0,0.5725716948509216,0.18317218124866486
7737830,5987381,4566218,12584,8720,1999,3680,1986,3864,8904,0.0,0.0,91,16.0,15,2,21,1554.0,0.4483118951320648,0.19389086961746216
7737718,6624702,4351036,12584,10127,2003,2455,1982,2457,10129,0.0,0.0,27,12.0,42,4,49,371.0,0.47408515214920044,0.19325727224349976
7735331,5953207,4450855,12584,8657,1999,3071,1984,3927,9513,0.3333333333333333,0.0,2,11.0,5,1,609,2380.0,0.47444063425064087,0.29799792170524597
7738274,6778435,5808260,12584,10456,2004,8293,1998,2128,4291,1.0,0.0,8,10.0,2,1,21,49.0,0.5690813660621643,0.15669958293437958
7739768,5491863,6018305,12591,7355,1996,8790,2000,5236,3801,0.0,0.0,28,18.0,4,4,336,371.0,0.33894315361976624,0.2173730581998825
7742645,6118900,6491486,12591,9021,2000,9840,2002,3570,2751,0.5,0.0,6,1.0,11,5,336,2751.0,0.42352619767189026,0.09174564480781555
7741161,6130473,4152586,12591,9049,2000,1216,1979,3542,11375,1.0,0.0,132,35.0,5,2,28,3150.0,0.6598648428916931,0.3002175986766815
7740640,5634936,5364057,12591,7824,1997,6893,1994,4767,5698,1.0,0.0,181,6.0,26,7,7,595.0,0.6373716592788696,0.4080161452293396
7743085,6091263,4971904,12591,8965,2000,5437,1990,3626,7154,0.5,0.0,125,8.0,6,6,7,63.0,0.4281608760356903,0.1909061074256897
7739923,5594175,6145271,12591,7684,1997,9084,2000,4907,3507,1.0,0.0,15,6.0,8,6,392,1148.0,0.5214976668357849,0.3603113293647766
7743336,6734864,4059530,12591,10358,2004,691,1977,2233,11900,1.0,0.0,11,3.0,61,1,56,910.0,0.13416336476802826,0.1666620522737503
7743119,6188695,4732818,12591,9175,2001,4464,1988,3416,8127,0.0,0.0,11,2.0,5,17,21,189.0,0.4232945442199707,0.1248873770236969
7740979,7232628,6654303,12591,11492,2007,10190,2003,1099,2401,1.0,0.0,1,7.0,5,2,1099,294.0,0.7269691228866577,0.20293420553207397
7740657,6203572,7510942,12591,9210,2001,12143,2009,3381,448,1.0,0.0,15,1.0,19,4,14,448.0,0.5066583156585693,0.3290306031703949
7740548,6773365,4146642,12591,10449,2004,1181,1979,2142,11410,1.0,0.0,1,4.0,5,1,2142,5635.0,0.6807560324668884,0.13035628199577332
7741689,5352886,4475227,12591,6851,1994,3197,1984,5740,9394,1.0,0.0,57,36.0,1,3,14,21.0,0.3358856439590454,0.10686745494604111
7743543,5813158,6782120,12598,8307,1998,10463,2004,4291,2135,1.0,0.0,6,8.0,5,7,742,63.0,0.43380433320999146,0.06208048760890961
7744622,5907664,7051045,12598,8545,1999,11100,2006,4053,1498,1.0,0.0,159,3.0,10,26,0,77.0,0.5857564806938171,0.26665765047073364
7744791,5844023,7382350,12598,8370,1998,11842,2008,4228,756,0.0,0.0,47,2.0,4,5,63,308.0,0.29057371616363525,0.03197427839040756
7748033,6654699,5297803,12598,10190,2003,6662,1994,2408,5936,1.0,0.0,7,17.0,11,2,203,357.0,0.41864168643951416,0.09960482269525528
7743448,6003187,5159386,12598,8755,1999,6144,1992,3843,6454,0.0,0.0,6,5.0,17,7,7,5264.0,0.4973672032356262,0.12623873353004456
7744808,6334884,7538503,12598,9497,2002,12199,2009,3101,399,1.0,0.0,4,1.0,3,7,203,399.0,0.5550389885902405,0.04902100935578346
7746548,6798567,4340756,12598,10498,2004,2392,1982,2100,10206,0.0,0.0,12,4.0,12,3,189,308.0,0.6155158281326294,-0.040777284651994705
7745291,6404009,5563012,12598,9658,2002,7586,1996,2940,5012,1.0,0.0,9,11.0,4,4,259,14.0,0.6454130411148071,0.2704150676727295
7747661,6724554,4133697,12598,10337,2004,1104,1979,2261,11494,0.0,0.0,4,20.0,77,2,203,1841.0,0.3699895739555359,0.20989444851875305
7748431,5072767,4428607,12605,5829,1991,2952,1984,6776,9653,0.0,0.0,8,6.0,2,1,2737,1946.0,0.562599778175354,0.38887283205986023
7751096,4926253,6123963,12605,5248,1990,9035,2000,7357,3570,1.0,0.0,9,2.0,6,2,539,1666.0,0.49108487367630005,0.1150144636631012
7749831,7364960,4429760,12605,11807,2008,2959,1984,798,9646,1.0,0.0,4,10.0,7,1,84,371.0,1.0,0.03122725896537304
7750292,5536939,4715102,12605,7502,1996,4380,1987,5103,8225,0.5,0.0,74,3.0,3,5,56,2863.0,0.5548955798149109,0.23489733040332794
7748553,4850493,7240067,12605,4954,1989,11506,2007,7651,1099,1.0,0.0,29,5.0,7,60,21,42.0,0.5034818053245544,0.115329310297966
7751953,6505106,6001103,12605,9868,2003,8748,1999,2737,3857,0.3333333333333333,0.0,70,3.0,18,18,7,2583.0,0.46633484959602356,0.19367364048957825
7748620,4870503,4076424,12605,5017,1989,789,1978,7588,11816,0.0,0.0,48,9.0,7,1,14,3850.0,0.39302071928977966,0.25286513566970825
7751035,6323951,4771924,12605,9462,2001,4646,1988,3143,7959,0.5,0.0,38,1.0,4,1,56,7959.0,0.5161504149436951,0.24706560373306274
7751402,6272616,6242582,12605,9350,2001,9287,2001,3255,3318,0.0,0.0,76,4.0,12,3,14,1120.0,0.47539928555488586,0.06052428483963013
7750876,6760254,6524387,12605,10414,2004,9917,2003,2191,2688,0.0,0.0,2,1.0,3,21,462,2688.0,0.44302788376808167,0.3832987844944
7751595,5991408,7100943,12605,8727,1999,11205,2006,3878,1400,0.0,0.0,38,1.0,12,12,7,1400.0,0.46443501114845276,-0.08130963146686554
7751482,6011596,4626349,12605,8769,2000,3988,1986,3836,8617,1.0,0.0,50,2.0,5,4,21,6524.0,0.5659599900245667,0.04812897369265556
7754119,4380570,4478974,12612,2665,1983,3218,1984,9947,9394,0.0,0.0,70,15.0,3,4,14,280.0,0.28995898365974426,0.3579612970352173
7753908,5868362,4940111,12612,8440,1999,5304,1990,4172,7308,0.0,0.0,12,6.0,3,3,833,196.0,0.38114213943481445,0.2263985574245453
7756904,6594653,4953023,12612,10057,2003,5353,1990,2555,7259,1.0,0.0,21,20.0,12,6,14,7.0,0.4950218200683594,0.16186487674713135
7754450,5457187,6549153,12612,7222,1995,9966,2003,5390,2646,0.0,0.0,62,3.0,1,15,7,2030.0,0.1598842442035675,0.060539066791534424
7753606,5860753,5387444,12612,8419,1999,6977,1995,4193,5635,1.0,0.0,14,7.0,7,10,756,553.0,0.47920921444892883,0.184299498796463
7752852,6096965,5177344,12612,8979,2000,6214,1993,3633,6398,0.0,0.0,10,13.0,2,28,931,42.0,0.48319000005722046,0.3220408260822296
7758554,4392858,7033913,12619,2749,1983,11072,2006,9870,1547,1.0,0.0,49,4.0,7,5,7,28.0,0.5789452791213989,0.21853220462799072
7760905,5594469,7057691,12619,7684,1997,11114,2006,4935,1505,0.0,0.0,75,3.0,3,23,21,413.0,0.22551296651363373,0.19125959277153015
7761890,4611227,7219295,12619,3904,1986,11457,2007,8715,1162,0.5,0.0,23,2.0,7,1,14,42.0,0.5835229754447937,0.3162030279636383
7758882,5981619,4091618,12619,8713,1999,880,1978,3906,11739,0.3333333333333333,0.0,11,12.0,2,1,63,70.0,0.5474392771720886,0.14658699929714203
7761652,6522586,4682588,12619,9910,2003,4226,1987,2709,8393,0.0,0.0,15,57.0,62,4,224,196.0,0.7144393920898438,0.19333937764167786
7761537,7146575,6434412,12619,11296,2006,9721,2002,1323,2898,1.0,0.0,2,5.0,2,9,602,588.0,0.5327858328819275,0.0702299177646637
7757611,4690072,4541767,12619,4261,1987,3547,1985,8358,9072,1.0,0.0,25,3.0,2,1,84,4130.0,0.47070837020874023,0.42750105261802673
7758514,4532935,6000713,12619,3505,1985,8748,1999,9114,3871,0.5,0.0,25,10.0,11,2,140,1330.0,0.4560201168060303,0.2586648762226105
7758518,4441510,4395508,12619,3022,1984,2763,1983,9597,9856,0.0,0.0,7,9.0,1,5,0,1953.0,0.3431673049926758,0.1354067176580429
7757823,5257673,4927906,12619,6515,1993,5255,1990,6104,7364,0.0,0.0,9,3.0,5,5,392,6643.0,0.5734595060348511,-0.0191922876983881
7762047,4495751,4535770,12626,3316,1985,3519,1985,9310,9107,1.0,0.0,16,17.0,1,3,1225,903.0,0.5143306851387024,0.298647403717041
7762341,6505682,5796460,12626,9875,2003,8265,1998,2751,4361,1.0,0.0,22,8.0,7,1,84,525.0,0.558775007724762,0.23965826630592346
7762269,5186728,5904644,12626,6256,1993,8538,1999,6370,4088,0.0,0.0,4,4.0,13,5,175,1960.0,0.36943182349205017,0.3672553300857544
7764027,6407511,5146895,12626,9665,2002,6102,1992,2961,6524,1.0,0.0,2,6.0,12,6,1330,448.0,0.5126925706863403,0.18117642402648926
7763041,5366462,4426392,12626,6900,1994,2938,1984,5726,9688,1.0,1.0,209,4.0,9,1,0,4081.0,0.43795156478881836,0.10336281359195709
7762927,5226864,6144072,12626,6403,1993,9077,2000,6223,3549,1.0,0.0,23,16.0,5,6,133,42.0,0.4985465407371521,0.027747951447963715
7764560,6031781,6521397,12626,8825,2000,9910,2003,3801,2716,1.0,0.0,12,2.0,3,7,49,2464.0,0.33483514189720154,0.09071696549654007
7765024,5422821,6323906,12626,7096,1995,9462,2001,5530,3164,0.0,0.0,53,5.0,12,5,42,133.0,0.6437195539474487,0.33853596448898315
7766210,5503320,5531487,12633,7397,1996,7488,1996,5236,5145,1.0,0.0,88,1.0,71,1,0,5145.0,0.49566835165023804,0.29340773820877075
7767165,4726812,4247797,12633,4436,1988,1853,1981,8197,10780,0.0,0.0,37,10.0,2,3,70,2842.0,0.5113042593002319,0.1426055133342743
7766741,5674128,5779576,12633,7950,1997,8230,1998,4683,4403,1.0,1.0,153,29.0,29,5,14,112.0,0.3561193346977234,0.3191458582878113
7768135,6339255,4452079,12633,9511,2002,3078,1984,3122,9555,1.0,0.0,93,9.0,13,3,56,189.0,0.6215085387229919,0.19620747864246368
7766209,6264086,4187969,12633,9336,2001,1503,1980,3297,11130,1.0,0.0,90,6.0,38,1,14,6993.0,0.42368271946907043,0.3179469406604767
7767756,6846940,4878198,12633,10617,2005,5052,1989,2016,7581,0.0,0.0,4,6.0,1,7,56,210.0,0.3604234755039215,0.039920587092638016
7767781,5288837,6696110,12633,6627,1994,10281,2004,6006,2352,1.0,0.0,29,3.0,16,1,28,1029.0,0.45204052329063416,0.2054990977048874
7769588,6615170,4030792,12633,10106,2003,537,1977,2527,12096,1.0,0.0,15,21.0,7,1,14,7.0,0.5266897678375244,0.3555555045604706
7768635,6479832,5981682,12633,9812,2002,8713,1999,2821,3920,1.0,0.0,1,2.0,6,6,2821,322.0,0.6328112483024597,0.3644687831401825
7768379,5276311,4172925,12633,6578,1994,1398,1979,6055,11235,1.0,0.0,211,12.0,11,7,0,28.0,0.4434029459953308,0.05517888069152832
7771283,6364779,4577619,12640,9588,2002,3736,1986,3052,8904,1.0,0.0,6,15.0,16,10,168,196.0,0.6021034121513367,0.17996469140052795
7770350,5860267,5257512,12640,8419,1999,6515,1993,4221,6125,1.0,0.0,135,4.0,5,5,21,2555.0,0.5351144671440125,0.2211516797542572
7774809,4413339,6167520,12640,2861,1983,9126,2000,9779,3514,0.5,1.0,82,11.0,10,25,7,7.0,0.24408026039600372,0.3571276366710663
7771445,4754755,5293707,12640,4569,1988,6648,1994,8071,5992,1.0,0.0,39,9.0,8,7,567,847.0,0.43992337584495544,0.355182021856308
7770693,6783835,4046203,12640,10470,2004,614,1977,2170,12026,0.0,0.0,2,15.0,4,1,721,595.0,0.3792606294155121,0.2462153434753418
7772161,4704213,4675025,12640,4324,1987,4191,1987,8316,8449,0.5,0.0,25,2.0,25,9,49,6979.0,0.5672757029533386,0.2709145247936249
7774237,4799156,6328702,12640,4765,1989,9476,2001,7875,3164,1.0,0.0,885,1.0,7,30,0,3164.0,0.29451555013656616,0.11304637044668198
7771302,6849011,5361526,12640,10624,2005,6886,1994,2016,5754,0.5,0.0,3,6.0,8,13,1183,700.0,0.4709959030151367,0.3307938873767853
7775025,6044637,5594270,12647,8860,2000,7684,1997,3787,4963,1.0,0.0,13,7.0,3,1,217,2226.0,0.4960551857948303,0.19939754903316498
7777120,5905222,7261701,12647,8538,1999,11562,2007,4109,1085,1.0,0.0,7,1.0,5,49,0,1085.0,0.4236263632774353,0.103095144033432
7779027,6088708,5158105,12647,8958,2000,6144,1992,3689,6503,1.0,0.0,91,12.0,2,9,7,294.0,0.11881940811872482,0.051992468535900116
7777197,6793114,5442230,12647,10491,2004,7166,1995,2156,5481,0.0,0.0,6,16.0,14,2,119,56.0,0.281545490026474,0.3739776909351349
7776243,4968463,4313656,12647,5423,1990,2224,1982,7224,10423,0.5,0.0,112,4.0,3,1,49,3017.0,0.5630925893783569,0.16911226511001587
7780151,5983642,7455040,12654,8720,1999,12017,2008,3934,637,1.0,0.0,32,1.0,17,12,7,637.0,0.6636268496513367,0.33359435200691223
7783040,5707288,4791845,12654,8048,1998,4737,1988,4606,7917,0.3333333333333333,0.0,11,9.0,46,2,210,392.0,0.42712774872779846,-0.0005359724746085703
7782590,5815362,5333765,12654,8307,1998,6788,1994,4347,5866,1.0,0.0,17,1.0,3,4,56,5866.0,0.48298653960227966,0.17681358754634857
7780628,6595959,5861921,12654,10064,2003,8419,1999,2590,4235,1.0,0.0,13,7.0,25,7,14,1449.0,0.5387907028198242,0.15325883030891418
7780116,6019316,4554959,12654,8797,2000,3617,1985,3857,9037,1.0,0.0,3,2.0,2,3,266,8617.0,0.34022387862205505,0.20132943987846375
7779841,5345930,7376364,12654,6830,1994,11828,2008,5824,826,0.3333333333333333,0.0,8,1.0,8,6,1071,826.0,0.5948739647865295,0.3007112741470337
7780514,5818026,6700050,12654,8314,1998,10288,2004,4340,2366,0.0,0.0,25,4.0,3,2,21,336.0,0.5522831678390503,0.24158763885498047
7784082,4011414,7448432,12654,432,1977,12003,2008,12222,651,1.0,0.0,19,1.0,1,15,0,651.0,0.47943955659866333,0.27882131934165955
7784107,6219063,6518909,12654,9238,2001,9903,2003,3416,2751,0.0,0.0,6,13.0,4,8,1316,84.0,0.3878805935382843,0.33501702547073364
7787474,7376125,4666450,12661,11828,2008,4156,1987,833,8505,0.5,0.0,23,9.0,89,2,14,28.0,0.40313947200775146,0.10725712776184082
7788332,5771374,6598828,12661,8209,1998,10071,2003,4452,2590,1.0,0.0,13,4.0,5,18,315,490.0,0.4325726628303528,0.29190436005592346
7785338,5324303,7332035,12661,6753,1994,11737,2008,5908,924,1.0,0.0,82,1.0,20,24,7,924.0,0.6092635989189148,0.2249724119901657
7787946,6258039,7009327,12661,9322,2001,11023,2006,3339,1638,1.0,0.0,11,4.0,4,5,21,133.0,0.48855483531951904,0.23110832273960114
7786658,7131886,5381239,12661,11268,2006,6949,1995,1393,5712,1.0,0.0,2,3.0,21,5,7,2170.0,0.19508928060531616,0.16493059694766998
7785962,6962846,5840252,12661,10904,2005,8363,1998,1757,4298,0.5,0.0,4,7.0,10,19,42,224.0,0.6138542890548706,0.2753344178199768
7785336,5997528,4197390,12661,8741,1999,1559,1980,3920,11102,1.0,0.0,7,15.0,81,2,574,2933.0,0.48211732506752014,0.10132624953985214
7784695,5288985,4797921,12661,6627,1994,4758,1989,6034,7903,1.0,0.0,121,15.0,24,2,14,322.0,0.36037757992744446,0.24070985615253448
7788287,6711585,5023781,12661,10309,2004,5640,1991,2352,7021,1.0,1.0,109,5.0,31,4,0,1512.0,0.38578808307647705,0.06306435912847519
7786662,5652474,4098480,12661,7880,1997,915,1978,4781,11746,1.0,0.0,10,26.0,2,1,231,546.0,0.3729478716850281,0.16531281173229218
7787882,7561881,6385429,12661,12248,2009,9623,2002,413,3038,1.0,0.0,6,4.0,156,24,7,1176.0,0.5454166531562805,0.11855760961771011
7793268,7152229,6441928,12668,11310,2006,9735,2002,1358,2933,1.0,0.0,13,4.0,4,5,14,56.0,0.3854025900363922,0.22792164981365204
7789969,6810887,6062697,12668,10533,2004,8902,2000,2135,3766,1.0,0.0,12,14.0,3,13,56,21.0,0.7174386978149414,0.008689909242093563
7792562,7651596,6488433,12668,12444,2010,9833,2002,224,2835,0.5,0.0,1,2.0,118,12,224,42.0,0.6544262170791626,0.032141003757715225
7789531,7335920,4271584,12668,11744,2008,1986,1981,924,10682,0.0,0.0,2,2.0,11,2,28,854.0,0.5922971963882446,0.4873911142349243
7793220,6029175,6820351,12668,8818,2000,10554,2004,3850,2114,1.0,0.0,280,3.0,23,12,7,112.0,0.28996798396110535,0.252232164144516
7792488,5625624,4397229,12668,7789,1997,2777,1983,4879,9891,1.0,0.0,56,9.0,8,3,133,4144.0,0.356352299451828,0.10446993261575699
7791181,5897338,4530970,12668,8517,1999,3491,1985,4151,9177,1.0,0.0,89,21.0,2,1,7,399.0,0.5219969153404236,0.24231092631816864
7789083,7195017,4809809,12668,11408,2007,4814,1989,1260,7854,1.0,0.0,11,3.0,6,5,56,6727.0,0.6895391345024109,0.3845326006412506
7792876,6330073,7473169,12668,9476,2001,12059,2009,3192,609,0.5,0.0,11,1.0,3,17,315,609.0,0.4052044451236725,0.310150682926178
7791860,7295423,5317947,12668,11639,2007,6732,1994,1029,5936,1.0,0.0,5,8.0,70,4,105,126.0,0.4426415264606476,0.1797589212656021
7794101,6837590,7095638,12675,10596,2005,11191,2006,2079,1484,1.0,0.0,6,1.0,8,10,294,1484.0,0.5028695464134216,0.4333628714084625
7793967,6527292,5007418,12675,9924,2003,5584,1991,2751,7091,0.0,0.0,20,5.0,7,17,14,665.0,0.531125009059906,0.19838717579841614
7797119,6308092,5025211,12675,9427,2001,5647,1991,3248,7028,0.0,0.5,24,9.0,7,5,0,2597.0,0.27237287163734436,0.16436082124710083
7793841,5784102,4723062,12675,8237,1998,4415,1988,4438,8260,0.0,0.0,155,2.0,11,4,7,5033.0,0.37977439165115356,0.31777042150497437
7801207,5241541,7561066,12682,6452,1993,12248,2009,6230,434,0.0,0.0,31,1.0,6,7,35,434.0,0.4757857024669647,0.3865702748298645
7798147,6312407,7333194,12682,9441,2001,11737,2008,3241,945,1.0,0.0,55,1.0,83,5,42,945.0,0.3809853196144104,0.20127904415130615
7798675,6222623,4036007,12682,9245,2001,565,1977,3437,12117,0.0,0.0,27,4.0,19,2,49,4039.0,0.42091283202171326,0.23879627883434296
7801745,5136647,4275794,12682,6060,1992,2007,1981,6622,10675,0.0,0.0,205,2.0,3,2,7,9240.0,0.3129027485847473,0.15574637055397034
7798695,5467208,6931156,12682,7257,1995,10820,2005,5425,1862,0.0,0.0,111,1.0,15,5,28,1862.0,0.3308599889278412,0.23028536140918732
7802082,6934956,5118383,12682,10827,2005,5997,1992,1855,6685,0.5,0.0,6,10.0,8,7,98,434.0,0.7115199565887451,0.05270034074783325
7803447,6773580,4979628,12689,10449,2004,5472,1990,2240,7217,0.0,0.0,2,5.0,15,8,84,56.0,0.2749875783920288,0.33338579535484314
7803156,6755827,5147228,12689,10407,2004,6102,1992,2282,6587,1.0,0.0,41,12.0,41,4,14,525.0,0.6005271673202515,0.3538479208946228
7802712,4592354,5222104,12689,3806,1986,6382,1993,8883,6307,1.0,0.0,108,19.0,5,4,21,420.0,0.5821604132652283,0.29195424914360046
7803638,4434150,4946401,12689,2980,1984,5332,1990,9709,7357,0.5,0.0,49,9.0,14,8,42,868.0,0.49923232197761536,0.17602327466011047
7805372,5813006,4427779,12689,8300,1998,2945,1984,4389,9744,0.5,0.0,74,14.0,13,5,21,784.0,0.26405760645866394,0.04363233968615532
7802426,7322377,5466523,12689,11716,2008,7257,1995,973,5432,0.2,0.0,1,5.0,5,3,973,231.0,0.40303757786750793,0.08293917030096054
7806892,6258029,5160368,12696,9322,2001,6151,1992,3374,6545,1.0,0.0,6,14.0,6,1,0,168.0,0.4619813859462738,0.16269047558307648
7808728,7068929,4406854,12696,11135,2006,2826,1983,1561,9870,0.0,0.0,8,14.0,59,3,217,2716.0,0.7035359144210815,0.26428571343421936
7807372,5514785,5897410,12696,7432,1996,8517,1999,5264,4179,0.3333333333333333,0.0,122,7.0,2,2,7,21.0,0.564171552658081,0.12940900027751923
7809663,6389124,6417263,12696,9630,2002,9686,2002,3066,3010,0.0,0.0,79,4.0,8,2,14,609.0,0.20605680346488953,0.20525147020816803
7808980,5909483,5515465,12696,8552,1999,7432,1996,4144,5264,1.0,0.0,49,6.0,6,5,119,3780.0,0.4059802293777466,0.2802606225013733
7807652,7468431,4240016,12696,12045,2008,1811,1980,651,10885,0.6666666666666666,0.0,1,12.0,198,2,651,1176.0,1.0,0.029169470071792603
7805992,6918404,5032593,12696,10792,2005,5675,1991,1904,7021,0.0,0.0,125,16.0,56,4,7,28.0,0.2784614861011505,0.18050731718540192
7812221,5593503,4902482,12703,7684,1997,5164,1990,5019,7539,0.25,0.0,22,10.0,3,3,91,546.0,0.38487955927848816,0.0706322118639946
7811409,5819434,4617371,12703,8321,1998,3939,1986,4382,8764,0.0,0.0,23,20.0,1,6,42,2380.0,0.28453171253204346,-0.03240108862519264
7811170,5680160,6158831,12703,7964,1997,9112,2000,4739,3591,0.0,0.0,28,7.0,8,20,28,518.0,0.46968844532966614,0.2482796013355255
7812369,5290393,4667468,12703,6634,1994,4163,1987,6069,8540,0.0,0.0,160,10.0,6,9,28,581.0,0.24530600011348724,0.16102436184883118
7810988,5968268,5677515,12703,8692,1999,7957,1997,4011,4746,0.0,0.0,22,18.0,3,9,21,42.0,0.48627007007598877,0.04696366935968399
7811314,5807404,6789216,12703,8293,1998,10477,2004,4410,2226,1.0,0.0,173,12.0,9,5,14,35.0,0.5647452473640442,0.05881233513355255
7817888,6184987,7118576,12710,9168,2001,11240,2006,3542,1470,0.0,0.0,21,3.0,1,12,35,119.0,0.32288724184036255,0.20856232941150665
7815113,6161760,4170458,12710,9119,2000,1377,1979,3591,11333,1.0,0.0,135,8.0,13,1,7,2086.0,0.3999156951904297,0.3218177855014801
7816572,5510089,7425982,12710,7418,1996,11947,2008,5292,763,0.0,0.0,6,2.0,12,3,1078,497.0,0.4825441241264343,0.16089855134487152
7817855,6738512,5297803,12710,10365,2004,6662,1994,2345,6048,1.0,0.0,6,18.0,6,2,98,35.0,0.3830581605434418,0.1883717030286789
7815656,6843795,4656412,12710,10610,2005,4114,1987,2100,8596,1.0,0.0,2,7.0,100,1,1330,1785.0,0.6432414054870605,0.148588627576828
7816122,5354692,4805785,12710,6858,1994,4800,1989,5852,7910,0.0,0.0,80,7.0,82,6,49,3255.0,0.549087405204773,0.19037967920303345
7814696,4643071,4936586,12710,4065,1987,5290,1990,8645,7420,1.0,0.0,9,24.0,3,2,1778,28.0,0.510954737663269,0.22299405932426453
7818253,6004681,6711894,12710,8755,1999,10316,2004,3955,2394,0.0,0.0,55,1.0,4,8,14,2394.0,0.13000215590000153,0.20758533477783203
7815627,4748982,6021974,12710,4541,1988,8804,2000,8169,3906,1.0,0.0,474,3.0,2,11,0,1260.0,0.5930055379867554,0.35308194160461426
7818137,7397259,5374267,12710,11877,2008,6928,1994,833,5782,1.0,0.0,1,28.0,2,7,833,112.0,0.7389011383056641,0.13866138458251953
7822379,6381442,5524021,12717,9616,2002,7460,1996,3101,5257,0.5,0.0,6,9.0,5,8,1204,315.0,0.806531548500061,0.17188118398189545
7822544,7099772,6161215,12717,11198,2006,9112,2000,1519,3605,0.5,0.0,1,18.0,7,5,1519,112.0,0.49570173025131226,0.19021299481391907
7823066,5805806,4520815,12717,8286,1998,3442,1985,4431,9275,1.0,0.0,58,21.0,4,3,0,147.0,0.3588048219680786,0.16427655518054962
7821900,7649825,5499229,12717,12437,2010,7376,1996,280,5341,1.0,1.0,1,25.0,9,7,280,882.0,0.4195597767829895,0.48531249165534973
7819863,5769843,4625962,12717,8209,1998,3988,1986,4508,8729,1.0,0.0,133,26.0,36,7,7,70.0,0.40866804122924805,0.16397128999233246
7820983,5545531,4219974,12717,7530,1996,1706,1980,5187,11011,0.0,0.0,219,9.0,6,2,28,3745.0,0.4065825343132019,0.20217928290367126
7822401,5896347,5213046,12717,8510,1999,6354,1993,4207,6363,0.0,0.0,65,7.0,6,4,77,2961.0,0.3236398994922638,0.1829845905303955
7819734,4593904,5829189,12717,3813,1986,8342,1998,8904,4375,0.0,0.0,141,6.0,7,3,49,861.0,0.7210896611213684,0.16961288452148438
7823055,6363380,5782160,12717,9581,2002,8237,1998,3136,4480,1.0,0.0,43,5.0,11,6,49,973.0,0.6183712482452393,0.13997569680213928
7820543,5466635,5193357,12717,7257,1995,6284,1993,5460,6433,1.0,0.0,23,16.0,11,12,28,126.0,0.5200721621513367,0.06777328997850418
7826817,5737035,5243986,12724,8132,1998,6466,1993,4592,6258,0.0,0.0,222,4.0,4,16,7,1386.0,0.39142364263534546,0.14857302606105804
7826074,6108453,5426113,12724,9000,2000,7110,1995,3724,5614,1.0,0.0,45,4.0,1,4,14,238.0,0.1296788901090622,0.007813769392669201
7827281,5251294,4322331,12724,6487,1993,2280,1982,6237,10444,1.0,0.0,76,12.0,4,2,42,2611.0,0.43630117177963257,0.14587722718715668
7823714,7172062,4681454,12724,11359,2007,4219,1987,1365,8505,1.0,0.0,3,8.0,8,4,56,126.0,0.8587879538536072,0.23567244410514832
7825312,5591927,5849363,12724,7677,1997,8384,1998,5047,4340,1.0,0.0,13,6.0,9,25,28,7.0,0.666000485420227,0.21625474095344543
7823847,6554242,6619380,12724,9980,2003,10120,2003,2744,2604,0.0,0.5,30,5.0,7,9,49,301.0,0.5272663831710815,0.20028726756572723
7823660,4407378,6745981,12724,2833,1983,10386,2004,9891,2338,1.0,0.0,51,1.0,6,6,140,2338.0,0.37975379824638367,0.19647473096847534
7829705,5112825,5539014,12731,5976,1992,7509,1996,6755,5222,0.5,0.0,7,17.0,11,9,441,2443.0,0.4568037688732147,0.31574389338493347
re41914,4670690,4493471,12731,4170,1987,3302,1985,8561,9429,0.0,0.0,19,16.0,2,3,56,91.0,0.38096073269844055,0.25430944561958313
7828791,5217001,4553904,12731,6368,1993,3610,1985,6363,9121,1.0,0.0,74,12.0,6,4,21,644.0,0.4572909474372864,0.24899499118328094
7830809,5740159,5911628,12731,8139,1998,8566,1999,4592,4165,1.0,0.0,17,4.0,5,8,294,2387.0,0.3135720491409302,0.25009486079216003
7828501,6893199,5710145,12731,10729,2005,8055,1998,2002,4676,1.0,0.0,3,4.0,9,3,77,567.0,0.4167681336402893,0.16085779666900635
7828208,4837822,5668440,12731,4905,1989,7929,1997,7826,4802,0.0,0.0,38,8.0,15,4,182,931.0,0.3970940411090851,0.16100390255451202
7827709,6826856,5023374,12731,10568,2004,5640,1991,2163,7091,1.0,0.0,4,20.0,19,1,490,497.0,0.6144424676895142,0.01681707240641117
7835598,7405829,4669888,12738,11898,2008,4170,1987,840,8568,0.5,0.0,6,1.0,4,2,77,8568.0,0.4612465798854828,0.21002499759197235
7833171,6726818,4872843,12738,10344,2004,5031,1989,2394,7707,0.0,0.0,41,14.0,5,5,21,2786.0,0.37985339760780334,0.17773401737213135
7832612,6755338,4854778,12738,10407,2004,4968,1989,2331,7770,1.0,0.0,103,9.0,127,8,0,4214.0,0.42088329792022705,0.16362375020980835
7835169,6956760,6081842,12738,10883,2005,8944,2000,1855,3794,1.0,0.0,1,18.0,7,9,1855,56.0,0.45055824518203735,0.2357195019721985
7836322,7007176,4369992,12738,11016,2006,2581,1983,1722,10157,1.0,0.0,44,13.0,14,3,0,350.0,0.5575259327888489,0.18846963346004486
7837690,5390683,5006602,12745,6991,1995,5577,1991,5754,7168,1.0,0.0,217,5.0,18,1,7,1386.0,0.4599587619304657,0.2336050122976303
7836800,6170364,5152636,12745,9140,2001,6123,1992,3605,6622,1.0,0.0,11,6.0,8,6,168,168.0,0.32727137207984924,0.1362842470407486
7839860,5541919,4623493,12745,7516,1996,3974,1986,5229,8771,0.5,0.0,99,8.0,7,1,63,686.0,0.378457635641098,0.4118058979511261
7839889,5592530,4595102,12745,7677,1997,3820,1986,5068,8925,1.0,0.0,118,42.0,6,6,21,224.0,0.3686300814151764,0.03371727839112282
7839037,6713913,4472546,12745,10316,2004,3183,1984,2429,9562,1.0,0.0,5,7.0,3,4,875,2933.0,0.48850858211517334,0.14547789096832275
7837205,6540240,4166562,12745,9952,2003,1342,1979,2793,11403,1.0,0.0,13,7.0,8,3,70,1785.0,0.6724007725715637,0.1747869849205017
7837319,6910764,4654303,12745,10771,2005,4107,1987,1974,8638,1.0,0.0,3,6.0,6,1,175,3990.0,0.6097402572631836,0.09773673117160797
7842247,5907399,5851625,12752,8545,1999,8391,1998,4207,4361,0.3333333333333333,0.0,9,3.0,6,3,280,511.0,0.33391353487968445,0.18759587407112122
7843871,6195705,5280759,12752,9189,2001,6599,1994,3563,6153,0.0,0.0,268,6.0,12,5,7,252.0,0.4684031307697296,0.21405917406082153
7841408,4860544,5240084,12752,4989,1989,6452,1993,7763,6300,0.0,0.0,216,10.0,8,2,0,203.0,0.35921844840049744,0.19077391922473907
7844313,6061584,4925861,12752,8895,2000,5248,1990,3857,7504,1.0,0.5,45,8.0,29,1,28,4837.0,0.5256593823432922,0.10960490256547928
7843437,6104334,6518364,12752,8993,2000,9903,2003,3759,2849,0.0,0.0,165,15.0,39,4,7,49.0,0.2295946478843689,0.14857886731624603
7846169,6755843,6367096,12759,10407,2004,9595,2002,2352,3164,1.0,0.0,43,10.0,7,2,0,301.0,0.7399094700813293,0.21081724762916565
7847517,6883715,5949169,12759,10708,2005,8650,1999,2051,4109,0.0,1.0,39,2.0,6,3,70,182.0,0.5040698647499084,0.22401651740074158
7846210,7479160,5754476,12759,12073,2009,8174,1998,686,4585,1.0,0.0,6,2.0,45,12,14,63.0,0.601498007774353,0.18260101974010468
7846235,6432533,4433068,12759,9721,2002,2973,1984,3038,9786,0.0,0.0,1,9.0,7,3,3038,2702.0,0.7015286087989807,0.30610495805740356
7849134,6642860,5503297,12759,10169,2003,7397,1996,2590,5362,0.5,0.0,9,33.0,11,23,693,98.0,0.4057266116142273,0.33813679218292236
7846008,6986705,7014702,12759,10974,2006,11037,2006,1785,1722,1.0,0.0,8,4.0,11,3,7,154.0,0.5392488241195679,0.18593959510326385
7849191,7191244,6906589,12759,11394,2007,10757,2005,1365,2002,1.0,0.0,19,2.0,62,2,0,1190.0,0.49422112107276917,0.05205324664711952
7847266,7279686,7026429,12759,11604,2007,11058,2006,1155,1701,0.0,0.0,1,3.0,28,2,1155,147.0,0.48139482736587524,0.029633790254592896
7845559,5489771,4221925,12759,7341,1996,1713,1980,5418,11046,0.0,0.0,119,13.0,3,1,7,63.0,0.433552086353302,0.3094494044780731
7848422,5602593,7493839,12759,7712,1997,12108,2009,5047,651,1.0,0.0,20,1.0,3,32,0,651.0,0.5547665357589722,0.19383077323436737
7846096,6183469,6313549,12759,9168,2001,9441,2001,3591,3318,1.0,0.0,106,4.0,102,19,35,77.0,0.31645309925079346,0.13230444490909576
7847773,5903249,4007148,12759,8531,1999,404,1977,4228,12355,1.0,0.0,44,5.0,15,1,42,4025.0,0.6217261552810669,0.15491946041584015
7847318,5296649,4208760,12759,6655,1994,1636,1980,6104,11123,0.5,0.0,31,16.0,7,2,0,469.0,0.13804985582828522,0.10367578268051147
7845098,5347933,4436529,12759,6837,1994,2994,1984,5922,9765,1.0,0.0,1,5.0,8,4,5922,4039.0,0.6092672348022461,0.11488623172044754
7850027,4779722,4396476,12766,4681,1988,2770,1983,8085,9996,0.0,0.5,29,53.0,1,5,49,665.0,0.5089647173881531,0.12055910378694534
7853329,6094598,4047165,12766,8972,2000,614,1977,3794,12152,1.0,0.0,64,10.0,26,1,14,4424.0,0.531785249710083,0.23129060864448547
7851595,5948889,4668452,12766,8650,1999,4163,1987,4116,8603,0.5,0.0,5,15.0,7,3,483,1008.0,0.12933604419231415,-0.11383962631225586
7853840,6876564,5283890,12766,10687,2005,6606,1994,2079,6160,0.3333333333333333,0.3333333333333333,2,13.0,3,7,1610,2541.0,0.4387612044811249,0.48911139369010925
7850876,6689477,5368236,12766,10267,2004,6907,1994,2499,5859,0.0,0.0,4,2.0,2,5,756,3871.0,0.6199590563774109,0.16513070464134216
7852114,6921575,5223406,12766,10799,2005,6389,1993,1967,6377,0.0,0.0,42,4.0,1,1,7,28.0,0.17222844064235687,0.05466212332248688
7850620,5885226,7253892,12766,8482,1999,11541,2007,4284,1225,1.0,0.0,22,1.0,2,24,35,1225.0,0.7045875191688538,0.11341389268636703
7854833,5374348,4908952,12773,6928,1994,5192,1990,5845,7581,0.5,0.0,13,3.0,11,1,42,56.0,0.5583482384681702,0.11573971062898636
7856138,6440759,4522041,12773,9735,2002,3449,1985,3038,9324,0.0,0.0,2,28.0,7,1,1001,203.0,0.3996686041355133,0.04703459143638611
7856207,4857727,4323022,12773,4975,1989,2287,1982,7798,10486,0.0,0.0,20,8.0,2,5,42,3962.0,0.2342451959848404,0.21499694883823395
7855740,6476865,4089088,12773,9805,2002,866,1978,2968,11907,1.0,0.0,13,15.0,8,1,28,2947.0,0.5838582515716553,0.16174225509166718
7857826,5800525,5266138,12780,8279,1998,6543,1993,4501,6237,1.0,0.0,211,3.0,8,1,14,1204.0,0.43399903178215027,0.13635626435279846
7857539,4512709,7264724,12780,3400,1985,11569,2007,9380,1211,0.0,0.0,40,1.0,4,5,63,1211.0,0.4567091763019562,0.26279154419898987
7861165,7210099,4735142,12780,11436,2007,4478,1988,1344,8302,1.0,0.0,10,10.0,7,2,105,1155.0,0.4401499032974243,0.3848164975643158
7858082,5917021,5115948,12780,8580,1999,5990,1992,4200,6790,1.0,0.0,6,12.0,13,3,175,399.0,0.6330307126045227,0.25271138548851013
7858998,7262912,6348666,12780,11562,2007,9546,2002,1218,3234,0.0,1.0,7,3.0,12,3,42,448.0,0.40558555722236633,0.2204906940460205
7859098,6232152,6635830,12780,9266,2001,10155,2003,3514,2625,1.0,0.0,41,3.0,38,24,182,987.0,0.5842222571372986,0.1797654777765274
7857580,7004720,5246150,12780,11016,2006,6473,1993,1764,6307,1.0,0.0,4,3.0,9,7,154,553.0,0.6407024264335632,0.2891586720943451
7860404,4561119,4648031,12780,3645,1985,4079,1987,9135,8701,1.0,0.0,62,21.0,1,2,77,56.0,0.5292699337005615,0.15270297229290009
7858038,6758824,4920322,12780,10414,2004,5227,1990,2366,7553,1.0,0.0,41,5.0,84,1,7,1197.0,0.3643190860748291,0.21753917634487152
7858854,7629511,4988699,12780,12395,2009,5507,1991,385,7273,0.3333333333333333,0.25,1,3.0,2,5,385,189.0,0.4633033573627472,0.021956810727715492
7861263,5225902,6670081,12780,6396,1993,10225,2003,6384,2555,0.5,0.0,103,7.0,24,21,0,7.0,0.46564799547195435,0.20653484761714935
7862605,5108424,5602228,12787,5962,1992,7712,1997,6825,5075,1.0,0.0,140,3.0,3,5,28,2695.0,0.4483696222305298,0.14574597775936127
7865224,6836679,5143380,12787,10589,2004,6088,1992,2198,6699,1.0,0.0,42,2.0,65,12,112,5488.0,0.6224216818809509,0.1834493726491928
7862183,6014259,4003388,12787,8776,2000,383,1977,4011,12404,0.0,0.0,41,18.0,12,1,259,1435.0,0.45429715514183044,0.19254064559936523
7863797,6066906,6419786,12787,8909,2000,9693,2002,3878,3094,1.0,0.0,36,3.0,2,2,21,1176.0,0.43172553181648254,0.15089932084083557
7862596,6344042,4522345,12787,9532,2002,3449,1985,3255,9338,1.0,0.0,3,2.0,3,4,441,2394.0,0.5167436003684998,0.2383885234594345
7864399,4671619,5167745,12787,4177,1987,6179,1992,8610,6608,1.0,0.0,66,5.0,4,7,7,910.0,0.37390565872192383,0.33073753118515015
7862596,6123709,6260519,12787,9035,2000,9329,2001,3752,3458,1.0,0.0,38,26.0,45,115,7,98.0,0.49270257353782654,0.19067741930484772
7869249,6297170,6638081,12794,9406,2001,10162,2003,3388,2632,0.0,0.0,177,2.0,24,10,7,1708.0,0.2898506224155426,0.23753619194030762
7868588,5642260,5487183,12794,7845,1997,7327,1996,4949,5467,0.0,0.0,18,4.0,1,6,112,2499.0,0.6136507391929626,0.020203396677970886
7869740,6912365,4114059,12794,10771,2005,985,1978,2023,11809,1.0,0.0,9,17.0,13,4,14,364.0,0.7271356582641602,0.3402456045150757
7866332,5062871,4499239,12794,5787,1991,3330,1985,7007,9464,0.0,0.0,23,15.0,12,8,77,609.0,0.3494582176208496,0.25132307410240173
7866681,4677263,4569720,12794,4198,1987,3694,1986,8596,9100,0.0,0.0,18,6.0,4,1,259,483.0,0.3490278422832489,0.13438422977924347
7866385,4823890,4573833,12794,4863,1989,3715,1986,7931,9079,0.0,0.0,79,8.0,3,1,14,1001.0,0.2231743186712265,0.21642611920833588
7867084,5394547,4896129,12794,6998,1995,5136,1990,5796,7658,1.0,0.0,51,11.0,10,3,28,336.0,0.2585289776325226,0.1284709870815277
7869582,6308083,4076424,12794,9427,2001,789,1978,3367,12005,1.0,0.0,40,9.0,11,1,0,4039.0,0.46403244137763977,0.24900677800178528
7867537,4560569,4493232,12794,3645,1985,3302,1985,9149,9492,0.0,0.0,33,10.0,5,3,77,1799.0,0.47233378887176514,0.04478491097688675
7872603,6018699,5616959,12801,8790,2000,7761,1997,4011,5040,0.0,0.0,80,36.0,12,18,7,161.0,0.3390572667121887,0.09086053818464279
7872700,5132819,5677498,12801,6046,1992,7957,1997,6755,4844,1.0,1.0,46,7.0,4,14,168,1351.0,0.7186371684074402,0.1500861644744873
7874612,6411874,4889310,12808,9672,2002,5108,1989,3136,7700,0.0,0.0,36,11.0,22,13,63,21.0,0.2609553635120392,0.3122325539588928
7874758,4989298,4399338,12808,5514,1991,2784,1983,7294,10024,1.0,0.0,2,13.0,3,1,5194,392.0,0.44021856784820557,0.25603246688842773
7876767,7142094,6177069,12808,11289,2006,9154,2001,1519,3654,1.0,0.0,24,3.0,4,5,35,1995.0,0.5343775153160095,0.13447998464107513
7875068,6849086,5507969,12808,10624,2005,7411,1996,2184,5397,1.0,0.0,6,8.0,58,5,231,1568.0,0.539574921131134,0.101859912276268
7877127,5167230,7350615,12808,6179,1992,11779,2008,6629,1029,1.0,0.0,45,1.0,13,2,0,1029.0,0.5651775598526001,0.15119734406471252
7876438,6664121,6081722,12808,10211,2003,8944,2000,2597,3864,0.5,0.0,16,4.0,5,2,42,2324.0,0.5679320096969604,0.1083599403500557
7879245,6413432,5186286,12815,9679,2002,6256,1993,3136,6559,1.0,0.0,2,5.0,2,4,714,686.0,0.5411198139190674,0.10717124491930008
7880371,4330730,4005259,12815,2329,1982,390,1977,10486,12425,1.0,0.5,40,19.0,1,1,21,2786.0,0.38022473454475403,0.3095757067203522
7881181,5243598,4625962,12815,6459,1993,3988,1986,6356,8827,1.0,0.0,114,26.0,3,7,0,168.0,0.5930042862892151,0.17074565589427948
7881966,6231435,4148101,12815,9266,2001,1188,1979,3549,11627,0.0,0.0,40,2.0,4,1,63,6531.0,0.4861081540584564,0.21957698464393616
7879097,5171280,4232921,12815,6193,1992,1776,1980,6622,11039,1.0,0.0,208,10.0,1,1,14,84.0,0.3846168518066406,0.23852023482322693
7877929,6887385,4450639,12815,10715,2005,3071,1984,2100,9744,0.0,0.0,4,31.0,25,5,707,273.0,0.42747044563293457,0.13845372200012207
7880614,7170415,4585144,12815,11352,2007,3771,1986,1463,9044,0.3333333333333333,0.0,10,15.0,5,5,7,49.0,0.6106967329978943,0.15561172366142273
7882660,4094110,5767789,12822,894,1978,8202,1998,11928,4620,1.0,0.0,30,33.0,1,6,154,28.0,0.4709809124469757,0.187142476439476
7884180,4552803,4170458,12822,3603,1985,1377,1979,9219,11445,0.0,0.0,14,8.0,1,1,259,2198.0,0.05488736927509308,0.12623576819896698
7886206,5072178,5652382,12822,5822,1991,7880,1997,7000,4942,0.0,0.0,62,7.0,5,6,14,707.0,0.5585384964942932,0.13684344291687012
7885699,6310110,5285005,12822,9434,2001,6613,1994,3388,6209,0.0,0.0,40,4.0,15,1,0,1071.0,0.2965201139450073,0.10973358899354935
7886176,5924115,4694319,12822,8594,1999,4275,1987,4228,8547,1.0,0.0,12,2.0,12,2,91,6790.0,0.2876032590866089,0.28062552213668823
7883986,5883006,6074712,12822,8475,1999,8930,2000,4347,3892,1.0,0.0,49,3.0,14,3,154,910.0,0.46612784266471863,0.1203809455037117
7886906,4829999,4497285,12829,4884,1989,3323,1985,7945,9506,0.0,0.0,19,12.0,2,5,119,273.0,0.3871734142303467,0.16989028453826904
7887505,6363609,5488004,12829,9588,2002,7334,1996,3241,5495,0.0,0.0,8,27.0,4,9,1169,70.0,0.2847073972225189,0.10109803080558777
7887173,6053608,4394857,12829,8881,2000,2763,1983,3948,10066,1.0,0.0,51,1.0,7,2,7,10066.0,0.5485110282897949,0.2027396261692047
7887579,5514154,5049549,12829,7432,1996,5738,1991,5397,7091,1.0,0.5,413,6.0,6,8,0,3745.0,0.6944631338119507,0.10018211603164673
7887238,6177172,4320751,12829,9154,2001,2273,1982,3675,10556,0.0,0.0,20,14.0,67,2,0,2331.0,0.2811804711818695,0.29155227541923523
7887689,7455757,4705542,12829,12017,2008,4331,1987,812,8498,1.0,0.0,3,7.0,28,5,147,70.0,0.6407708525657654,0.11323871463537216
7889163,5745281,4575613,12829,8153,1998,3722,1986,4676,9107,0.0,0.0,219,2.0,3,5,7,7042.0,0.33727261424064636,0.1668758988380432
7887536,5722421,4309524,12829,8097,1998,2196,1982,4732,10633,1.0,0.0,75,5.0,2,2,0,6349.0,0.4604579508304596,0.19031499326229095
7886626,7155994,6169748,12829,11324,2007,9133,2001,1505,3696,1.0,0.0,8,7.0,8,31,217,49.0,0.5365670919418335,0.21283042430877686
7894521,6496980,4705229,12836,9847,2002,4331,1987,2989,8505,1.0,0.0,54,6.0,4,4,7,203.0,0.41887181997299194,0.22315742075443268
7891304,6450105,4779202,12836,9756,2002,4674,1988,3080,8162,1.0,0.0,8,4.0,5,6,252,84.0,0.42908671498298645,0.35677453875541687
7894254,7277317,4144780,12836,11597,2007,1174,1979,1239,11662,1.0,0.0,46,2.0,5,1,0,224.0,0.42307019233703613,0.150722935795784
7894326,6320911,5322728,12836,9455,2001,6746,1994,3381,6090,1.0,0.0,3,14.0,7,10,1512,21.0,0.4806332290172577,0.051545966416597366
7891233,6062085,6550109,12836,8902,2000,9973,2003,3934,2863,1.0,0.0,4,1.0,3,2,469,2863.0,0.5351480841636658,0.2061113566160202
7893296,6734324,5528133,12836,10358,2004,7474,1996,2478,5362,1.0,0.0,2,5.0,2,15,2051,3003.0,0.5150442719459534,0.20190048217773438
7894660,7109483,4017818,12836,11219,2006,467,1977,1617,12369,0.0,0.0,22,3.0,21,1,7,2702.0,0.23802311718463898,0.12434381246566772
7895624,5851149,5091693,12836,8391,1998,5899,1992,4445,6937,0.0,0.0,240,9.0,38,6,0,77.0,0.2397860437631607,0.04537131264805794
7892107,5820482,6180032,12836,8321,1998,9161,2001,4515,3675,1.0,0.0,3,10.0,8,22,4200,154.0,0.23179224133491516,0.1469581574201584
7897492,5754299,5993226,12843,8174,1998,8734,1999,4669,4109,0.0,1.0,36,3.0,6,2,140,3339.0,0.19682522118091583,0.22890284657478333
7898416,6920088,6899302,12843,10792,2005,10743,2005,2051,2100,0.0,0.0,4,8.0,9,9,63,238.0,0.2846725881099701,0.20213834941387177
7897008,5808310,7344838,12843,8293,1998,11765,2008,4550,1078,0.0,0.0,8,2.0,4,1,21,112.0,0.3174492120742798,0.0403301939368248
7898571,5040068,5836391,12843,5703,1991,8356,1998,7140,4487,1.0,0.0,80,9.0,17,1,70,21.0,0.5287793874740601,0.12545472383499146
7897914,6230557,5554013,12843,9266,2001,7558,1996,3577,5285,0.5,0.0,88,25.0,22,20,14,133.0,0.6657554507255554,0.26810434460639954
7897020,6690041,6058276,12843,10267,2004,8888,2000,2576,3955,0.0,0.0,6,4.0,14,5,182,2506.0,0.4374361038208008,0.23177659511566162
re42174,6143049,5502292,12843,9077,2000,7390,1996,3766,5453,1.0,0.0,20,13.0,56,10,161,217.0,0.4128340482711792,0.2381921112537384
7899959,6347398,3987474,12843,9539,2002,292,1976,3304,12551,1.0,0.0,232,6.0,55,2,21,8022.0,0.5510389804840088,0.21140865981578827
7901016,5506308,7278164,12850,7404,1996,11597,2007,5446,1253,0.0,0.0,4,3.0,8,7,2905,28.0,0.37062719464302063,0.07070962339639664
7901292,5573402,6117951,12850,7621,1996,9021,2000,5229,3829,0.0,0.0,37,7.0,16,5,119,245.0,0.3515276610851288,0.04020886868238449
7904178,4161952,5039247,12850,1300,1979,5703,1991,11550,7147,1.0,1.0,119,25.0,3,6,0,210.0,0.5772987604141235,0.2983595132827759
7904790,5475693,5491642,12850,7285,1995,7348,1996,5565,5502,0.0,0.0,93,26.0,2,18,7,371.0,0.6391188502311707,0.21408706903457642
7901423,6423073,6559668,12850,9700,2002,9987,2003,3150,2863,1.0,0.0,14,7.0,24,32,49,413.0,0.44442978501319885,0.27543389797210693
7902018,6297595,4021385,12850,9406,2001,488,1977,3444,12362,1.0,0.0,32,24.0,63,1,105,35.0,0.42675572633743286,0.12107500433921814
7902229,7122547,6960762,12850,11247,2006,10897,2005,1603,1953,1.0,0.0,8,3.0,2,1,7,336.0,0.6344163417816162,0.14440716803073883
7908152,5642936,6472062,12857,7852,1997,9798,2002,5005,3059,0.0,0.0,72,3.0,2,5,7,42.0,0.1451312154531479,0.07340876013040543
7906014,6962466,6958952,12857,10904,2005,10890,2005,1953,1967,0.0,0.0,3,4.0,51,7,70,1316.0,0.42192527651786804,0.04117313399910927
7908571,6170080,4298947,12857,9133,2001,2133,1981,3724,10724,1.0,0.0,24,10.0,16,4,56,84.0,0.6477830410003662,0.28893834352493286
7905880,4311145,7475660,12857,2210,1982,12066,2009,10647,791,1.0,0.0,125,1.0,7,6,14,791.0,0.4533608853816986,0.27288442850112915
7905923,5954767,7534835,12857,8664,1999,12192,2009,4193,665,1.0,0.0,58,1.0,16,10,42,665.0,0.36991143226623535,0.26891154050827026
7905812,5370013,5445963,12857,6914,1994,7180,1995,5943,5677,0.0,0.0,35,4.0,7,5,672,1442.0,0.30774039030075073,0.26146945357322693
7905840,4892105,5365084,12857,5122,1990,6893,1994,7735,5964,1.0,0.0,39,29.0,8,11,21,21.0,0.34333860874176025,0.22580808401107788
7907940,7240049,5749018,12857,11506,2007,8160,1998,1351,4697,0.0,0.0,21,2.0,10,6,14,3269.0,0.25894635915756226,0.3199130892753601
7907944,6449461,5477917,12857,9749,2002,7299,1995,3108,5558,1.0,0.0,84,20.0,9,36,0,189.0,0.47594359517097473,-0.03395870700478554
7909956,4880102,6689245,12864,5066,1989,10267,2004,7798,2597,0.0,0.5,27,10.0,6,9,77,21.0,0.21425126492977142,0.21914458274841309
7908738,5566441,5243528,12864,7600,1996,6459,1993,5264,6405,1.0,0.0,174,17.0,10,25,21,7.0,0.4850848317146301,0.10619034618139267
7913297,5955667,5186987,12864,8664,1999,6256,1993,4200,6608,0.0,0.0,93,19.0,5,6,0,28.0,0.30634790658950806,0.13449297845363617
7911904,7428202,5785251,12864,11954,2008,8244,1998,910,4620,1.0,0.0,3,13.0,2,6,161,2667.0,0.6954193711280823,0.14450740814208984
7909778,5897493,5915030,12864,8517,1999,8573,1999,4347,4291,0.5,0.0,222,5.0,4,10,0,1568.0,0.25974607467651367,0.1779293715953827
7909117,5332049,4956775,12864,6781,1994,5367,1990,6083,7497,1.0,0.0,166,20.0,16,7,35,70.0,0.5311192274093628,0.12514986097812653
7909202,6003205,6792836,12864,8755,1999,10491,2004,4109,2373,0.0,0.0,4,3.0,6,8,294,945.0,0.6840012669563293,0.32921215891838074
7912170,6198786,5442230,12864,9196,2001,7166,1995,3668,5698,1.0,0.0,7,16.0,3,2,56,273.0,0.4628002643585205,0.14244939386844635
7909165,6165161,4038599,12864,9126,2000,572,1977,3738,12292,0.0,0.0,11,44.0,94,1,224,21.0,0.516668975353241,0.11601152271032333
7912064,5423002,4844216,12864,7096,1995,4933,1989,5768,7931,0.5,0.0,148,16.0,23,7,49,2002.0,0.3547343611717224,0.1296183466911316
7911353,5736927,5503712,12864,8132,1998,7397,1996,4732,5467,1.0,0.0,40,8.0,4,11,427,371.0,0.42999380826950073,0.05543546378612518
7909114,7325273,6631219,12864,11723,2008,10141,2003,1141,2723,0.0,0.0,1,1.0,7,12,1141,2723.0,0.4806842803955078,0.034816205501556396
7913955,5743490,6744484,12871,8153,1998,10379,2004,4718,2492,1.0,0.0,43,4.0,10,9,35,112.0,0.44536662101745605,0.379976361989975
7913946,7347397,3980411,12871,11772,2008,257,1976,1099,12614,1.0,0.0,7,12.0,3,1,84,2506.0,0.7368041276931763,0.2341575175523758
7916308,6320665,5582204,12871,9455,2001,7649,1996,3416,5222,1.0,0.0,15,9.0,8,1,7,217.0,0.533050537109375,0.14823588728904724
7913890,4183453,4987546,12871,1475,1980,5500,1991,11396,7371,1.0,0.0,21,2.0,3,4,77,4606.0,0.4815710186958313,0.46873170137405396
7914208,5403094,5584837,12871,7033,1995,7656,1996,5838,5215,0.5,0.0,89,6.0,9,11,14,91.0,0.45883363485336304,0.34846231341362
7914561,5139497,3985019,12871,6074,1992,285,1976,6797,12586,1.0,0.0,45,12.0,2,1,42,301.0,0.4874236285686493,0.08726577460765839
7917130,6578047,7320002,12871,10022,2003,11702,2008,2849,1169,0.0,0.0,23,3.0,16,7,35,273.0,0.3476978540420532,0.18663917481899261
7915736,6939343,5369448,12871,10841,2005,6907,1994,2030,5964,0.0,0.0,7,7.0,4,5,21,1099.0,0.1269139051437378,0.15662698447704315
7917488,7720856,5686687,12871,12556,2010,7985,1997,315,4886,1.0,0.0,1,1.0,8,4,315,4886.0,0.5093793869018555,0.11264186352491379
7914503,5205810,6523507,12871,6326,1993,9917,2003,6545,2954,1.0,0.0,42,8.0,13,11,42,448.0,0.3437027335166931,0.0943121612071991
7917468,6029238,5026044,12871,8818,2000,5654,1991,4053,7217,1.0,0.0,27,8.0,7,9,7,308.0,0.3618587553501129,0.10648389160633087
7913410,4653194,7116999,12871,4107,1987,11233,2006,8764,1638,0.0,0.0,16,1.0,2,8,0,1638.0,0.4166071116924286,0.14141632616519928
7919870,6314013,4157824,12878,9441,2001,1258,1979,3437,11620,0.0,0.0,68,4.0,30,2,7,3752.0,0.36088311672210693,0.2285284847021103
7920873,5883594,7048993,12878,8475,1999,11100,2006,4403,1778,0.0,0.0,105,3.0,7,14,21,1512.0,0.5398799777030945,0.11611706018447876
7921532,5540582,6235283,12885,7516,1996,9273,2001,5369,3612,0.0,0.0,11,2.0,2,1,252,1435.0,0.25559189915657043,0.12040762603282928
7921734,5623605,4424262,12885,7782,1997,2924,1984,5103,9961,0.0,0.0,181,15.0,7,4,105,1043.0,0.12319741398096085,0.25069454312324524
7921945,4825663,4262529,12885,4870,1989,1937,1981,8015,10948,0.0,1.0,32,9.0,2,3,175,3808.0,0.35151028633117676,0.31148532032966614
7923260,6025283,4860297,12885,8811,2000,4982,1989,4074,7903,0.0,0.0,64,10.0,8,3,35,448.0,0.15310125052928925,0.19770921766757965
7925612,5804803,7397743,12885,8286,1998,11877,2008,4599,1008,0.5,0.0,365,3.0,10,8,7,287.0,0.057051390409469604,0.24867607653141022
7924613,7539062,5833990,12885,12199,2009,8349,1998,686,4536,1.0,0.0,7,2.0,15,9,0,3591.0,0.5705864429473877,0.08857297152280807
7921924,6691777,6543152,12885,10274,2004,9959,2003,2611,2926,1.0,0.0,7,6.0,8,3,532,532.0,0.4368247091770172,0.3115338683128357
7927646,4954362,6751559,12892,5360,1990,10393,2004,7532,2499,1.0,0.0,5,8.0,1,9,3906,98.0,0.4992857575416565,0.20559413731098175
7926243,7159374,5943764,12892,11331,2007,8643,1999,1561,4249,0.5,0.0,7,5.0,43,41,42,623.0,0.4253692626953125,0.26577097177505493
7926417,5413087,4276626,12892,7068,1995,2007,1981,5824,10885,0.0,0.0,17,3.0,13,4,168,9989.0,0.6234639286994934,0.1436046063899994
7928968,7064673,7595181,12892,11128,2006,12325,2009,1764,567,0.0,0.0,3,1.0,20,6,784,567.0,0.45598313212394714,0.14688065648078918
7929949,6014427,7125626,12892,8776,2000,11254,2006,4116,1638,1.0,0.0,72,2.0,8,79,28,343.0,0.5316611528396606,0.1723480224609375
7930756,7035854,4357177,12892,11072,2006,2497,1982,1820,10395,1.0,0.0,27,7.0,43,2,14,4354.0,0.4531957507133484,0.16864798963069916
7927374,7179294,5253751,12892,11373,2007,6501,1993,1519,6391,1.0,0.0,22,19.0,31,31,21,1330.0,0.5003029108047485,0.16305646300315857
7929938,6959178,4768608,12892,10890,2005,4632,1988,2002,8260,0.3333333333333333,0.0,50,17.0,16,2,0,3129.0,0.41104212403297424,0.22931259870529175
7930416,5761673,4411783,12892,8188,1998,2854,1983,4704,10038,1.0,0.0,115,16.0,5,15,35,161.0,0.28146326541900635,0.03438210114836693
7927370,5383260,5918147,12892,6963,1995,8580,1999,5929,4312,0.0,0.0,23,9.0,8,19,21,259.0,0.3643619120121002,0.10670773684978485
7931666,6258120,4192189,12899,9322,2001,1531,1980,3577,11368,1.0,0.0,103,13.0,17,1,7,1253.0,0.4629463255405426,0.26750579476356506
7932283,6706748,6620474,12899,10302,2004,10120,2003,2597,2779,0.5,0.0,1,11.0,2,18,2597,70.0,0.5705999732017517,0.17073602974414825
7931683,6955685,7565958,12899,10883,2005,12262,2009,2016,637,1.0,0.0,5,3.0,14,3,161,231.0,0.20124582946300507,0.06863364577293396
7934012,5943674,5260987,12899,8636,1999,6522,1993,4263,6377,1.0,0.0,9,30.0,11,12,77,7.0,0.36013099551200867,0.22777900099754333
7931020,4962885,4795433,12899,5402,1990,4751,1989,7497,8148,0.0,1.0,45,4.0,1,7,77,7.0,0.38525500893592834,0.28861352801322937
7931086,5285846,6628443,12899,6620,1994,10134,2003,6279,2765,1.0,0.0,206,2.0,7,3,35,1722.0,0.4951299726963043,0.15005658566951752
7931353,6561627,4435938,12899,9994,2003,2994,1984,2905,9905,1.0,0.0,49,19.0,8,1,0,175.0,0.5879122614860535,0.13623936474323273
7930833,4733470,5545991,12899,4471,1988,7530,1996,8428,5369,0.3333333333333333,0.0,6,4.0,1,2,287,1232.0,0.415824830532074,0.09317798912525177
7931244,5133094,7349702,12899,6053,1992,11772,2008,6846,1127,0.0,0.0,4,1.0,4,4,945,1127.0,0.6343984603881836,0.18238025903701782
7935520,5998298,4681121,12906,8741,1999,4219,1987,4165,8687,0.0,0.0,73,11.0,16,4,14,343.0,0.26762208342552185,0.19954591989517212
7936105,4272695,5841350,12906,1986,1981,8363,1998,10920,4543,1.0,0.0,18,10.0,1,17,21,126.0,0.50626540184021,0.2255248874425888
7934515,6578602,4606245,12906,10029,2003,3883,1986,2877,9023,0.0,0.0,2,8.0,1,3,420,161.0,0.190705344080925,0.10782511532306671
7937475,7464147,5761247,12906,12031,2008,8188,1998,875,4718,1.0,0.0,27,9.0,6,18,21,1029.0,0.38374441862106323,0.18153859674930573
7935166,5304312,5787157,12906,6683,1994,8244,1998,6223,4662,1.0,0.0,45,6.0,12,3,7,252.0,0.46611008048057556,0.14810745418071747
7937706,6629148,4010432,12906,10134,2003,425,1977,2772,12481,0.0,0.0,12,34.0,8,1,126,49.0,0.39199718832969666,0.28638699650764465
7934994,6431982,3983450,12906,9721,2002,271,1976,3185,12635,1.0,0.0,16,4.0,12,1,28,3731.0,0.505178689956665,0.35796111822128296
7935755,4996259,6069722,12906,5535,1991,8916,2000,7371,3990,0.25,0.0,7,6.0,2,5,280,735.0,0.4275985360145569,0.12024659663438797
7935126,7357804,6334121,12906,11793,2008,9490,2001,1113,3416,1.0,0.0,10,15.0,118,10,0,21.0,0.6761612296104431,-0.033557143062353134
7934799,6270180,5388972,12906,9350,2001,6984,1995,3556,5922,1.0,0.0,21,12.0,5,12,7,91.0,0.613410234451294,0.142711341381073
7940138,6147564,4483528,12913,9084,2000,3246,1984,3829,9667,0.5,0.0,5,10.0,6,5,413,3129.0,0.7353423833847046,0.20084089040756226
7940479,6439721,4900960,12913,9735,2002,5157,1990,3178,7756,0.0,0.0,4,5.0,1,2,63,2002.0,0.577341616153717,0.30071431398391724
7940785,6381648,5902437,12913,9616,2002,8531,1999,3297,4382,0.0,0.0,3,3.0,3,79,2030,133.0,0.3132677674293518,0.3383408784866333
7942803,6213932,6213302,12920,9231,2001,9231,2001,3689,3689,1.0,0.0,36,5.0,3,13,105,315.0,0.36111101508140564,0.24740223586559296
7944435,6166723,6914026,12920,9126,2000,10778,2005,3794,2142,0.5,0.0,77,7.0,95,13,0,98.0,0.6140854954719543,0.0427490696310997
7944350,6429809,5855682,12920,9714,2002,8405,1999,3206,4515,0.0,0.0,12,1.0,4,2,28,4515.0,0.24380117654800415,0.17700962722301483
7945039,5339352,4202947,12920,6802,1994,1594,1980,6118,11326,1.0,0.0,101,4.0,15,1,7,4592.0,0.6452781558036804,0.06581447273492813
7945945,5396493,7683363,12920,7005,1995,12500,2010,5915,420,0.5,0.0,40,1.0,7,2,112,420.0,0.5488224625587463,0.14210805296897888
7944784,5828634,4219974,12920,8335,1998,1706,1980,4585,11214,1.0,0.0,25,9.0,4,2,231,3948.0,0.5822002291679382,0.2822856307029724
7944435,5262777,4546252,12920,6529,1993,3568,1985,6391,9352,0.0,0.0,79,5.0,12,3,0,5873.0,0.47543537616729736,-0.005723567679524422
7944586,6859289,5630296,12920,10645,2005,7810,1997,2275,5110,0.3333333333333333,0.0,7,11.0,4,13,14,126.0,0.6047892570495605,0.059735968708992004
7945631,7525964,4165556,12920,12171,2009,1335,1979,749,11585,0.0,0.0,2,15.0,4,1,434,490.0,0.4840215742588043,0.14799919724464417
7948407,6031473,4607157,12927,8825,2000,3883,1986,4102,9044,1.0,0.0,17,14.0,14,2,427,3486.0,0.4829970896244049,0.1318555474281311
7948094,6807730,4789127,12927,10526,2004,4723,1988,2401,8204,0.0,0.0,1,2.0,10,3,2401,2625.0,0.47537943720817566,0.18581900000572205
7947142,6319865,7205085,12927,9455,2001,11429,2007,3472,1498,0.5,0.0,6,2.0,7,11,70,434.0,0.32562312483787537,0.2990081310272217
7949644,6633868,4721003,12927,10148,2003,4408,1988,2779,8519,1.0,0.0,73,7.0,9,1,35,4032.0,0.5893054604530334,0.1501094251871109
7951185,6387121,7455040,12934,9630,2002,12017,2008,3304,917,1.0,0.0,79,1.0,3,12,7,917.0,0.5635855793952942,0.271902859210968
7952910,6903962,5844180,12934,10750,2005,8370,1998,2184,4564,1.0,0.0,29,6.0,6,4,7,455.0,0.5307599306106567,0.15676288306713104
7953720,6643641,4319005,12934,10169,2003,2259,1982,2765,10675,1.0,0.0,82,6.0,13,1,7,5481.0,0.3399783968925476,0.08483900874853134
7951183,6354099,4385584,12934,9567,2002,2707,1983,3367,10227,0.5,0.0,27,11.0,8,1,154,2289.0,0.5676990747451782,0.024890024214982986
7953369,6173899,6474363,12934,9147,2001,9805,2002,3787,3129,0.0,0.0,68,2.0,8,16,0,259.0,0.28875166177749634,0.25828585028648376
7951192,5851464,4376563,12934,8391,1998,2630,1983,4543,10304,0.0,0.0,56,12.0,23,2,0,602.0,0.4434018135070801,0.24633415043354034
7953251,6349373,5035055,12934,9546,2002,5689,1991,3388,7245,1.0,0.0,53,7.0,20,3,35,84.0,0.36139705777168274,0.15155021846294403
7958390,4694454,5598161,12941,4275,1987,7698,1997,8666,5243,0.0,0.0,43,24.0,7,4,119,392.0,0.4683386981487274,0.24513234198093414
7955489,4457813,5413284,12941,3106,1984,7068,1995,9835,5873,1.0,0.0,13,4.0,2,10,203,3353.0,0.30851978063583374,0.15278629958629608
7957408,6697329,5642747,12941,10281,2004,7852,1997,2660,5089,1.0,0.0,28,5.0,5,4,7,581.0,0.49250322580337524,0.2156549096107483
7955381,6645243,4885615,12941,10176,2003,5087,1989,2765,7854,1.0,0.0,44,6.0,20,3,7,3045.0,0.330351322889328,0.27233898639678955
7955124,7780458,4596715,12941,12654,2010,3827,1986,287,9114,1.0,0.0,1,13.0,8,7,287,3556.0,0.6306747198104858,0.14743618667125702
7959872,4931225,4015677,12948,5269,1990,460,1977,7679,12488,0.0,0.0,35,25.0,7,1,301,756.0,0.29573214054107666,0.2200632244348526
7962580,7484002,5269269,12948,12080,2009,6557,1993,868,6391,1.0,0.0,1,20.0,20,3,868,343.0,0.6094030737876892,0.09306365996599197
7959190,5871240,7584638,12948,8447,1999,12304,2009,4501,644,1.0,0.0,5,2.0,5,4,168,217.0,0.3650774359703064,0.3432876169681549
7962046,5991477,4019862,12948,8727,1999,481,1977,4221,12467,0.25,0.25,29,8.0,12,1,119,245.0,0.6485790014266968,0.03518318012356758
7962506,5917489,5899244,12948,8580,1999,8524,1999,4368,4424,1.0,0.0,102,2.0,2,4,28,1939.0,0.4275757670402527,0.28059929609298706
7962336,4783802,4075949,12948,4695,1988,789,1978,8253,12159,1.0,0.0,29,8.0,9,2,462,182.0,0.5111530423164368,0.14393694698810577
7959646,6702834,5873862,12948,10295,2004,8454,1999,2653,4494,1.0,1.0,40,18.0,95,62,49,21.0,0.7826108336448669,0.40835100412368774
7960756,5885860,4550921,12948,8482,1999,3596,1985,4466,9352,1.0,0.0,33,5.0,1,1,56,2625.0,0.2807809114456177,0.18876805901527405
7964181,5559232,4202209,12955,7572,1996,1594,1980,5383,11361,0.0,0.0,27,4.0,7,1,238,7819.0,0.31263259053230286,0.0956130400300026
7966542,4561092,6413226,12955,3645,1985,9679,2002,9310,3276,0.0,0.0,26,3.0,1,21,476,1141.0,0.32249048352241516,0.10496167093515396
7963847,6884168,7265503,12955,10708,2005,11569,2007,2247,1386,1.0,0.0,19,1.0,2,2,0,1386.0,0.4218650460243225,0.10817758738994598
7963975,5540711,4095120,12955,7516,1996,894,1978,5439,12061,1.0,0.0,95,15.0,69,1,14,147.0,0.7081769108772278,-0.0927937775850296
7964031,5565592,4578198,12955,7593,1996,3736,1986,5362,9219,0.0,0.0,46,23.0,9,4,7,2471.0,0.355541467666626,0.36374229192733765
7967775,5865790,7295542,12962,8433,1999,11639,2007,4529,1323,1.0,0.0,40,3.0,2,4,98,203.0,0.43338295817375183,0.17509454488754272
7970688,6236977,6011740,12962,9273,2001,8769,2000,3689,4193,1.0,0.0,269,9.0,4,5,0,21.0,0.3655224144458771,0.18855689465999603
7969754,6002214,5047086,12962,8748,1999,5731,1991,4214,7231,0.5,0.0,13,13.0,11,3,98,42.0,0.586665153503418,0.11376082897186279
7971234,7096355,6435514,12962,11191,2006,9728,2002,1771,3234,0.5,0.0,5,10.0,15,3,133,266.0,0.4241544008255005,0.17632019519805908
7967913,5939831,5639973,12962,8629,1999,7838,1997,4333,5124,1.0,0.0,37,7.0,11,19,49,112.0,0.29539650678634644,0.29573333263397217
7967214,5961451,5690139,12962,8678,1999,7999,1997,4284,4963,0.0,0.0,96,10.0,50,4,14,168.0,0.39102599024772644,0.25500619411468506
7969934,5623534,5500481,12962,7782,1997,7383,1996,5180,5579,1.0,0.0,47,15.0,3,9,35,2009.0,0.4260423481464386,0.06751611083745956
7971089,7325156,4997937,12962,11716,2008,5542,1991,1246,7420,1.0,0.0,2,3.0,3,3,287,4347.0,0.49562451243400574,-0.011796491220593452
7967968,6103479,4586823,12962,8993,2000,3778,1986,3969,9184,0.0,0.0,162,10.0,27,1,14,210.0,0.37305641174316406,0.11573665589094162
7968062,6108588,4532713,12962,9000,2000,3505,1985,3962,9457,0.0,0.5,51,15.0,38,1,0,1631.0,0.30366045236587524,0.25437572598457336
7972711,6806508,7589344,12969,10519,2004,12311,2009,2450,658,0.0,0.0,15,4.0,12,1,63,7.0,0.4506033957004547,0.2394675463438034
7972802,6225047,6255936,12969,9252,2001,9315,2001,3717,3654,1.0,0.0,96,4.0,27,6,14,1533.0,0.41579675674438477,0.09458771347999573
7971518,6775942,4349620,12969,10456,2004,2448,1982,2513,10521,1.0,0.0,7,23.0,9,4,56,70.0,0.3987143039703369,0.15203793346881866
7974677,5099846,5843535,12969,5934,1992,8370,1998,7035,4599,1.0,0.0,223,15.0,6,2,0,826.0,0.5096275806427002,0.24691319465637207
7978943,4553238,4914059,12976,3603,1985,5206,1990,9373,7770,0.0,0.0,63,9.0,1,5,525,224.0,0.5575894117355347,0.1297246813774109
7977972,7051306,4301187,12976,11100,2006,2147,1981,1876,10829,0.0,0.0,17,11.0,6,1,49,196.0,0.17720314860343933,0.00033404934220016
7978818,7590219,4703855,12976,12311,2009,4324,1987,665,8652,0.5,0.0,5,5.0,5,5,28,6615.0,0.49657776951789856,0.06866362690925598
7977216,7078357,4806068,12976,11156,2006,4800,1989,1820,8176,1.0,0.0,2,18.0,5,1,399,140.0,0.5462653636932373,0.20670980215072632
7977462,6783961,4928746,12976,10470,2004,5262,1990,2506,7714,0.5,0.0,41,8.0,1,6,7,2002.0,0.34446612000465393,0.12007616460323334
7977583,6420888,6820810,12976,9693,2002,10554,2004,3283,2422,0.0,0.0,20,3.0,4,4,35,14.0,0.3954717516899109,0.22315125167369843
7976060,6988413,7264252,12976,10981,2006,11569,2007,1995,1407,0.0,1.0,5,1.0,13,6,756,1407.0,0.7119064331054688,0.46442896127700806
7978128,6834234,5941964,12976,10582,2004,8636,1999,2394,4340,1.0,0.0,16,9.0,4,5,56,329.0,0.6467992067337036,0.2859984040260315
7979518,5655007,5752340,12976,7887,1997,8174,1998,5089,4802,0.0,0.0,81,6.0,4,9,112,1645.0,0.27936118841171265,0.2023870199918747
7978122,7765065,4756667,12976,12626,2010,4576,1988,350,8400,0.0,0.0,1,5.0,11,1,350,2443.0,0.3034786581993103,0.1899517923593521
7976941,6677068,5035580,12976,10239,2004,5689,1991,2737,7287,0.0,0.0,4,12.0,31,8,385,84.0,0.33025485277175903,0.24385502934455872
7976816,5547748,4158686,12976,7537,1996,1265,1979,5439,11711,0.25,0.0,87,8.0,4,1,63,1274.0,0.19794946908950806,0.1836702674627304
7982464,6670813,7029095,12983,10225,2003,11065,2006,2758,1918,1.0,0.0,14,6.0,24,8,147,749.0,0.4826701283454895,0.21718889474868774
7983399,6404859,4440484,12983,9658,2002,3015,1984,3325,9968,0.5,0.0,11,7.0,15,2,189,3640.0,0.631626546382904,0.14079788327217102
7981097,5966680,7707142,12983,8685,1999,12535,2010,4298,448,0.0,0.0,17,1.0,7,87,105,448.0,0.3792616128921509,0.19765275716781616
7981984,6133389,5279928,12983,9056,2000,6592,1994,3927,6391,1.0,0.0,20,7.0,7,6,203,98.0,0.4336218237876892,0.3383820354938507
7981134,6129739,4862812,12983,9049,2000,4996,1989,3934,7987,1.0,0.0,183,2.0,55,2,7,3836.0,0.7124226689338684,0.0872642993927002
7981056,5628961,6623317,12983,7803,1997,10127,2003,5180,2856,0.0,0.0,47,1.0,10,10,0,2856.0,0.3150489628314972,0.19138924777507782
7983024,6180992,7087165,12983,9161,2001,11177,2006,3822,1806,0.3333333333333333,0.0,2,1.0,6,12,147,1806.0,0.6309523582458496,0.12077273428440094
7984429,6519767,7414482,12983,9903,2003,11919,2008,3080,1064,1.0,0.0,84,2.0,12,4,77,392.0,0.44915974140167236,0.29452183842658997
7984275,6009261,6999246,12983,8762,1999,11002,2006,4221,1981,1.0,0.0,36,2.0,12,2,203,7.0,0.3375716507434845,0.18156854808330536
7980385,4213527,6972326,12983,1664,1980,10932,2005,11319,2051,0.0,0.0,41,10.0,2,20,1162,63.0,0.5750811696052551,0.07449157536029816
7984357,7624329,4381770,12983,12381,2009,2679,1983,602,10304,1.0,0.0,1,25.0,4,3,602,399.0,0.4858723282814026,0.0897989496588707
7980327,4627036,6396020,12983,3988,1986,9644,2002,8995,3339,0.5,0.0,26,5.0,3,19,357,819.0,0.2546595335006714,0.2155076116323471
7983741,5408093,4184218,12983,7047,1995,1482,1980,5936,11501,0.5,0.0,17,33.0,3,1,133,28.0,0.5011341571807861,0.029693791642785072
7986124,6005367,7156495,12990,8755,1999,11324,2007,4235,1666,1.0,0.0,21,4.0,3,18,245,7.0,0.5011831521987915,0.18084459006786346
7984558,6526670,6649061,12990,9924,2003,10183,2003,3066,2807,1.0,0.0,11,7.0,7,19,126,56.0,0.2947523891925812,0.060957688838243484
7985379,6468490,4334995,12990,9791,2002,2357,1982,3199,10633,1.0,1.0,14,6.0,43,1,28,259.0,0.4850420653820038,0.3061123490333557
7985164,5328420,4088695,12990,6767,1994,859,1978,6223,12131,1.0,0.0,37,3.0,4,1,7,11088.0,0.2725578844547272,0.059120796620845795
7985588,6680025,5348036,12990,10246,2004,6837,1994,2744,6153,0.0,0.0,5,10.0,47,4,140,973.0,0.2541404962539673,0.11292359977960587
7985214,5499973,7284169,12990,7383,1996,11611,2007,5607,1379,1.0,0.0,143,4.0,19,27,56,84.0,0.5575898289680481,0.1391313225030899
7988036,5180640,5197594,12997,6228,1993,6298,1993,6769,6699,0.3333333333333333,0.0,27,3.0,11,2,875,5117.0,0.12299671769142151,0.21590392291545868
7989094,5104539,6434720,12997,5948,1992,9721,2002,7049,3276,0.0,0.0,23,2.0,7,26,112,1162.0,0.26445457339286804,0.10333709418773651
7989674,6099489,5584094,12997,8986,2000,7656,1996,4011,5341,1.0,0.0,17,12.0,3,3,14,175.0,0.2448759377002716,0.14963673055171967
7987613,5175136,4473669,12997,6207,1992,3190,1984,6790,9807,0.0,0.0,14,10.0,5,2,77,882.0,0.12414436787366867,0.06472130119800568
7992163,6181693,7573245,12997,9161,2001,12276,2009,3836,721,1.0,0.0,25,2.0,25,5,28,252.0,0.5053781270980835,0.1766224056482315
7988044,5585787,7714646,12997,7656,1996,12549,2010,5341,448,0.5,0.0,197,1.0,11,2,0,448.0,0.49569568037986755,0.08604313433170319
7992644,5785120,7454260,13004,8244,1998,12010,2008,4760,994,1.0,0.0,202,1.0,12,7,21,994.0,0.4940958321094513,0.23700572550296783
7994471,7224324,4534838,13004,11471,2007,3512,1985,1533,9492,0.0,0.0,10,29.0,66,6,112,581.0,0.7535503506660461,0.09949599951505661
7993405,6824562,4066260,13004,10561,2004,733,1978,2443,12271,1.0,0.0,87,19.0,48,2,0,175.0,0.115766242146492,0.06411764770746231
7994919,6285295,5522394,13004,9378,2001,7460,1996,3626,5544,0.0,0.0,33,11.0,6,5,0,189.0,0.4763457775115967,0.1059827134013176
7995627,6374128,5290826,13004,9602,2002,6634,1994,3402,6370,0.0,0.0,29,3.0,7,11,0,1694.0,0.4532061517238617,0.2295312136411667
7993194,6645077,4792320,13004,10176,2003,4737,1988,2828,8267,1.0,0.0,115,16.0,35,9,7,630.0,0.5336366295814514,0.3268803656101227
7995478,6891801,4617371,13004,10722,2005,3939,1986,2282,9065,1.0,0.0,5,20.0,8,6,273,2681.0,0.45527175068855286,-0.01274973526597023
7997106,5197706,5679092,13011,6298,1993,7964,1997,6713,5047,1.0,0.0,35,5.0,8,5,56,224.0,0.6383171677589417,0.24398045241832733
7997217,5398771,6234366,13011,7019,1995,9273,2001,5992,3738,1.0,0.0,21,12.0,22,10,1029,154.0,0.349569708108902,0.3026222586631775
7997445,5435468,6751259,13011,7145,1995,10393,2004,5866,2618,1.0,0.0,5,6.0,8,14,385,14.0,0.5210778713226318,0.1508093625307083
8001400,5754027,5383665,13011,8174,1998,6963,1995,4837,6048,0.0,0.0,46,11.0,9,8,42,77.0,0.4300995469093323,0.17145785689353943
7997616,6817628,6915763,13011,10547,2004,10785,2005,2464,2226,1.0,0.0,6,4.0,16,8,217,966.0,0.7771319150924683,0.3023443818092346
8000006,6411436,4352550,13011,9672,2002,2469,1982,3339,10542,1.0,1.0,4,23.0,5,7,672,4676.0,0.489686518907547,0.3852543830871582
8002028,5890538,5817692,13018,8496,1999,8314,1998,4522,4704,1.0,0.0,45,5.0,11,3,105,1197.0,0.4080822467803955,0.04335978999733925
8002490,5020866,6820810,13018,5633,1991,10554,2004,7385,2464,0.0,0.0,31,4.0,11,4,175,7.0,0.23276977241039276,0.21532517671585083
8003889,7097661,7660292,13018,11198,2006,12458,2010,1820,560,0.0,0.0,1,2.0,18,22,1820,399.0,0.48431187868118286,0.24710559844970703
8002770,6076012,5681002,13018,8930,2000,7971,1997,4088,5047,1.0,0.0,93,2.0,36,3,42,4039.0,0.32876768708229065,0.17099212110042572
8002919,5968639,5729253,13018,8692,1999,8111,1998,4326,4907,1.0,0.0,14,8.0,12,7,133,91.0,0.4123894274234772,0.2820415794849396
8005647,5541833,4651552,13018,7516,1996,4100,1987,5502,8918,0.0,0.0,58,5.0,20,4,63,2436.0,0.32121121883392334,0.19252990186214447
8001682,5041342,5304099,13018,5710,1991,6683,1994,7308,6335,0.0,0.0,2,22.0,12,7,147,126.0,0.40386995673179626,0.3422766923904419
8001777,5163293,7592552,13018,6165,1992,12318,2009,6853,700,1.0,0.0,68,1.0,5,9,322,700.0,0.6387609839439392,0.19078996777534485
8002768,6508813,7004283,13018,9882,2003,11016,2006,3136,2002,1.0,0.0,76,5.0,102,14,21,98.0,0.5581695437431335,0.236786350607872
8007446,4948961,5489053,13025,5339,1990,7341,1996,7686,5684,0.0,0.0,56,2.0,2,7,14,2765.0,0.48881426453590393,0.21721550822257996
8010411,6873970,6041685,13025,10680,2005,8853,2000,2345,4172,1.0,0.0,9,2.0,12,9,133,2576.0,0.4918641448020935,0.14868097007274628
8010113,6119010,6879008,13025,9021,2000,10694,2005,4004,2331,1.0,0.0,24,1.0,6,1,119,2331.0,0.30486345291137695,0.2043347805738449
8010988,6941275,5373633,13025,10841,2005,6928,1994,2184,6097,0.0,0.0,77,12.0,16,4,0,2359.0,0.5717794895172119,0.053655531257390976
8011579,7374092,5373423,13032,11828,2008,6921,1994,1204,6111,1.0,0.0,2,12.0,60,2,791,56.0,1.0,0.2735019326210022
8013580,6541819,5128240,13032,9952,2003,6032,1992,3080,7000,0.0,0.0,31,4.0,5,3,91,2135.0,0.22674982249736786,0.30061420798301697
8012395,6514672,4070008,13032,9896,2003,754,1978,3136,12278,0.0,0.0,54,25.0,9,1,175,161.0,0.3276514410972595,0.08358985930681229
8014731,6795714,4473321,13032,10491,2004,3190,1984,2541,9842,1.0,0.0,14,3.0,9,1,210,3199.0,0.2398766130208969,0.11836555600166321
8015025,5956501,5260402,13032,8664,1999,6522,1993,4368,6510,1.0,0.0,179,4.0,5,4,7,581.0,0.30286869406700134,0.14229311048984528
8015590,7201251,4127033,13032,11422,2007,1062,1978,1610,11970,0.25,0.0,5,6.0,13,1,308,525.0,0.36316001415252686,0.1904263198375702
8016874,7128756,7088686,13039,11261,2006,11177,2006,1778,1862,1.0,0.0,32,3.0,72,7,42,616.0,0.5406648516654968,0.0591750293970108
8019331,5235632,5123850,13039,6431,1993,6018,1992,6608,7021,1.0,0.0,99,5.0,6,6,21,126.0,0.4045022428035736,0.16623522341251373
8019975,4942525,6909111,13039,5311,1990,10764,2005,7728,2275,1.0,0.0,155,14.0,9,4,63,7.0,0.3717636168003082,0.07378197461366653
8016486,4496197,5511578,13039,3316,1985,7425,1996,9723,5614,1.0,1.0,5,5.0,2,8,2793,210.0,0.36176806688308716,0.36405715346336365
8019434,6329920,4151540,13039,9476,2001,1209,1979,3563,11830,0.0,0.0,71,13.0,19,2,0,14.0,0.3226836621761322,0.13039898872375488
8020187,5798785,6169884,13039,8272,1998,9133,2001,4767,3906,1.0,1.0,269,14.0,89,3,0,42.0,0.2850395441055298,0.2632029950618744
8016030,5012865,4478487,13039,5605,1991,3218,1984,7434,9821,1.0,0.0,46,9.0,4,3,35,3430.0,0.6277676224708557,0.2173800766468048
8015810,4502431,4409715,13039,3351,1985,2847,1983,9688,10192,0.5,0.0,25,8.0,1,1,364,700.0,0.4405834376811981,0.12982656061649323
8017237,5342348,4987487,13039,6816,1994,5500,1991,6223,7539,0.0,0.0,346,11.0,12,3,0,56.0,0.37087440490722656,0.08256331086158752
8016414,7465048,5445502,13039,12038,2008,7180,1995,1001,5859,1.0,0.0,6,6.0,7,14,14,1988.0,0.6161086559295654,0.12920647859573364
8016755,6035559,6505421,13039,8839,2000,9875,2003,4200,3164,0.0,0.0,25,11.0,7,8,7,210.0,0.16138963401317596,0.22913847863674164
8017168,4557927,4625289,13039,3631,1985,3981,1986,9408,9058,0.6666666666666666,0.0,33,44.0,2,1,490,35.0,0.4310765862464905,0.023884756490588188
8016749,6992477,4373543,13039,10988,2006,2602,1983,2051,10437,0.5,0.0,5,5.0,17,6,252,8862.0,0.3291019797325134,0.1538418084383011
8021421,6503272,5324847,13046,9868,2003,6753,1994,3178,6293,1.0,0.0,133,2.0,23,4,0,4550.0,0.33298489451408386,0.06779477745294571
8021360,6357089,4743827,13046,9574,2002,4513,1988,3472,8533,0.0,0.0,17,7.0,6,3,7,1750.0,0.39265310764312744,0.21605435013771057
8021344,6953693,4151540,13046,10876,2005,1209,1979,2170,11837,0.0,0.0,57,13.0,65,2,7,21.0,0.3496341109275818,0.1657273769378662
8025510,7563113,5752114,13053,12255,2009,8167,1998,798,4886,1.0,0.0,1,6.0,5,7,798,21.0,0.5027697086334229,0.26840969920158386
8024908,5718669,5111364,13053,8083,1998,5969,1992,4970,7084,0.0,0.0,18,9.0,9,5,420,2541.0,0.2559189796447754,0.04227078706026077
8027199,7379351,4612765,13053,11835,2008,3918,1986,1218,9135,1.0,0.0,1,9.0,3,2,1218,1778.0,0.6296923160552979,0.2050529420375824
re42729,5175886,4522780,13053,6214,1993,3449,1985,6839,9604,1.0,0.0,11,12.0,1,8,140,5446.0,0.509951114654541,0.2270779311656952
8027081,6241921,5459123,13053,9287,2001,7229,1995,3766,5824,0.0,0.0,128,25.0,30,1,14,455.0,0.36651501059532166,0.25877511501312256
8025120,5592946,3974749,13053,7684,1997,229,1976,5369,12824,1.0,0.0,11,14.0,10,1,357,1190.0,0.5328958630561829,0.30370959639549255
8027584,6813403,6991871,13053,10533,2004,10988,2006,2520,2065,0.0,0.0,15,1.0,13,3,42,2065.0,0.3669361472129822,-0.06947232782840729
8028032,6728934,4687629,13053,10344,2004,4247,1987,2709,8806,1.0,0.0,17,4.0,10,2,49,7371.0,0.40377306938171387,0.17141002416610718
8027571,7500528,4531883,13053,12122,2009,3498,1985,931,9555,0.0,0.0,49,26.0,545,5,21,203.0,0.34347233176231384,0.040689438581466675
8028388,5584859,6689317,13060,7656,1996,10267,2004,5404,2793,0.0,0.0,80,4.0,4,5,0,259.0,0.6124513149261475,0.11719520390033722
8028370,5500977,4169802,13060,7390,1996,1370,1979,5670,11690,1.0,0.0,54,9.0,10,1,63,126.0,0.44589143991470337,0.08278626948595047
8028767,6695080,4303572,13060,10281,2004,2161,1981,2779,10899,1.0,0.0,13,11.0,19,2,14,1694.0,0.6325470805168152,0.18991412222385406
8029020,6726247,6415142,13060,10344,2004,9679,2002,2716,3381,1.0,0.0,5,10.0,11,9,392,21.0,0.4325653910636902,0.1001269593834877
8031495,4375662,6745613,13060,2616,1983,10386,2004,10444,2674,0.5,0.0,58,7.0,2,69,7,56.0,0.27659961581230164,0.1314668208360672
8031588,6981039,6706232,13060,10953,2005,10302,2004,2107,2758,0.3333333333333333,0.3333333333333333,18,11.0,83,1,7,21.0,0.4427362084388733,0.055789683014154434
8030918,5247278,5894099,13060,6473,1993,8503,1999,6587,4557,0.0,0.0,64,4.0,8,2,84,616.0,0.5191861391067505,0.2022044062614441
8032711,6820173,5611455,13060,10547,2004,7747,1997,2513,5313,1.0,0.0,13,6.0,7,4,91,1148.0,0.5186620950698853,0.20231616497039795
8029208,4366806,5478257,13060,2560,1983,7299,1995,10500,5761,0.0,0.0,12,6.0,4,19,714,224.0,0.38130056858062744,0.19084735214710236
8033440,5797537,5545393,13067,8272,1998,7530,1996,4795,5537,1.0,0.0,217,8.0,46,2,0,238.0,0.5140111446380615,0.1084355041384697
8033983,5700286,6073883,13067,8027,1997,8930,2000,5040,4137,1.0,0.0,413,19.0,46,4,7,70.0,0.3929733633995056,0.238393172621727
8036304,5841811,4466555,13067,8363,1998,3155,1984,4704,9912,0.0,0.0,92,10.0,10,1,28,889.0,0.5598564147949219,0.21184633672237396
8034367,6302898,4305255,13067,9420,2001,2175,1981,3647,10892,1.0,0.0,69,9.0,65,3,7,63.0,0.4337970018386841,0.09134642779827118
8033038,4637321,4828177,13067,4037,1987,4877,1989,9030,8190,0.0,0.0,10,7.0,1,4,0,1561.0,0.4807933270931244,0.42191463708877563
8034065,5365985,5511451,13067,6900,1994,7425,1996,6167,5642,0.0,0.0,25,4.0,18,9,28,133.0,0.3805277943611145,0.1994284689426422
8033902,6220959,4648244,13067,9245,2001,4086,1987,3822,8981,0.5,0.0,137,5.0,11,1,7,98.0,0.3713556230068207,0.28286293148994446
8035400,5384543,6119669,13067,6963,1995,9028,2000,6104,4039,1.0,0.0,15,5.0,11,7,420,1491.0,0.4548715651035309,0.1381523311138153
8033996,4807640,4243766,13067,4807,1989,1832,1981,8260,11235,1.0,0.0,32,3.0,6,1,126,3941.0,0.27555665373802185,0.09099122136831284
8041151,7643690,6490621,13074,12423,2010,9833,2002,651,3241,1.0,1.0,1,9.0,8,3,651,105.0,0.39198824763298035,0.06551968306303024
8042149,6697950,5888081,13074,10281,2004,8489,1999,2793,4585,0.5,0.0,56,3.0,2,2,147,826.0,0.408293217420578,0.08094165474176407
8042131,6505169,6301041,13074,9868,2003,9413,2001,3206,3661,0.0,0.0,82,9.0,8,8,0,77.0,0.5052204728126526,0.23468813300132751
8038774,7056367,5664292,13074,11114,2006,7922,1997,1960,5152,1.0,0.0,2,18.0,12,10,98,182.0,0.5185810923576355,0.15403872728347778
8041416,7123954,4549973,13074,11247,2006,3589,1985,1827,9485,1.0,0.0,13,3.0,2,5,0,1897.0,0.7123414874076843,0.06122664362192154
8038013,6149702,4168341,13074,9091,2000,1356,1979,3983,11718,1.0,0.0,11,4.0,21,1,70,7665.0,0.5588663220405579,0.3533423840999603
8037721,7267289,4304457,13074,11576,2007,2168,1981,1498,10906,0.0,0.0,5,11.0,6,1,7,1533.0,0.3510175943374634,0.17000141739845276
8037934,7059407,4487288,13074,11121,2006,3267,1984,1953,9807,1.0,0.0,14,9.0,70,1,35,231.0,0.5336129665374756,0.32052361965179443
8045011,7340164,6184933,13081,11751,2008,9168,2001,1330,3913,0.5,0.5,1,2.0,8,14,1330,1813.0,0.10182270407676697,0.5714841485023499
8043498,4658449,4956623,13081,4128,1987,5367,1990,8953,7714,0.0,0.0,45,4.0,5,4,14,56.0,0.4733192026615143,0.2080392837524414
8045373,7202521,6668197,13081,11422,2007,10218,2003,1659,2863,0.0,0.0,5,10.0,14,24,84,280.0,0.42168474197387695,0.3254891335964203
8042313,6685154,4905494,13081,10260,2004,5178,1990,2821,7903,0.0,0.0,13,3.0,18,3,42,4907.0,0.3718341588973999,0.3592526614665985
8043433,5745331,4437727,13081,8153,1998,3001,1984,4928,10080,1.0,0.0,48,10.0,20,3,35,399.0,0.7205681800842285,0.011087414808571339
8042214,6383202,5012622,13081,9623,2002,5605,1991,3458,7476,0.5,0.0,17,12.0,5,4,105,1015.0,0.4896370768547058,0.15829578042030334
8043322,5135516,4783003,13081,6060,1992,4695,1988,7021,8386,0.5,0.0,157,14.0,41,16,28,210.0,0.24920356273651123,0.2337878942489624
8046313,5123087,4762569,13081,6011,1992,4604,1988,7070,8477,1.0,0.0,68,14.0,5,3,112,1925.0,0.3386653959751129,0.1068841740489006
8049569,6542025,4004265,13088,9952,2003,383,1977,3136,12705,0.0,0.0,17,10.0,2,1,14,2471.0,0.24058282375335693,0.15887874364852905
8048766,6057212,3989958,13088,8888,2000,306,1976,4200,12782,1.0,0.0,28,8.0,4,1,14,2947.0,0.46759045124053955,0.2564336061477661
8047027,6739796,5184643,13088,10372,2004,6249,1993,2716,6839,0.0,0.0,19,5.0,10,1,182,1897.0,0.34207913279533386,0.18111871182918549
8049766,6272532,5526147,13088,9350,2001,7467,1996,3738,5621,0.3333333333333333,0.0,72,8.0,3,5,7,560.0,0.23716965317726135,0.2611144185066223
8047549,5951020,4478604,13088,8657,1999,3218,1984,4431,9870,1.0,0.0,15,14.0,8,3,42,392.0,0.4653911590576172,0.17190992832183838
8048172,4558704,3980036,13088,3638,1985,257,1976,9450,12831,1.0,0.0,43,12.0,10,1,0,2352.0,0.4899902045726776,0.20393770933151245
8055022,7190496,7082107,13095,11394,2007,11163,2006,1701,1932,0.0,0.0,9,12.0,11,32,35,238.0,0.32824450731277466,0.10270382463932037
8055625,5673381,6708762,13095,7943,1997,10309,2004,5152,2786,1.0,0.0,183,8.0,25,23,7,84.0,0.4508589804172516,0.21837668120861053
8051565,5846057,5979612,13095,8377,1998,8713,1999,4718,4382,0.0,0.0,39,4.0,35,11,7,1610.0,0.49375927448272705,0.03181867301464081
8052642,5531680,4688043,13095,7488,1996,4247,1987,5607,8848,1.0,0.0,24,4.0,7,2,28,6391.0,0.48345768451690674,0.228194460272789
8052015,5819985,4655961,13095,8321,1998,4114,1987,4774,8981,0.0,0.0,10,4.0,6,11,483,3339.0,0.5634059309959412,0.03606020659208298
8051915,7240740,4933670,13095,11513,2007,5276,1990,1582,7819,1.0,0.0,3,40.0,12,2,259,238.0,0.4963218867778778,0.05482285097241402
8052597,4727417,7094389,13095,4436,1988,11191,2006,8659,1904,0.5,0.0,30,7.0,2,3,133,84.0,0.35412660241127014,0.01517653651535511
8059431,4903183,6956036,13102,5164,1990,10883,2005,7938,2219,0.5,0.0,14,5.0,5,13,56,847.0,0.429335355758667,0.07716933637857437
8060185,5188126,6490945,13102,6263,1993,9840,2002,6839,3262,1.0,0.0,80,16.0,6,13,0,301.0,0.3655710816383362,0.21702131628990173
8057399,7452334,4526202,13102,12010,2008,3470,1985,1092,9632,1.0,0.0,8,6.0,14,3,28,3829.0,0.38842231035232544,0.26877015829086304
8056784,7225956,5092414,13102,11478,2007,5906,1992,1624,7196,1.0,0.0,1,9.0,5,6,1624,455.0,0.5757953524589539,0.2767080068588257
8060247,5997170,4474841,13102,8741,1999,3197,1984,4361,9905,1.0,0.0,84,3.0,17,1,42,2254.0,0.6742250323295593,0.24143601953983307
8059449,6972428,7762145,13102,10932,2005,12626,2010,2170,476,0.0,0.0,62,1.0,4,2,35,476.0,0.5930066108703613,0.09978685528039932
8060840,5973315,4038061,13102,8699,1999,572,1977,4403,12530,0.0,0.0,42,17.0,12,1,0,84.0,0.2142324298620224,0.1938009262084961
8060285,5944783,7574097,13102,8643,1999,12276,2009,4459,826,1.0,0.0,57,1.0,8,1,21,826.0,0.6341292262077332,0.17261554300785065
8059196,6598331,7014702,13102,10071,2003,11037,2006,3031,2065,0.0,0.0,16,4.0,12,3,14,497.0,0.3429514467716217,0.10785484313964844
8056419,6304840,7817609,13102,9420,2001,12710,2010,3682,392,0.0,0.0,22,1.0,9,4,14,392.0,0.18384411931037903,0.260513037443161
8060234,6950547,6083216,13102,10862,2005,8951,2000,2240,4151,1.0,0.0,13,20.0,14,22,21,7.0,0.47441306710243225,0.13161681592464447
8057549,6063121,4375810,13102,8902,2000,2623,1983,4200,10479,1.0,1.0,214,15.0,21,1,0,476.0,0.5499497652053833,0.4130527675151825
8056924,7731224,4860929,13102,12577,2010,4989,1989,525,8113,1.0,0.0,4,14.0,12,5,14,399.0,0.4720684289932251,0.1411208063364029
8062231,7073246,7805892,13109,11149,2006,12696,2010,1960,413,0.0,0.0,55,1.0,67,6,70,413.0,0.3208144009113312,0.10950484871864319
8062408,7637987,7424789,13109,12416,2009,11947,2008,693,1162,1.0,0.0,1,1.0,3,26,693,1162.0,0.5266672372817993,0.22142544388771057
8062789,5256503,5038920,13109,6508,1993,5703,1991,6601,7406,1.0,0.0,10,7.0,5,2,210,133.0,0.31082814931869507,0.156925231218338
8061787,4836622,4011173,13109,4905,1989,432,1977,8204,12677,0.5,0.0,9,50.0,1,2,266,2877.0,0.45618724822998047,0.1759025603532791
8065739,6453338,4345570,13109,9756,2002,2427,1982,3353,10682,1.0,0.0,24,7.0,40,4,35,3920.0,0.27234596014022827,0.19742916524410248
8063436,6713810,5847631,13109,10316,2004,8377,1998,2793,4732,1.0,1.0,35,7.0,4,9,0,490.0,0.4887283444404602,0.33229196071624756
8061492,5169018,7036479,13109,6186,1992,11079,2006,6923,2030,0.0,0.0,9,2.0,13,1,966,1533.0,0.5104624629020691,0.16247302293777466
8065201,5297249,4293080,13109,6655,1994,2105,1981,6454,11004,1.0,0.0,368,37.0,6,2,21,154.0,0.4270783066749573,0.18530413508415222
8064908,7289809,4379643,13109,11625,2007,2658,1983,1484,10451,1.0,0.0,2,3.0,5,1,308,2387.0,0.7108597159385681,0.09296563267707825
8063986,6914637,7700404,13109,10778,2005,12528,2010,2331,581,0.5,0.0,71,2.0,20,5,7,42.0,0.23601889610290527,0.024026671424508095
8062314,5501693,5333920,13109,7390,1996,6788,1994,5719,6321,1.0,0.0,31,9.0,27,1,7,1253.0,0.44777318835258484,0.17704640328884125
8069405,7200507,4001649,13116,11415,2007,369,1977,1701,12747,1.0,0.0,13,26.0,19,1,0,14.0,0.3626238703727722,0.36157599091529846
8068670,7796815,4650082,13116,12675,2010,4093,1987,441,9023,1.0,0.0,2,14.0,11,3,105,3556.0,1.0000001192092896,0.16413544118404388
8068933,4906828,6029909,13116,5178,1990,8825,2000,7938,4291,1.0,0.0,143,10.0,8,7,7,805.0,0.191746324300766,0.2278575748205185
8069369,6857013,4053840,13116,10638,2005,649,1977,2478,12467,1.0,0.0,51,9.0,64,1,7,2667.0,0.7149737477302551,0.13123217225074768
8066063,6557629,4089463,13116,9987,2003,866,1978,3129,12250,1.0,0.0,33,31.0,2,1,112,203.0,0.3748999536037445,0.28221338987350464
8070597,5761647,5238015,13123,8188,1998,6445,1993,4935,6678,0.0,0.0,331,5.0,12,6,0,1582.0,0.470937579870224,0.03355325758457184
8070014,6422412,6293270,13123,9700,2002,9399,2001,3423,3724,1.0,0.0,8,9.0,4,5,371,266.0,0.5486359000205994,0.2846164107322693
8070805,7189199,4039725,13123,11394,2007,579,1977,1729,12544,1.0,0.0,17,2.0,248,1,7,11144.0,0.5979292988777161,0.0943688154220581
8069745,4831897,7475190,13123,4891,1989,12059,2009,8232,1064,1.0,0.0,7,1.0,2,22,665,1064.0,0.30994102358818054,0.02704133652150631
8076111,5142834,4008756,13130,6088,1992,418,1977,7042,12712,0.0,0.0,28,4.0,12,2,105,8162.0,0.09845668822526932,0.18353906273841858
8075550,7703486,7300327,13130,12535,2010,11653,2007,595,1477,0.0,0.0,5,1.0,7,5,70,1477.0,0.3704416751861572,0.15516316890716553
8075837,5951243,6877146,13130,8657,1999,10687,2005,4473,2443,0.0,0.0,20,8.0,78,129,273,112.0,0.7296152710914612,0.16804616153240204
8074894,4807700,7390406,13130,4807,1989,11863,2008,8323,1267,0.0,0.0,13,1.0,6,24,1533,1267.0,0.2545270025730133,0.29667776823043823
8077305,5018853,4894823,13130,5626,1991,5129,1990,7504,8001,1.0,0.0,38,21.0,4,9,161,322.0,0.45888590812683105,0.16138407588005066
8074353,7586319,6738682,13130,12304,2009,10365,2004,826,2765,0.5,0.0,1,20.0,23,14,826,21.0,1.0,0.0947619080543518
8078101,5339330,6629406,13130,6802,1994,10141,2003,6328,2989,1.0,0.0,257,1.0,14,13,7,2989.0,0.5958972573280334,0.2656177580356598
8079531,4796804,7784234,13137,4758,1989,12661,2010,8379,476,1.0,0.0,13,1.0,1,27,385,476.0,0.6780928373336792,0.23443035781383514
8080726,5476553,4887198,13137,7292,1995,5094,1989,5845,8043,1.0,0.0,33,4.0,12,1,7,4284.0,0.5748505592346191,0.11762019246816635
8079945,7153465,5763118,13137,11317,2006,8195,1998,1820,4942,0.0,0.0,2,14.0,2,7,574,301.0,0.285097599029541,0.2305421680212021
8079991,5556375,5363746,13137,7565,1996,6893,1994,5572,6244,1.0,0.0,114,15.0,37,29,7,21.0,0.3918915390968323,0.2778657376766205
8079426,7021402,4280031,13137,11051,2006,2028,1981,2086,11109,1.0,0.0,14,3.0,11,3,21,8568.0,0.4888664484024048,0.1913704127073288
8082221,5168446,4473218,13137,6179,1992,3190,1984,6958,9947,1.0,0.0,255,10.0,40,8,0,371.0,0.3162534832954407,0.1853180080652237
8085564,4404472,7329737,13144,2812,1983,11730,2008,10332,1414,1.0,0.0,62,1.0,1,1,56,1414.0,0.5661057829856873,0.13176290690898895
8087087,6907430,5092812,13144,10757,2005,5906,1992,2387,7238,1.0,0.0,29,9.0,15,4,28,35.0,0.5272518396377563,0.18828782439231873
8083085,4478344,5213912,13144,3218,1984,6354,1993,9926,6790,0.5,0.0,23,15.0,3,6,161,28.0,0.4168856739997864,0.06525641679763794
8086510,6157918,7684198,13144,9105,2000,12500,2010,4039,644,1.0,0.0,71,3.0,21,12,21,210.0,0.3879179358482361,0.2700575292110443
8083601,5624321,4525781,13144,7789,1997,3463,1985,5355,9681,1.0,0.0,13,13.0,7,5,21,196.0,0.4534609019756317,0.15091635286808014
8083528,6448803,4378239,13144,9749,2002,2644,1983,3395,10500,0.0,0.0,2,2.0,12,3,2058,9506.0,0.5545667409896851,-0.028927264735102654
8083386,7175291,6095212,13144,11366,2007,8979,2000,1778,4165,0.5,0.0,44,1.0,10,2,21,4165.0,0.7057147026062012,0.035911913961172104
8086564,7003694,4638089,13144,11009,2006,4037,1987,2135,9107,1.0,0.0,13,7.0,6,3,140,952.0,0.7365943193435669,0.17685507237911224
8085009,8004255,5878071,13144,13018,2011,8461,1999,126,4683,1.0,0.0,1,16.0,152,5,126,224.0,0.5682458281517029,0.1766667515039444
8086913,6154851,6145011,13144,9098,2000,9077,2000,4046,4067,0.0,0.0,43,10.0,13,4,77,21.0,0.6593971848487854,0.2738059461116791
8083401,5627577,5007418,13144,7796,1997,5584,1991,5348,7560,1.0,0.0,7,5.0,4,17,308,1134.0,0.701955258846283,0.3290032744407654
8083802,5370699,6227279,13144,6914,1994,9259,2001,6230,3885,1.0,0.0,62,5.0,23,1,14,7.0,0.6149519085884094,0.23137116432189941
8090573,5737484,5159871,13151,8132,1998,6151,1992,5019,7000,1.0,0.0,29,3.0,2,2,91,6125.0,0.5680986046791077,0.29869207739830017
8089054,5349198,4276329,13151,6837,1994,2007,1981,6314,11144,0.5,0.0,19,17.0,2,2,35,1176.0,0.47970712184906006,-0.003204189706593752
8090973,6961347,7461759,13151,10897,2005,12031,2008,2254,1120,0.0,0.0,25,6.0,12,118,63,84.0,0.4722449779510498,0.3045760989189148
8088234,6562154,5542179,13151,9994,2003,7523,1996,3157,5628,1.0,0.0,22,5.0,35,5,112,1169.0,0.5711180567741394,0.19227923452854156
8087162,5589045,4763743,13151,7670,1996,4611,1988,5481,8540,0.0,0.0,34,1.0,2,2,7,8540.0,0.4282327890396118,0.037599723786115646
8089795,7414917,5115996,13151,11919,2008,5990,1992,1232,7161,1.0,0.0,7,28.0,7,2,14,133.0,0.6045160889625549,0.35996386408805847
8089227,7049790,4772060,13151,11100,2006,4646,1988,2051,8505,0.0,0.0,1,11.0,4,4,2051,322.0,0.6654927730560303,0.25349777936935425
8094938,6493464,5797685,13158,9840,2002,8272,1998,3318,4886,1.0,0.0,52,13.0,53,4,35,196.0,0.6622638702392578,0.2263326644897461
8095533,5832476,4455051,13158,8342,1998,3092,1984,4816,10066,1.0,0.0,62,7.0,10,4,126,4193.0,0.5857170224189758,0.08190042525529861
8093354,7728104,7016740,13158,12570,2010,11037,2006,588,2121,1.0,0.0,1,3.0,18,7,588,1295.0,1.0,0.19921423494815826
8091272,4384537,7700262,13158,2700,1983,12528,2010,10458,630,1.0,0.0,9,1.0,3,9,210,630.0,0.4456425607204437,0.2306719720363617
8092514,5882444,4336880,13158,8475,1999,2371,1982,4683,10787,0.5,0.0,15,12.0,5,1,217,2359.0,0.34766367077827454,0.16938941180706024
8095659,6477580,4215525,13158,9805,2002,1678,1980,3353,11480,1.0,0.0,195,9.0,11,1,7,1029.0,0.3119274079799652,0.18810626864433289
8091754,5383880,5651324,13158,6963,1995,7880,1997,6195,5278,1.0,0.0,256,6.0,3,3,0,476.0,0.36969202756881714,0.43621429800987244
8091816,4789289,7727222,13158,4723,1988,12570,2010,8435,588,0.0,0.0,27,2.0,8,48,1078,245.0,0.42941707372665405,0.2743019759654999
8094002,6184679,5361003,13158,9168,2001,6879,1994,3990,6279,0.0,0.0,45,5.0,8,5,14,350.0,0.14055022597312927,0.1066935658454895
8092151,7802961,4330749,13158,12689,2010,2329,1982,469,10829,1.0,0.0,4,19.0,3,2,49,777.0,0.5425301790237427,0.011085333302617073
8091625,4930454,7029489,13158,5269,1990,11065,2006,7889,2093,0.0,0.0,20,4.0,22,112,21,14.0,0.4923279881477356,0.30815550684928894
8092459,5201734,4446959,13158,6312,1993,3050,1984,6846,10108,1.0,0.0,142,2.0,23,2,14,1932.0,0.45987245440483093,0.3844676911830902
8094315,6218111,5848997,13158,9238,2001,8384,1998,3920,4774,0.0,0.0,13,15.0,2,5,329,217.0,0.292400062084198,-0.039242420345544815
8092530,5236462,4354503,13158,6438,1993,2483,1982,6720,10675,1.0,1.0,20,18.0,7,2,42,3766.0,0.3987758457660675,0.053554926067590714
8096994,5628756,6702320,13165,7803,1997,10295,2004,5362,2870,1.0,0.0,179,7.0,3,7,7,518.0,0.4793628752231598,0.14730876684188843
8096961,5372596,4725114,13165,6921,1994,4429,1988,6244,8736,1.0,0.0,78,6.0,5,8,21,1253.0,0.23748740553855896,0.2791912853717804
8096006,6131214,7566071,13165,9056,2000,12262,2009,4109,903,0.5,0.0,14,4.0,9,13,406,238.0,0.6216918230056763,0.2121386080980301
8098293,4804983,4142591,13165,4793,1989,1160,1979,8372,12005,0.3333333333333333,0.0,20,20.0,5,4,238,259.0,0.4161714017391205,0.347794771194458
8096303,5954057,4596993,13165,8664,1999,3827,1986,4501,9338,1.0,0.0,57,12.0,12,7,56,4494.0,0.38638243079185486,0.18981975317001343
8098055,6369462,4868641,13165,9595,2002,5010,1989,3570,8155,0.0,0.0,19,7.0,1,3,7,3437.0,0.37839776277542114,0.21642912924289703
8098253,6005572,4161438,13165,8755,1999,1293,1979,4410,11872,0.0,0.0,12,2.0,6,1,483,7455.0,0.6002846360206604,0.20281372964382172
8097003,6873352,4302891,13165,10680,2005,2161,1981,2485,11004,0.0,0.0,12,12.0,8,1,21,231.0,0.32793959975242615,0.2453424334526062
8096097,6883297,4674343,13165,10708,2005,4191,1987,2457,8974,0.5,0.0,27,9.0,30,2,119,2681.0,0.6655752658843994,0.4042600989341736
8098753,7555054,5910637,13165,12234,2009,8559,1999,931,4606,1.0,0.0,22,14.0,187,11,21,637.0,0.6014604568481445,0.11553836613893509
8102018,6707098,6426294,13172,10302,2004,9707,2002,2870,3465,0.5,0.5,99,8.0,5,10,0,287.0,0.4388400912284851,0.10924870520830154
8103496,7099818,4298175,13172,11198,2006,2133,1981,1974,11039,1.0,0.0,24,9.0,19,1,14,1078.0,0.4503324031829834,0.12439554184675217
8104079,6957330,7078937,13172,10883,2005,11156,2006,2289,2016,0.0,0.0,11,7.0,21,8,84,420.0,0.37138837575912476,0.09104550629854202
8099835,7140172,6083654,13172,11289,2006,8951,2000,1883,4221,1.0,0.0,1,12.0,2,16,1883,1386.0,0.469836950302124,0.15390482544898987
8101343,6451603,4959346,13172,9756,2002,5381,1990,3416,7791,0.6666666666666666,0.0,5,10.0,1,1,56,2681.0,0.3693245053291321,-0.019486840814352036
8101134,5244718,6660833,13172,6466,1993,10204,2003,6706,2968,0.0,1.0,29,6.0,4,4,287,588.0,0.4251311421394348,0.199041485786438
8100776,6872145,4753080,13172,10680,2005,4562,1988,2492,8610,1.0,0.0,3,16.0,7,4,105,1379.0,0.2714274525642395,0.06954162567853928
8102092,5583387,7400124,13172,7649,1996,11884,2008,5523,1288,1.0,0.0,96,1.0,1,12,336,1288.0,0.4956112504005432,0.09366822242736816
8105654,4950541,6037360,13179,5346,1990,8839,2000,7833,4340,0.0,0.0,60,5.0,19,22,49,623.0,0.4642144441604614,0.16423359513282776
8107594,6490444,7365363,13179,9833,2002,11807,2008,3346,1372,0.0,1.0,8,2.0,19,4,98,609.0,0.4087201654911041,0.22160325944423676
8108543,5384622,4734419,13179,6963,1995,4471,1988,6216,8708,0.0,0.0,30,8.0,18,3,14,154.0,0.3125115931034088,0.01632719486951828
8108826,6637026,5264241,13179,10155,2003,6536,1993,3024,6643,1.0,0.0,3,7.0,7,1,1022,7.0,0.25812867283821106,0.16771166026592255
8104190,5852880,5430716,13179,8398,1998,7124,1995,4781,6055,1.0,0.0,10,18.0,6,14,224,1414.0,0.41905996203422546,0.18296769261360168
8105299,5879499,5692556,13179,8468,1999,8006,1997,4711,5173,1.0,0.0,64,6.0,71,5,7,210.0,0.42164576053619385,0.05978164076805115
8106853,5745086,6790912,13179,8153,1998,10484,2004,5026,2695,1.0,0.0,143,13.0,13,12,21,77.0,0.44258493185043335,0.17631907761096954
8105527,6103176,7195084,13179,8993,2000,11408,2007,4186,1771,1.0,0.0,9,9.0,33,73,665,49.0,0.44231390953063965,0.3243710398674011
8105495,6245900,4940107,13179,9294,2001,5304,1990,3885,7875,0.0,0.0,24,9.0,5,9,14,336.0,0.37759941816329956,0.2007506936788559
8108777,7266773,6405359,13179,11569,2007,9658,2002,1610,3521,1.0,1.0,8,7.0,7,2,105,1092.0,0.5994783043861389,0.04438667371869087
8107921,5838252,4694350,13179,8356,1998,4275,1987,4823,8904,1.0,1.0,147,10.0,8,6,0,3801.0,0.22179614007472992,0.1071295365691185
8110195,6057115,4935863,13186,8888,2000,5283,1990,4298,7903,0.0,0.0,4,9.0,7,6,14,371.0,0.723441481590271,0.27397599816322327
8109032,6817728,6222356,13186,10547,2004,9245,2001,2639,3941,1.0,0.0,4,13.0,4,4,455,7.0,0.31869736313819885,0.10352601110935211
8109033,5165194,4759081,13186,6172,1992,4583,1988,7014,8603,1.0,0.0,2,5.0,2,2,6202,980.0,0.6929230093955994,0.3486710488796234
8110594,6479063,3984552,13186,9812,2002,278,1976,3374,12908,1.0,0.5,4,3.0,3,1,119,378.0,0.2741796672344208,0.4440568685531616
8112420,6011895,6968964,13186,8769,2000,10925,2005,4417,2261,0.0,0.0,54,2.0,7,15,98,637.0,0.47252172231674194,0.15576699376106262
8112549,6587684,7308930,13186,10043,2003,11674,2007,3143,1512,0.0,0.0,149,1.0,26,4,0,1512.0,0.44667741656303406,0.1754198521375656
8110376,6238890,4188254,13186,9280,2001,1503,1980,3906,11683,0.5,0.0,15,16.0,7,5,21,252.0,0.3484417200088501,0.167454794049263
8116841,6988989,4873754,13193,10981,2006,5038,1989,2212,8155,1.0,0.0,14,6.0,8,1,35,2877.0,0.44249966740608215,0.2500189542770386
8120926,4558916,5656998,13200,3638,1985,7894,1997,9562,5306,0.0,0.0,12,26.0,6,4,749,77.0,0.37665683031082153,0.17824414372444153
8119012,5813246,4794910,13200,8307,1998,4751,1989,4893,8449,0.0,0.0,15,17.0,5,13,189,1848.0,0.3956491947174072,0.3024287819862366
8119314,7202002,5459173,13200,11422,2007,7229,1995,1778,5971,1.0,0.0,2,2.0,12,6,42,4739.0,0.31441086530685425,0.2683986723423004
8119472,6066545,4430899,13200,8909,2000,2966,1984,4291,10234,1.0,0.0,111,16.0,2,1,7,7.0,0.4115910232067108,0.24999982118606567
8118620,6961598,6509711,13200,10897,2005,9882,2003,2303,3318,0.0,0.0,99,8.0,116,16,14,7.0,0.29732629656791687,0.0986497774720192
8121450,5605600,4161438,13200,7726,1997,1293,1979,5474,11907,0.0,0.0,22,2.0,19,1,182,7490.0,0.46921053528785706,0.17731641232967377
8119157,5998365,6018352,13200,8741,1999,8790,2000,4459,4410,1.0,0.0,15,6.0,1,6,203,1757.0,0.5207398533821106,-0.03841068968176842
8125940,5574979,6442895,13207,7621,1996,9742,2002,5586,3465,1.0,0.0,126,3.0,4,5,14,336.0,0.21611978113651276,0.28136640787124634
8127081,6460108,4592533,13207,9770,2002,3806,1986,3437,9401,1.0,0.0,34,19.0,24,1,63,7.0,0.29316988587379456,0.107660211622715
8124854,5276266,4142364,13207,6578,1994,1160,1979,6629,12047,1.0,0.0,285,11.0,1,1,0,2002.0,0.6640101075172424,0.13324271142482758
8127577,7823424,4848745,13214,12724,2010,4947,1989,490,8267,1.0,0.0,5,14.0,25,24,42,42.0,0.7089232802391052,0.22792202234268188
8129393,6130222,6359356,13214,9049,2000,9574,2002,4165,3640,1.0,0.0,15,5.0,3,5,168,742.0,0.6853708028793335,0.08999653905630112
8130184,6340976,5760733,13214,9518,2002,8188,1998,3696,5026,1.0,0.0,31,2.0,19,4,168,4382.0,0.3664611577987671,0.2744143009185791
8130560,7003639,4502909,13214,11009,2006,3351,1985,2205,9863,0.0,0.0,29,9.0,7,1,28,1463.0,0.539317786693573,0.2874525785446167
8129408,5472704,7707801,13214,7278,1995,12542,2010,5936,672,0.0,0.0,70,1.0,4,68,42,672.0,0.53016197681427,0.22379213571548462
8128595,5004461,4015094,13214,5570,1991,453,1977,7644,12761,1.0,0.0,36,16.0,9,1,126,462.0,0.31280648708343506,0.3006086051464081
8129190,6274381,6361245,13214,9357,2001,9581,2002,3857,3633,0.5,0.0,17,5.0,9,8,336,721.0,0.555404543876648,0.1738172024488449
8129403,7528142,4300912,13214,12178,2009,2147,1981,1036,11067,1.0,0.0,4,7.0,55,1,0,238.0,0.6868364214897156,0.40248769521713257
8130237,6421058,5152904,13214,9693,2002,6123,1992,3521,7091,0.0,0.0,44,8.0,75,4,0,91.0,0.4845938980579376,0.05077390745282173
8134425,5659274,4984486,13221,7901,1997,5493,1991,5320,7728,0.5,0.0,16,5.0,6,12,14,4326.0,0.3716264069080353,0.15733365714550018
8134103,7026980,4260037,13221,11058,2006,1923,1981,2163,11298,0.0,0.0,13,11.0,10,1,7,2954.0,0.6724476218223572,0.20333720743656158
8135465,5902324,6068066,13221,8531,1999,8916,2000,4690,4305,1.0,0.0,157,7.0,2,3,7,147.0,0.5753852128982544,0.06712742894887924
8133101,6758745,4627907,13221,10414,2004,3995,1986,2807,9226,1.0,0.0,7,3.0,3,2,0,3010.0,0.5052348971366882,0.173434779047966
8135050,re37585,6501115,13221,9574,2002,9861,2002,3647,3360,0.0,1.0,38,10.0,44,8,14,189.0,0.10533003509044647,0.20522263646125793
8134857,7423300,4237346,13221,11940,2008,1797,1980,1281,11424,0.0,0.0,56,2.0,126,1,35,10633.0,0.5858520269393921,0.004991712048649788
8135641,6052673,6805782,13221,8874,2000,10519,2004,4347,2702,1.0,0.0,82,2.0,7,5,0,490.0,0.2570324242115021,0.3821226954460144
8140601,7881315,7660358,13228,12815,2011,12458,2010,413,770,0.0,0.0,2,1.0,4,40,70,770.0,0.3966626524925232,0.17350883781909943
8138823,6328697,7231924,13228,9476,2001,11492,2007,3752,1736,0.5,0.0,31,2.0,4,8,196,21.0,0.4349880814552307,0.16359660029411316
8136527,4469097,4423898,13228,3169,1984,2924,1984,10059,10304,0.5,0.0,22,5.0,6,2,315,5187.0,0.3854617178440094,0.3265020549297333
8138254,5618631,4485418,13228,7768,1997,3253,1984,5460,9975,0.0,0.0,7,30.0,13,2,70,2359.0,0.5612325072288513,0.061235103756189346
8137766,7135211,6830616,13228,11275,2006,10575,2004,1953,2653,1.0,0.0,4,5.0,12,21,231,875.0,0.6311482191085815,0.28528642654418945
8143043,4908404,4353591,13235,5185,1990,2476,1982,8050,10759,0.0,0.0,39,9.0,17,1,35,1036.0,0.37744128704071045,0.1708269715309143
8145310,7139610,7243865,13235,11282,2006,11520,2007,1953,1715,1.0,0.0,18,1.0,22,9,42,1715.0,0.602999210357666,0.014404724352061749
8141504,5220876,5086259,13235,6382,1993,5878,1992,6853,7357,1.0,0.0,98,8.0,18,2,1470,3276.0,0.44655683636665344,0.3172653615474701
8142236,6054758,7890202,13235,8881,2000,12829,2011,4354,406,1.0,0.0,14,1.0,4,8,567,406.0,0.3549303114414215,0.20031601190567017
8143723,5389568,6953461,13235,6984,1995,10876,2005,6251,2359,1.0,0.0,58,8.0,3,110,707,21.0,0.49984586238861084,0.2887551188468933
8145765,6487555,4148688,13235,9826,2002,1195,1979,3409,12040,1.0,0.0,47,3.0,14,2,154,5166.0,0.19870907068252563,0.1718466430902481
8142278,5280909,5203154,13235,6599,1994,6319,1993,6636,6916,0.5,0.0,283,29.0,11,6,7,35.0,0.41752591729164124,0.15917983651161194
8144767,7295609,5940163,13235,11639,2007,8629,1999,1596,4606,1.0,0.0,6,9.0,4,24,231,217.0,0.759566605091095,0.30747804045677185
8143379,6075181,7358922,13235,8930,2000,11793,2008,4305,1442,0.3333333333333333,0.0,223,5.0,8,27,0,238.0,0.5376590490341187,0.11695592105388641
8142531,5779743,4031094,13235,8230,1998,537,1977,5005,12698,0.5,0.0,24,2.0,42,1,28,11641.0,0.629515528678894,0.09827663004398346
8141642,5645131,7288828,13235,7859,1997,11625,2007,5376,1610,1.0,0.0,89,1.0,3,8,35,1610.0,0.32190269231796265,0.12586620450019836
8142988,5776652,4404345,13235,8223,1998,2812,1983,5012,10423,1.0,0.0,3,15.0,6,14,1673,126.0,0.39672544598579407,0.3728024661540985
8144121,7786982,7556504,13235,12661,2010,12241,2009,574,994,0.3333333333333333,0.0,1,3.0,22,2,574,98.0,0.6213301420211792,0.3615967929363251
8142643,6306152,5366582,13235,9427,2001,6900,1994,3808,6335,0.0,0.0,125,2.0,17,3,0,5383.0,0.22914427518844604,0.06772033125162125
8150494,5913820,4370144,13242,8573,1999,2581,1983,4669,10661,0.0,0.0,185,10.0,10,3,0,2254.0,0.3234366178512573,0.3070347011089325
8146400,6464650,4749031,13242,9784,2002,4541,1988,3458,8701,0.0,0.0,12,8.0,6,3,7,1211.0,0.49139872193336487,0.3231275677680969
8149117,5333615,5189225,13242,6788,1994,6263,1993,6454,6979,0.0,0.0,11,1.0,5,1,28,6979.0,0.49496525526046753,0.05557934567332268
8147194,4569667,4148933,13242,3694,1986,1195,1979,9548,12047,0.0,0.0,6,25.0,4,2,1288,2429.0,0.44991520047187805,0.173306405544281
8149418,6790175,5233069,13242,10484,2004,6424,1993,2758,6818,0.0,0.0,54,8.0,3,1,7,1113.0,0.40359315276145935,-0.019955424591898918
8151980,5950815,5138377,13249,8657,1999,6067,1992,4592,7182,0.3333333333333333,0.0,7,45.0,7,12,875,14.0,0.7235425114631653,0.12377927452325821
8155096,6452913,4599719,13249,9756,2002,3841,1986,3493,9408,1.0,1.0,25,16.0,26,3,21,658.0,0.45005184412002563,0.34821075201034546
8156474,7000224,6829669,13249,11002,2006,10568,2004,2247,2681,1.0,1.0,28,8.0,19,7,91,175.0,0.5141682624816895,0.12192097306251526
8155178,6625234,6567106,13249,10127,2003,10001,2003,3122,3248,0.0,0.0,8,14.0,6,11,196,28.0,0.5109096765518188,0.3270224332809448
8151468,6886262,4465132,13249,10715,2005,3148,1984,2534,10101,1.0,0.0,4,2.0,1,6,273,7245.0,0.6495689749717712,0.18656761944293976
8152961,4665014,7650519,13249,4149,1987,12437,2010,9100,812,0.0,0.0,13,3.0,2,4,581,280.0,0.3999379277229309,0.1971883624792099
8155582,5077608,5361464,13249,5843,1991,6886,1994,7406,6363,0.5,0.0,132,5.0,7,8,56,224.0,0.2147274613380432,0.10710883885622025
8160184,6714148,5260031,13256,10316,2004,6522,1993,2940,6734,0.5,0.0,5,37.0,3,56,847,133.0,0.3605620861053467,0.1494956910610199
8159967,6400780,7583484,13256,9651,2002,12297,2009,3605,959,0.5,0.0,34,1.0,5,28,413,959.0,0.4857479929924011,0.05551353842020035
8160668,6801799,6531828,13256,10505,2004,9931,2003,2751,3325,1.0,0.0,76,9.0,52,8,21,140.0,0.4445793628692627,0.10401718318462372
8159227,7385400,5241498,13256,11849,2008,6452,1993,1407,6804,1.0,0.0,6,5.0,23,5,105,434.0,0.35480448603630066,-0.010347974486649036
8160496,8027666,4839785,13256,13053,2011,4912,1989,203,8344,1.0,0.0,1,23.0,9,6,203,385.0,0.3354649841785431,0.12351983785629272
8158959,7271401,4237895,13256,11583,2007,1804,1980,1673,11452,0.5,0.0,10,23.0,3,6,42,217.0,0.559057891368866,0.12689869105815887
8159227,6998844,4654181,13256,11002,2006,4107,1987,2254,9149,1.0,0.0,13,7.0,30,1,42,1981.0,0.6146584153175354,0.07270064949989319
8162739,6149156,7784234,13263,9091,2000,12661,2010,4172,602,1.0,0.0,146,1.0,3,27,14,602.0,0.4472355544567108,0.26809874176979065
8161584,5010611,7935208,13263,5598,1991,12906,2011,7665,357,1.0,0.0,56,1.0,4,13,287,357.0,0.6730785369873047,0.23015353083610535
8165291,7437646,4116170,13263,11975,2008,999,1978,1288,12264,0.0,0.0,1,6.0,8,3,1288,7581.0,0.1926519274711609,0.35719621181488037
8162251,6308909,5569826,13263,9434,2001,7607,1996,3829,5656,1.0,0.0,19,2.0,19,1,7,1617.0,0.5860151648521423,0.11235149949789047
8166178,7085825,4484064,13263,11170,2006,3246,1984,2093,10017,0.5,0.0,16,25.0,4,1,7,518.0,0.32873964309692383,0.23493200540542603
8163547,5350671,5806538,13263,6844,1994,8293,1998,6419,4970,0.6666666666666666,0.0,133,7.0,2,5,7,2009.0,0.6965687274932861,0.06478708982467651
8165880,5201028,4058470,13263,6305,1993,684,1977,6958,12579,1.0,0.0,3,8.0,10,1,98,6090.0,0.5250174403190613,0.2238367199897766
8166918,6568348,5331548,13270,10008,2003,6774,1994,3262,6496,1.0,0.0,18,25.0,5,10,7,147.0,0.6027254462242126,0.18077324330806732
8167873,5310566,5079605,13270,6704,1994,5850,1992,6566,7420,0.0,0.0,3,24.0,4,3,5054,1001.0,0.0550515241920948,0.009471510536968708
8169131,6682663,7687277,13270,10253,2004,12507,2010,3017,763,1.0,0.0,20,2.0,1,18,28,49.0,0.46503332257270813,0.19374129176139832
8170513,6363267,4119907,13270,9581,2002,1013,1978,3689,12257,1.0,0.0,19,11.0,4,1,0,448.0,0.32492595911026,0.10525180399417877
8170068,7028093,6350684,13270,11058,2006,9553,2002,2212,3717,0.0,0.0,3,4.0,7,6,840,868.0,0.5716419816017151,0.10822653770446777
8174085,8003422,5711269,13277,13018,2011,8062,1998,259,5215,1.0,0.0,1,13.0,3,4,259,49.0,0.6729252338409424,0.13442352414131165
8172016,4337958,7605676,13277,2378,1982,12346,2009,10899,931,0.0,0.0,31,1.0,3,6,0,931.0,0.4665731191635132,0.13413549959659576
8172228,6926272,6437782,13277,10813,2005,9728,2002,2464,3549,1.0,0.0,16,3.0,26,3,371,56.0,0.38074231147766113,0.1454753577709198
8175667,6397093,4173410,13277,9644,2002,1405,1979,3633,11872,1.0,0.0,62,9.0,2,1,42,8225.0,0.5559256076812744,0.22617770731449127
8172819,5591152,6022513,13277,7677,1997,8804,2000,5600,4473,1.0,0.0,75,20.0,17,10,7,70.0,0.40739384293556213,0.0918082520365715
8171893,5547494,6142214,13277,7537,1996,9077,2000,5740,4200,0.0,0.0,28,2.0,17,12,455,3255.0,0.3461146950721741,0.2741071283817291
8173851,7342144,4059531,13277,11758,2008,691,1977,1519,12586,1.0,0.0,14,8.0,23,1,182,595.0,0.6032642722129822,0.2811446785926819
8173199,6283949,5315828,13277,9378,2001,6725,1994,3899,6552,0.5,0.0,153,5.0,14,8,35,231.0,0.45253491401672363,0.1480850875377655
8175964,6366889,4851365,13277,9588,2002,4954,1989,3689,8323,1.0,0.0,38,45.0,11,10,147,532.0,0.28971341252326965,0.1689571589231491
8176259,7222220,5626735,13277,11464,2007,7796,1997,1813,5481,1.0,0.0,8,5.0,12,10,42,308.0,0.5265572667121887,0.12079095840454102
8173145,4952495,4328641,13277,5353,1990,2322,1982,7924,10955,0.0,0.0,12,9.0,8,3,252,280.0,0.4110560119152069,0.1953517198562622
8173692,5330741,7399568,13277,6774,1994,11884,2008,6503,1393,0.3333333333333333,0.0,27,2.0,3,1,0,861.0,0.3399503827095032,0.21759527921676636
8174299,6294924,4420665,13277,9399,2001,2903,1983,3878,10374,1.0,0.0,25,3.0,43,4,217,8134.0,0.35848096013069153,0.16596128046512604
8175190,7339457,6553556,13277,11751,2008,9973,2003,1526,3304,0.0,0.0,4,10.0,6,6,490,154.0,0.32547155022621155,0.1821163445711136
8175730,7317958,4411804,13277,11695,2008,2854,1983,1582,10423,0.5,0.0,5,4.0,9,4,70,980.0,0.40251457691192627,0.11269309371709824
8180668,5836011,4502909,13284,8349,1998,3351,1985,4935,9933,1.0,0.0,43,9.0,20,1,77,1533.0,0.4195219576358795,0.2727087140083313
8181016,5701471,4160118,13284,8027,1997,1279,1979,5257,12005,0.0,0.0,50,2.0,11,1,56,9800.0,0.29595887660980225,0.1912621408700943
8178750,5750867,6627600,13284,8167,1998,10134,2003,5117,3150,1.0,0.0,23,2.0,4,25,252,98.0,0.594055712223053,0.06322304904460907
8177203,6382608,7733936,13284,9623,2002,12577,2010,3661,707,1.0,0.0,20,2.0,2,5,126,420.0,0.7465459704399109,0.13331662118434906
8180547,5351779,4566068,13284,6851,1994,3673,1986,6433,9611,1.0,0.0,10,12.0,2,4,343,1169.0,0.600333034992218,0.2767142057418823
8179338,6587118,7398299,13284,10043,2003,11877,2008,3241,1407,1.0,0.0,22,3.0,13,28,35,441.0,0.56683349609375,0.17585738003253937
8176986,7845417,4794680,13284,12759,2010,4751,1989,525,8533,1.0,0.0,2,21.0,8,21,42,1582.0,0.9217978119850159,0.1668495535850525
8176787,6875177,4948321,13284,10687,2005,5339,1990,2597,7945,0.5,0.0,1,6.0,19,13,2597,1267.0,0.4814903736114502,0.1559775024652481
8178784,6627314,7189440,13284,10134,2003,11394,2007,3150,1890,0.0,0.0,27,7.0,15,1,7,805.0,0.27956846356391907,0.1869606226682663
8177620,6309300,4688688,13284,9434,2001,4254,1987,3850,9030,0.5,0.0,390,5.0,16,2,0,448.0,0.6509302854537964,0.352191686630249
8181177,7584232,7400661,13284,12297,2009,11884,2008,987,1400,1.0,0.0,3,1.0,2,6,224,1400.0,0.5765366554260254,0.1470186710357666
8176782,5488862,4354552,13284,7341,1996,2483,1982,5943,10801,1.0,0.0,131,11.0,5,2,28,238.0,0.3148881793022156,0.23300430178642273
8185840,4570217,7702678,13291,3694,1986,12528,2010,9597,763,1.0,1.0,294,1.0,5,7,21,763.0,0.43588873744010925,0.15118403732776642
8185813,5596700,7210766,13291,7691,1997,11443,2007,5600,1848,1.0,0.0,123,1.0,7,5,70,1848.0,0.42577964067459106,0.24073229730129242
8185441,6466917,4354632,13291,9784,2002,2483,1982,3507,10808,1.0,0.0,70,3.0,71,3,14,2142.0,0.15381436049938202,0.08824294060468674
8185224,6793491,4692388,13291,10491,2004,4268,1987,2800,9023,0.0,0.0,9,4.0,5,1,42,91.0,0.4979827404022217,0.12245651334524155
8182514,6416515,4593980,13291,9686,2002,3813,1986,3605,9478,1.0,0.0,123,3.0,236,1,7,4669.0,0.4605771601200104,0.14787356555461884
8181559,5249496,7692195,13291,6487,1993,12514,2010,6804,777,0.0,0.0,52,1.0,6,4,119,777.0,0.4911426603794098,0.15970146656036377
8184974,7344102,7192082,13291,11765,2008,11401,2007,1526,1890,0.0,0.0,1,1.0,3,4,1526,1890.0,0.21421381831169128,0.2513868808746338
8185241,6636781,4352550,13291,10155,2003,2469,1982,3136,10822,0.0,0.0,21,23.0,5,7,63,4956.0,0.2596644163131714,0.3310167193412781
8182040,5100202,4120604,13291,5934,1992,1020,1978,7357,12271,1.0,0.0,16,14.0,10,2,140,2730.0,0.5503215193748474,0.32005277276039124
8182693,5635071,6049484,13291,7824,1997,8867,2000,5467,4424,1.0,0.0,23,10.0,16,10,7,1512.0,0.5664515495300293,0.23257069289684296
8184940,6614980,4359677,13291,10106,2003,2511,1982,3185,10780,1.0,0.0,68,7.0,7,3,63,1897.0,0.5057951807975769,-0.016199134290218353
8184453,5766972,5181757,13291,8202,1998,6235,1993,5089,7056,0.0,0.0,127,7.0,20,5,84,903.0,0.5416226983070374,0.22615133225917816
8191080,7774772,7095638,13298,12640,2010,11191,2006,658,2107,1.0,0.0,2,3.0,10,10,119,77.0,0.5180720090866089,0.19245274364948273
8186349,6796309,7579377,13298,10498,2004,12290,2009,2800,1008,1.0,0.5,10,3.0,21,2,56,553.0,0.6732320189476013,0.08564701676368713
8190170,6131121,6530474,13298,9049,2000,9931,2003,4249,3367,0.0,0.0,153,5.0,4,8,0,1365.0,0.44647571444511414,0.18353775143623352
8187304,5893889,4171532,13298,8503,1999,1384,1979,4795,11914,1.0,0.0,319,6.0,5,2,0,5859.0,0.3527814447879791,0.28924307227134705
8187619,5955110,4474841,13298,8664,1999,3197,1984,4634,10101,1.0,0.0,78,3.0,14,1,84,2450.0,0.5043744444847107,0.18757851421833038
8188632,4270065,4413429,13298,1972,1981,2868,1983,11326,10430,1.0,0.0,7,21.0,1,1,91,777.0,0.4657438099384308,0.0916404202580452
8189139,6911271,5166793,13298,10771,2005,6172,1992,2527,7126,0.0,0.0,19,4.0,5,6,357,1841.0,0.30663394927978516,0.2776308059692383
8189747,7177415,4047165,13298,11366,2007,614,1977,1932,12684,1.0,0.0,4,10.0,7,1,245,4956.0,0.4635258615016937,0.2482690066099167
8194133,6046837,4532713,13305,8860,2000,3505,1985,4445,9800,0.0,0.0,62,16.0,8,1,21,49.0,0.2959412634372711,0.23385830223560333
8195296,5312439,4906676,13305,6711,1994,5178,1990,6594,8127,1.0,0.0,196,12.0,2,9,14,1253.0,0.4401862919330597,0.18437063694000244
8192733,6399114,5904158,13305,9651,2002,8538,1999,3654,4767,0.0,0.0,8,1.0,9,8,686,4767.0,0.49104568362236023,-0.03318355232477188
8194008,6518962,5592357,13305,9903,2003,7677,1997,3402,5628,1.0,0.0,127,11.0,10,19,0,994.0,0.4493507444858551,0.2657862901687622
8191837,7719832,6343011,13305,12556,2010,9525,2002,749,3780,0.0,0.0,1,26.0,16,5,749,14.0,0.4386143088340759,0.49409720301628113
8192480,5476472,5961918,13305,7292,1995,8678,1999,6013,4627,1.0,0.0,68,2.0,3,12,28,343.0,0.24365337193012238,0.051147136837244034
8195752,6175621,5248279,13305,9147,2001,6480,1993,4158,6825,0.0,0.0,35,12.0,10,91,14,2730.0,0.4405824840068817,0.1100502610206604
8192435,5341807,6334732,13305,6816,1994,9497,2002,6489,3808,1.0,0.0,258,1.0,17,10,7,3808.0,0.3284054398536682,0.3858872056007385
8192677,4849469,6634971,13305,4947,1989,10155,2003,8358,3150,0.0,0.0,23,2.0,3,14,2247,252.0,0.3789975345134735,0.23894023895263672
8195985,7246159,5264296,13305,11520,2007,6536,1993,1785,6769,1.0,0.0,28,4.0,2,9,0,5341.0,0.3311271369457245,0.095247283577919
8197335,6471208,4471363,13312,9798,2002,3176,1984,3514,10136,1.0,0.0,210,2.0,38,9,7,1141.0,0.733864963054657,0.25758546590805054
8198164,6249984,5186987,13312,9308,2001,6256,1993,4004,7056,0.0,0.0,11,20.0,27,6,378,112.0,0.3768461048603058,0.062140870839357376
8199933,5583962,4234837,13312,7649,1996,1783,1980,5663,11529,0.0,0.0,97,4.0,10,5,35,2940.0,0.39739561080932617,0.23808838427066803
8201152,5687375,6648356,13312,7985,1997,10183,2003,5327,3129,1.0,0.0,24,3.0,12,5,21,2611.0,0.6611437797546387,0.2662581205368042
8199663,5729535,4602640,13312,8111,1998,3862,1986,5201,9450,1.0,0.0,13,8.0,8,2,84,1547.0,0.47789445519447327,0.12121100723743439
8199446,6215102,5703701,13312,9231,2001,8034,1997,4081,5278,0.0,0.0,3,27.0,21,5,1330,1379.0,0.4086352586746216,0.3068728744983673
8197802,5167960,7785037,13312,6179,1992,12661,2010,7133,651,0.5,0.0,66,1.0,13,18,56,651.0,0.4685170650482178,0.06389271467924118
8197335,6019374,5422833,13312,8797,2000,7096,1995,4515,6216,1.0,0.0,145,27.0,19,12,7,175.0,0.6555217504501343,0.2081640511751175
8197855,4814102,4210695,13312,4828,1989,1643,1980,8484,11669,0.0,0.0,19,6.0,10,2,21,4998.0,0.24893490970134735,0.09255217760801315
8199785,6563623,6181534,13312,9994,2003,9161,2001,3318,4151,0.5,0.0,42,30.0,8,6,56,392.0,0.37939104437828064,0.15860971808433533
8197423,7347926,4592975,13312,11772,2008,3806,1986,1540,9506,0.0,0.0,26,10.0,3,8,0,4151.0,0.27425628900527954,0.0735723227262497
8202502,6384125,6531824,13319,9623,2002,9931,2003,3696,3388,0.0,0.0,13,6.0,8,12,84,294.0,0.5432729125022888,0.03801501914858818
8201315,6065737,5856605,13319,8909,2000,8405,1999,4410,4914,0.0,0.0,7,3.0,4,2,700,749.0,0.3507034480571747,0.10640610009431839
8203908,6002643,5948294,13319,8748,1999,8650,1999,4571,4669,0.0,0.0,13,2.0,8,2,91,3521.0,0.6171153783798218,0.33103975653648376
8201444,7294252,6911763,13319,11639,2007,10771,2005,1680,2548,1.0,0.0,6,4.0,7,21,35,1568.0,0.41824862360954285,0.20507898926734924
8202760,5574291,7664685,13319,7621,1996,12465,2010,5698,854,1.0,0.0,79,1.0,3,8,84,854.0,0.5641059279441833,0.1513090580701828
8204945,5539824,4965166,13319,7509,1996,5409,1990,5810,7910,0.0,0.0,53,37.0,4,5,56,14.0,0.2503543794155121,0.05802754685282707
8203080,5326636,7566781,13319,6760,1994,12262,2009,6559,1057,0.0,0.0,45,1.0,29,2,441,1057.0,0.20753827691078186,0.047994714230298996
8209055,6243657,5135682,13326,9287,2001,6060,1992,4039,7266,0.0,0.0,53,13.0,42,3,35,3612.0,0.37928417325019836,0.06900345534086227
8206638,5525227,7389757,13326,7467,1996,11863,2008,5859,1463,0.0,0.0,4,1.0,2,4,77,1463.0,0.48805251717567444,0.15805168449878693
8207944,5714984,4163931,13326,8069,1998,1314,1979,5257,12012,0.0,0.0,19,7.0,6,2,70,3360.0,0.40669748187065125,0.28793662786483765
8206087,7175387,5806272,13326,11366,2007,8293,1998,1960,5033,1.0,0.0,1,14.0,10,19,1960,490.0,0.720706582069397,0.3966766893863678
8206317,6275717,6699288,13326,9357,2001,10288,2004,3969,3038,1.0,1.0,205,6.0,43,5,0,161.0,0.25585344433784485,0.08850667625665665
8205684,5372420,7334412,13326,6921,1994,11744,2008,6405,1582,0.5,0.0,24,1.0,7,7,427,1582.0,0.30991804599761963,0.21235904097557068
8211451,6102254,5588862,13333,8993,2000,7670,1996,4340,5663,0.0,0.0,17,5.0,24,3,7,3619.0,0.5107719302177429,0.12836994230747223
8210402,4494734,4024495,13333,3309,1985,502,1977,10024,12831,0.0,0.0,14,17.0,2,1,189,518.0,0.45855411887168884,0.16797852516174316
8210364,5127546,5729219,13333,6032,1992,8111,1998,7301,5222,0.0,0.0,13,27.0,3,9,84,77.0,0.2764867842197418,0.09859932959079742
8213466,6185255,5806538,13333,9168,2001,8293,1998,4165,5040,0.5,0.0,25,7.0,2,5,0,2079.0,0.18475958704948425,-0.0059209661558270454
8212536,7667991,4367054,13333,12472,2010,2560,1983,861,10773,0.0,0.0,2,10.0,1,3,217,7.0,0.22712360322475433,0.16664345562458038
8209784,4947490,7077738,13333,5339,1990,11156,2006,7994,2177,1.0,0.0,15,2.0,5,8,231,987.0,0.5617243647575378,0.23688818514347076
8211629,6003678,4196750,13333,8755,1999,1559,1980,4578,11774,0.0,0.0,22,2.0,3,3,35,11060.0,0.21699464321136475,0.18542276322841644
8213526,6411649,5134263,13333,9672,2002,6053,1992,3661,7280,0.0,0.0,17,9.0,8,7,210,77.0,0.5947001576423645,0.14774902164936066
8211515,6685998,5644143,13333,10260,2004,7852,1997,3073,5481,1.0,0.0,8,2.0,8,4,658,4445.0,0.6748864054679871,0.14088310301303864
8218735,5903726,7691980,13340,8531,1999,12514,2010,4809,826,0.0,0.0,65,4.0,6,6,35,182.0,0.4994172155857086,0.12048240751028061
8218899,8014575,7925075,13340,13032,2011,12885,2011,308,455,0.5,1.0,1,1.0,10,30,308,455.0,0.42010965943336487,0.4219801425933838
8218709,5227127,7762574,13340,6403,1993,12626,2010,6937,714,1.0,0.0,2,2.0,2,7,4893,469.0,0.5524414777755737,0.19638372957706451
8215122,4766735,5200214,13340,4625,1988,6305,1993,8715,7035,0.0,0.0,19,11.0,5,10,287,2100.0,0.6411898136138916,-0.06257598102092743
8216267,6261316,5777470,13340,9329,2001,8223,1998,4011,5117,1.0,0.0,97,1.0,83,15,14,5117.0,0.39922887086868286,0.06029684096574783
8217594,6012826,5945958,13340,8776,2000,8643,1999,4564,4697,0.0,0.0,30,8.0,1,5,560,532.0,0.3770957887172699,0.058947812765836716
8216174,6379740,4223761,13340,9616,2002,1727,1980,3724,11613,0.5,0.0,10,4.0,5,1,14,2667.0,0.34343138337135315,0.15160202980041504
8215900,4494287,5662221,13340,3309,1985,7915,1997,10031,5425,0.0,0.0,23,14.0,7,19,602,476.0,0.42880046367645264,0.2930244505405426
8215124,4292816,4925736,13340,2105,1981,5248,1990,11235,8092,0.0,0.0,9,17.0,1,3,1386,105.0,0.5063439011573792,0.13255296647548676
8224411,6526300,6527874,13347,9917,2003,9924,2003,3430,3423,1.0,0.0,193,3.0,7,10,0,1379.0,0.5363057255744934,0.036033809185028076
8223943,5727002,4592741,13347,8104,1998,3806,1986,5243,9541,0.5,0.0,164,19.0,9,2,0,35.0,0.30970603227615356,0.18307839334011078
8223898,5241561,4059560,13347,6452,1993,691,1977,6895,12656,0.5,0.0,127,3.0,4,1,49,8701.0,0.33073684573173523,-0.009599870070815086
8223531,5375250,5148558,13347,6928,1994,6109,1992,6419,7238,0.0,0.0,26,20.0,11,8,28,343.0,0.5396714806556702,0.2719378173351288
8221144,5662480,4074003,13347,7915,1997,775,1978,5432,12572,1.0,0.0,12,3.0,2,1,637,539.0,0.45437660813331604,0.24713560938835144
8223777,5966649,5385559,13347,8685,1999,6970,1995,4662,6377,1.0,0.0,12,17.0,9,7,154,70.0,0.3746565878391266,0.1936669647693634
8225181,7661054,4118178,13347,12458,2010,1006,1978,889,12341,0.2,0.0,11,12.0,6,1,21,1757.0,0.6373839974403381,0.35266363620758057
8220702,5597114,4426686,13347,7698,1997,2938,1984,5649,10409,1.0,0.0,20,6.0,7,2,21,3178.0,0.2730545401573181,0.18073035776615143
8224953,6122639,5497628,13347,9028,2000,7376,1996,4319,5971,1.0,0.0,136,6.0,11,2,35,371.0,0.49230286478996277,0.2466798573732376
8224413,6629934,7182979,13347,10141,2003,11380,2007,3206,1967,0.5,0.0,50,4.0,117,32,35,315.0,0.4588888883590698,0.23152539134025574
8224853,6345278,4026375,13347,9532,2002,516,1977,3815,12831,1.0,0.0,136,6.0,15,1,7,4116.0,0.4713064432144165,0.1639903336763382
8222969,5386203,7098663,13347,6970,1995,11198,2006,6377,2149,0.0,0.0,42,3.0,1,4,203,1078.0,0.5276634097099304,0.2064518928527832
8223021,6942518,6535790,13347,10848,2005,9938,2003,2499,3409,0.0,0.0,165,10.0,267,7,0,756.0,0.485668808221817,0.1692705899477005
8225214,5761662,6528687,13347,8188,1998,9924,2003,5159,3423,1.0,0.0,387,4.0,7,2,7,637.0,0.4364529848098755,0.20258457958698273
8220334,5957846,4991377,13347,8671,1999,5521,1991,4676,7826,0.0,0.0,81,9.0,47,2,7,56.0,0.5854740738868713,0.14364296197891235
8227957,7839028,7051840,13354,12745,2010,11107,2006,609,2247,1.0,0.0,3,3.0,83,9,280,252.0,0.4285682141780853,0.2592217028141022
8226674,5507292,4525664,13354,7411,1996,3463,1985,5943,9891,1.0,0.0,46,7.0,34,2,49,336.0,0.4307902157306671,0.2248418778181076
8226558,5830341,6704974,13354,8342,1998,10302,2004,5012,3052,0.0,0.0,81,2.0,30,8,0,2037.0,0.3542131781578064,0.1708022654056549
8226555,7875293,4336032,13354,12808,2011,2364,1982,546,10990,0.5,0.0,7,8.0,349,1,7,2317.0,0.3275430202484131,0.18546585738658905
8226374,5418984,5502329,13354,7089,1995,7390,1996,6265,5964,0.0,0.0,14,5.0,10,10,987,21.0,0.2910744547843933,0.22239524126052856
8226675,6319221,5817406,13354,9455,2001,8314,1998,3899,5040,1.0,0.0,7,13.0,36,6,63,7.0,0.2498025745153427,0.25419798493385315
8225980,7025747,7009974,13354,11058,2006,11023,2006,2296,2331,1.0,0.0,28,10.0,41,6,42,371.0,0.34310364723205566,0.1373748779296875
8228879,5367558,4470521,13354,6900,1994,3176,1984,6454,10178,1.0,0.0,175,17.0,4,2,35,203.0,0.41025954484939575,0.21508467197418213
8233959,7624028,4187910,13361,12381,2009,1503,1980,980,11858,0.0,0.0,41,6.0,511,2,0,448.0,0.32694122195243835,0.11250918358564377
8230562,7388318,4529387,13361,11856,2008,3484,1985,1505,9877,0.0,0.0,18,16.0,6,3,56,686.0,0.49760329723358154,0.19647535681724548
8233471,5550358,4313256,13361,7544,1996,2224,1982,5817,11137,0.0,0.0,58,13.0,14,7,14,371.0,0.5019468069076538,0.13748250901699066
8232523,7329868,5128424,13361,11730,2008,6032,1992,1631,7329,0.0,0.0,1,13.0,22,7,1631,798.0,0.44637683033943176,0.07143700122833252
8234128,5573506,6966924,13361,7621,1996,10918,2005,5740,2443,0.0,0.0,120,5.0,23,19,0,21.0,0.31044015288352966,0.1900186985731125
8231628,4217902,4128531,13361,1692,1980,1069,1978,11669,12292,1.0,0.0,131,6.0,1,1,7,7336.0,0.21383261680603027,0.21009615063667297
8236019,6679899,6298037,13368,10246,2004,9406,2001,3122,3962,1.0,0.0,20,24.0,24,3,14,21.0,0.4701831340789795,0.11168042570352554
8236121,4946527,6381695,13368,5332,1990,9616,2002,8036,3752,1.0,0.0,127,4.0,30,7,0,42.0,0.24686723947525024,0.11238352954387665
8236242,5422246,7896512,13368,7096,1995,12843,2011,6272,525,0.0,0.0,98,1.0,9,3,0,525.0,0.2576490342617035,0.22630617022514343
8238888,5948061,5519382,13368,8650,1999,7446,1996,4718,5922,0.0,0.0,1047,4.0,11,3,7,217.0,0.3507591485977173,0.40301090478897095
8237285,6268619,7727469,13368,9343,2001,12570,2010,4025,798,1.0,0.0,6,1.0,7,7,1253,798.0,0.49912697076797485,0.2565504312515259
8238200,5168479,7562603,13368,6179,1992,12255,2009,7189,1113,0.5,0.0,7,1.0,1,3,2114,1113.0,0.31970611214637756,0.19536268711090088
8236040,4878906,4759633,13368,5059,1989,4590,1988,8309,8778,1.0,0.0,611,8.0,7,4,7,252.0,0.5417390465736389,0.2620023190975189
8235901,4454597,5242143,13368,3085,1984,6459,1993,10283,6909,0.0,0.0,7,10.0,1,3,217,105.0,0.216502383351326,0.2498481124639511
8236242,4655880,5546773,13368,4114,1987,7537,1996,9254,5831,1.0,0.0,243,10.0,14,1,0,280.0,0.285749226808548,0.14127561450004578
8236534,6136577,6831518,13368,9063,2000,10575,2004,4305,2793,0.5,0.0,40,3.0,21,4,21,350.0,0.4386194944381714,0.192660391330719
8236730,5998332,6966677,13368,8741,1999,10918,2005,4627,2450,1.0,0.0,16,8.0,16,5,371,84.0,0.5801606178283691,0.1558120846748352
8244442,6155365,4356281,13375,9105,2000,2490,1982,4270,10885,1.0,0.0,19,3.0,13,3,21,294.0,0.4679528474807739,-0.03068464808166027
8241279,6837846,5440672,13375,10596,2005,7159,1995,2779,6216,0.0,0.0,24,10.0,104,8,70,742.0,0.38638976216316223,0.1917726993560791
8244944,7966037,5684835,13375,12955,2011,7978,1997,420,5397,0.5,0.3333333333333333,2,10.0,4,6,28,70.0,0.6208330988883972,0.026056958362460136
8241330,6238397,3993787,13375,9280,2001,327,1976,4095,13048,1.0,0.0,112,18.0,37,1,0,3171.0,0.44399937987327576,0.33685559034347534
8243847,5357145,4744472,13375,6865,1994,4520,1988,6510,8855,0.5,0.0,39,7.0,1,3,7,3829.0,0.43896493315696716,0.14468657970428467
8241266,5964767,7623085,13375,8685,1999,12381,2009,4690,994,1.0,0.0,48,2.0,7,19,0,112.0,0.3658107817173004,0.28289851546287537
8241284,7435249,4048244,13375,11975,2008,621,1977,1400,12754,1.0,0.0,44,6.0,358,2,0,1575.0,0.48229604959487915,0.06950502842664719
8240683,7604450,8008258,13375,12346,2009,13025,2011,1029,350,0.0,0.0,1,1.0,19,11,1029,350.0,0.4098275899887085,0.036187902092933655
8241346,6432131,5507969,13375,9721,2002,7411,1996,3654,5964,1.0,0.0,30,8.0,23,5,7,2135.0,0.5445250868797302,0.13632820546627045
8249865,5289372,6479303,13382,6627,1994,9812,2002,6755,3570,0.0,0.0,78,5.0,7,39,77,910.0,0.23004518449306488,-0.0152807105332613
8247020,5656036,4042169,13382,7894,1997,593,1977,5488,12789,0.0,0.0,72,11.0,9,1,14,1008.0,0.2255932092666626,0.3802680969238281
8247051,4959421,5822404,13382,5381,1990,8321,1998,8001,5061,0.0,0.0,11,23.0,7,18,77,154.0,0.4159921407699585,0.12128947675228119
8250503,5773994,5484018,13382,8216,1998,7320,1996,5166,6062,0.0,0.0,55,5.0,14,2,28,2205.0,0.41601115465164185,0.16181804239749908
8245995,5439305,5590468,13382,7159,1995,7677,1997,6223,5705,0.0,0.0,50,10.0,6,48,28,49.0,0.3069623112678528,0.3324291706085205
8246636,5972005,4027382,13382,8699,1999,523,1977,4683,12859,1.0,0.0,22,10.0,17,2,7,6384.0,0.4721597135066986,0.10767026990652084
8247677,6296489,4244785,13382,9406,2001,1839,1981,3976,11543,0.0,0.0,21,1.0,9,3,35,11543.0,0.5062392354011536,0.11845576018095016
8245402,7877877,7349918,13382,12815,2011,11772,2008,567,1610,1.0,0.0,1,1.0,3,19,567,1610.0,0.8179643154144287,0.08790207654237747
8252057,5297536,6963454,13389,6662,1994,10904,2005,6727,2485,1.0,0.0,98,2.0,5,13,0,1218.0,0.4636796712875366,0.37110158801078796
8253368,5020186,4094545,13389,5633,1991,894,1978,7756,12495,0.0,0.0,69,6.0,6,1,14,679.0,0.2408495396375656,0.13930843770503998
8250969,4681028,7274756,13389,4219,1987,11590,2007,9170,1799,1.0,0.0,12,1.0,1,6,1050,1799.0,0.5971084237098694,0.26853013038635254
8251162,4457387,4499423,13389,3106,1984,3330,1985,10283,10059,1.0,0.0,9,17.0,3,5,378,63.0,0.4290234446525574,0.2603893578052521
re43619,6407554,7768797,13389,9665,2002,12633,2010,3724,756,0.3333333333333333,0.0,44,1.0,4,2,21,756.0,0.4827297329902649,0.3864007890224457
8255030,7074307,4725114,13389,11149,2006,4429,1988,2240,8960,0.5,0.0,234,6.0,67,8,0,1477.0,0.5533034205436707,0.12541358172893524
8250918,7132722,5242276,13389,11268,2006,6459,1993,2121,6930,0.0,0.0,9,9.0,4,3,14,2373.0,0.6164548993110657,0.2940734624862671
8253833,6061093,4159084,13389,8895,2000,1272,1979,4494,12117,1.0,0.0,13,3.0,13,1,189,4438.0,0.3751561641693115,0.011946392245590687
8251992,6258087,5786227,13389,9322,2001,8244,1998,4067,5145,1.0,0.0,160,19.0,146,18,0,266.0,0.28906428813934326,0.25298768281936646
8254491,5444667,5633628,13389,7173,1995,7817,1997,6216,5572,0.0,0.0,105,15.0,3,4,7,735.0,0.23133152723312378,0.18176528811454773
8252100,5772738,6345343,13389,8216,1998,9532,2002,5173,3857,0.5,0.0,43,4.0,10,24,0,301.0,0.4175845682621002,0.04248950257897377
8254404,6292479,6815608,13389,9392,2001,10540,2004,3997,2849,1.0,0.0,107,1.0,27,2,14,2849.0,0.46528762578964233,0.040374964475631714
8256305,6851255,6488439,13396,10631,2005,9833,2002,2765,3563,0.0,0.0,3,8.0,4,9,854,140.0,0.543699324131012,0.2653541564941406
8256584,6491352,4055647,13396,9840,2002,663,1977,3556,12733,0.0,0.0,7,2.0,17,1,35,8029.0,0.6641282439231873,0.15494374930858612
8257112,6591907,4412225,13396,10057,2003,2854,1983,3339,10542,0.0,0.0,171,15.0,231,2,0,1330.0,0.09726759046316147,0.13562150299549103
8257968,5994071,4020499,13396,8734,1999,481,1977,4662,12915,0.3333333333333333,0.0,29,3.0,3,1,56,2492.0,0.29539331793785095,0.2458096444606781
8261094,6570555,4721138,13396,10008,2003,4408,1988,3388,8988,0.0,0.0,90,21.0,12,1,7,140.0,0.235513836145401,0.15137536823749542
8257398,6716213,5233620,13396,10323,2004,6424,1993,3073,6972,1.0,0.0,84,11.0,10,5,0,686.0,0.4996545612812042,0.21896514296531677
8257554,5624743,6209677,13396,7789,1997,9224,2001,5607,4172,0.0,0.0,13,20.0,6,8,441,651.0,0.47246497869491577,0.22329062223434448
8257416,6935761,5546288,13396,10834,2005,7530,1996,2562,5866,0.0,0.0,13,8.0,29,11,91,1057.0,0.32977768778800964,0.28483515977859497
8264616,6392710,5868565,13403,9637,2002,8440,1999,3766,4963,0.5,0.0,21,5.0,33,9,35,21.0,0.3902885317802429,0.0903250128030777
8265726,5556524,4356702,13403,7565,1996,2497,1982,5838,10906,0.0,0.0,106,9.0,1,1,0,7.0,0.3167313039302826,0.270908385515213
8266016,6496793,6841075,13403,9847,2002,10603,2005,3556,2800,1.0,0.0,29,8.0,7,11,14,119.0,0.1569637656211853,0.11929143965244293
8265605,6738647,4080278,13403,10365,2004,810,1978,3038,12593,0.5,0.0,22,8.0,92,2,14,4753.0,0.3019110858440399,0.16261817514896393
8265549,6023605,4691130,13403,8804,2000,4261,1987,4599,9142,1.0,0.0,114,6.0,7,1,21,2086.0,0.43171530961990356,0.15671856701374054
8265902,6331999,5754476,13403,9483,2001,8174,1998,3920,5229,0.0,0.0,15,2.0,41,12,231,448.0,0.6201741099357605,0.26798075437545776
8262459,4695053,6910558,13403,4282,1987,10771,2005,9121,2632,1.0,0.0,651,3.0,2,9,0,553.0,0.5658091306686401,0.30925649404525757
8261822,4651822,4081007,13403,4100,1987,817,1978,9303,12586,1.0,0.0,3,5.0,6,2,7644,1890.0,0.38658228516578674,0.2683616578578949
8262990,4824641,5931959,13403,4863,1989,8615,1999,8540,4788,0.3333333333333333,0.0,64,15.0,12,2,7,21.0,0.3776260018348694,0.17951083183288574
8263667,5626883,7099499,13403,7796,1997,11198,2006,5607,2205,0.0,0.0,34,3.0,2,5,0,42.0,0.4742027223110199,0.05546644702553749
8265395,6363173,6218579,13403,9581,2002,9238,2001,3822,4165,1.0,0.0,13,4.0,5,5,14,616.0,0.3727956712245941,0.21354368329048157
8266304,7200632,6837891,13403,11415,2007,10596,2005,1988,2807,1.0,0.0,20,15.0,55,65,0,70.0,0.4719306230545044,0.04014460742473602
8264575,6714665,4432375,13403,10316,2004,2973,1984,3087,10430,0.0,0.0,170,9.0,15,4,0,287.0,0.47455060482025146,0.30011922121047974
8263580,5612327,6581524,13403,7747,1997,10036,2003,5656,3367,1.0,0.0,7,2.0,1,9,420,364.0,0.47876766324043274,0.1457616686820984
8266593,6718535,6039948,13403,10323,2004,8846,2000,3080,4557,1.0,0.0,243,2.0,108,9,0,861.0,0.3198741376399994,0.0020974597427994013
8266124,5787234,7427410,13403,8244,1998,11954,2008,5159,1449,1.0,0.0,63,2.0,3,11,7,1071.0,0.27703890204429626,-0.07990895956754684
8263581,6537573,6086799,13403,9945,2003,8958,2000,3458,4445,1.0,0.0,5,10.0,10,46,14,147.0,0.517413854598999,0.22278009355068207
8261674,7377733,5714028,13403,11835,2008,8069,1998,1568,5334,0.0,0.0,3,10.0,5,2,140,1722.0,0.3863450288772583,0.21861204504966736
8266819,5640783,4337661,13410,7845,1997,2378,1982,5565,11032,1.0,0.0,12,9.0,3,9,217,1113.0,0.6599066257476807,0.22167527675628662
8269326,6281046,5652410,13410,9371,2001,7880,1997,4039,5530,1.0,0.0,65,10.0,7,17,112,518.0,0.7043495178222656,0.5140751004219055
8267928,8012150,7802750,13410,13032,2011,12689,2010,378,721,1.0,0.0,3,1.0,454,4,14,721.0,0.7577393651008606,0.35427066683769226
8267673,7121368,4170031,13410,11247,2006,1370,1979,2163,12040,0.0,0.0,4,4.0,19,1,21,2569.0,0.5705403089523315,0.37340086698532104
8267999,6231609,4850026,13410,9266,2001,4947,1989,4144,8463,1.0,0.0,132,20.0,11,10,0,721.0,0.6209684014320374,0.08974774181842804
8271306,6594635,6629332,13410,10057,2003,10141,2003,3353,3269,1.0,0.0,45,15.0,22,9,21,448.0,0.5090314745903015,0.16966861486434937
8267814,6929572,7335999,13410,10820,2005,11744,2008,2590,1666,0.5,0.0,9,1.0,4,18,0,1666.0,0.5890819430351257,0.14729459583759308
8267315,6183362,4016007,13410,9168,2001,460,1977,4242,12950,0.5,0.0,102,27.0,4,1,21,581.0,0.38371264934539795,0.12131869047880173
8272036,6339404,4453331,13410,9511,2002,3085,1984,3899,10325,0.0,0.0,43,2.0,15,1,70,5005.0,0.2518978416919708,0.15495073795318604
8271129,5634239,4574151,13410,7824,1997,3715,1986,5586,9695,0.0,0.0,24,2.0,6,2,0,8491.0,0.14155907928943634,0.1093742623925209
8274479,7006077,5166586,13417,11016,2006,6172,1992,2401,7245,0.5,0.0,23,7.0,18,4,63,469.0,0.5822517275810242,0.445679247379303
8272188,4402778,7276698,13417,2805,1983,11597,2007,10612,1820,0.0,0.0,25,3.0,2,3,476,245.0,0.47678980231285095,0.17796343564987183
8272373,5769066,6271597,13417,8209,1998,9350,2001,5208,4067,1.0,0.0,64,7.0,15,16,98,371.0,0.5600773096084595,0.08421112596988678
8274954,6356538,6654023,13417,9567,2002,10190,2003,3850,3227,0.0,0.0,43,3.0,22,2,42,875.0,0.3872143626213074,0.2613842487335205
8275660,7720351,4513507,13417,12556,2010,3407,1985,861,10010,0.5,0.0,3,13.0,1,4,7,735.0,0.2726598381996155,0.13666874170303345
8274037,6836212,5345067,13417,10589,2004,6823,1994,2828,6594,0.0,0.0,25,16.0,7,6,21,189.0,0.40045180916786194,0.262792706489563
8273061,4931816,4053840,13417,5269,1990,649,1977,8148,12768,0.0,0.0,12,9.0,1,1,21,2968.0,0.3843201696872711,0.2638743221759796
8273330,5000888,6578907,13417,5556,1991,10029,2003,7861,3388,0.5,0.0,16,2.0,5,10,140,1785.0,0.34436577558517456,0.0996643677353859
8272645,5909882,6531828,13417,8559,1999,9931,2003,4858,3486,1.0,0.0,8,9.0,4,8,448,301.0,0.4945017993450165,0.06845059990882874
8273451,7687143,6617409,13417,12507,2010,10113,2003,910,3304,0.0,0.0,13,2.0,156,2,14,770.0,0.9451270699501038,0.36137115955352783
8280229,5805763,5454382,13424,8286,1998,7215,1995,5138,6209,1.0,0.0,209,5.0,25,6,14,1834.0,0.30286872386932373,0.06910808384418488
8280517,6625493,4389577,13424,10127,2003,2728,1983,3297,10696,1.0,0.0,44,3.0,11,3,42,140.0,0.45326197147369385,0.2079589068889618
8276717,6296085,4810928,13424,9406,2001,4814,1989,4018,8610,1.0,0.0,6,2.0,1,2,1603,7658.0,0.6735974550247192,0.30173078179359436
8279583,5729428,5470001,13424,8111,1998,7271,1995,5313,6153,1.0,0.0,94,6.0,3,8,7,1176.0,0.4953288733959198,0.20215703547000885
8278167,6180496,7564913,13424,9161,2001,12255,2009,4263,1169,1.0,0.0,76,2.0,1,9,49,210.0,0.4069836437702179,0.27025139331817627
8278194,6071795,4310036,13424,8923,2000,2203,1982,4501,11221,1.0,0.0,218,17.0,9,3,0,308.0,0.4228116273880005,0.22251813113689423
8284017,6426268,7957162,13431,9707,2002,12941,2011,3724,490,1.0,0.0,12,5.0,10,11,49,126.0,0.49701932072639465,0.09094328433275223
8284336,6912018,4663391,13431,10771,2005,4142,1987,2660,9289,0.5,0.0,19,5.0,9,3,28,3682.0,0.30030909180641174,0.09136715531349182
8282972,4564450,4820261,13431,3666,1986,4849,1989,9765,8582,0.0,0.0,14,25.0,5,3,1771,7.0,0.25713664293289185,0.14058122038841248
8286058,7979782,6820244,13431,12976,2011,10547,2004,455,2884,1.0,0.0,1,5.0,2,6,455,322.0,0.5402137637138367,0.20917440950870514
8281572,5552128,7551427,13431,7551,1996,12227,2009,5880,1204,0.0,0.0,24,4.0,14,7,28,56.0,0.3654133081436157,0.24263113737106323
8282577,5976085,7993905,13431,8706,1999,13004,2011,4725,427,1.0,0.0,163,1.0,24,60,0,427.0,0.6222960948944092,0.3928253650665283
8282472,6012983,4897184,13431,8776,2000,5143,1990,4655,8288,1.0,0.0,297,38.0,11,4,7,812.0,0.5339893102645874,0.19232580065727234
8285398,5797967,4110761,13431,8272,1998,971,1978,5159,12460,1.0,0.0,71,7.0,35,2,35,3682.0,-0.004419798497110605,0.26773300766944885
8282660,6979344,5555036,13431,10953,2005,7558,1996,2478,5873,1.0,0.0,41,8.0,31,3,28,49.0,0.39214789867401123,0.08742113411426544
8285149,7245379,4648167,13431,11520,2007,4086,1987,1911,9345,0.0,0.0,6,6.0,4,2,21,2128.0,0.40534788370132446,0.21547867357730865
8282577,6944486,4538581,13431,10848,2005,3533,1985,2583,9898,1.0,0.0,69,4.0,38,1,0,1680.0,0.40479743480682373,0.087712362408638
8287539,4262665,7209422,13438,1937,1981,11436,2007,11501,2002,1.0,0.0,60,2.0,2,3,0,854.0,0.5552689433097839,0.2959692180156708
8288663,5517758,4209302,13438,7446,1996,1636,1980,5992,11802,0.0,0.0,41,37.0,6,1,14,63.0,0.5488362312316895,0.04283180832862854
8290140,6810116,7416151,13438,10526,2004,11926,2008,2912,1512,1.0,0.0,21,3.0,6,1,91,630.0,0.49910980463027954,0.16483017802238464
8288711,6439755,6934446,13438,9735,2002,10827,2005,3703,2611,0.0,0.0,74,2.0,6,10,7,343.0,0.6107797026634216,0.1590641438961029
8287538,6096040,5083400,13438,8979,2000,5871,1992,4459,7567,1.0,0.0,92,4.0,6,2,56,343.0,0.5382237434387207,0.2977132797241211
8287677,4663220,5223414,13438,4142,1987,6389,1993,9296,7049,0.0,0.0,733,36.0,14,4,0,63.0,0.4835071265697479,0.07113034278154373
8290632,7455114,5188026,13438,12017,2008,6263,1993,1421,7175,0.0,0.0,2,12.0,35,13,623,210.0,0.28569501638412476,0.20249852538108826
8287539,6197031,4263714,13438,9196,2001,1944,1981,4242,11494,1.0,0.0,11,6.0,8,1,21,14.0,0.4064234793186188,0.245463028550148
8288103,5545531,6919562,13438,7530,1996,10792,2005,5908,2646,1.0,0.0,267,14.0,6,1,14,182.0,0.5318619012832642,0.07314516603946686
8286980,6869090,4943624,13438,10673,2005,5318,1990,2765,8120,0.0,0.0,10,12.0,12,1,581,70.0,0.5811919569969177,0.24348898231983185
8293004,7351280,5227083,13445,11779,2008,6403,1993,1666,7042,1.0,0.0,3,3.0,4,8,966,3360.0,0.7114189267158508,-0.05442662537097931
8293663,5790092,4006014,13445,8251,1998,397,1977,5194,13048,0.0,0.0,55,5.0,1,1,49,6790.0,0.3796117603778839,0.05727042630314827
8293367,5879713,5405272,13445,8468,1999,7040,1995,4977,6405,0.0,0.0,280,8.0,1,6,0,1288.0,0.40603527426719666,0.19457295536994934
8294975,6573957,6969358,13445,10015,2003,10925,2005,3430,2520,1.0,0.0,46,2.0,4,11,7,686.0,0.3773183822631836,0.18831989169120789
8296333,4893270,4266240,13445,5122,1990,1951,1981,8323,11494,1.0,0.0,76,12.0,12,2,7,2443.0,0.5795656442642212,0.19524255394935608
8293945,7754922,7635300,13445,12612,2010,12409,2009,833,1036,1.0,0.0,4,2.0,13,5,21,336.0,0.756604015827179,0.09812627732753754
8294994,6538799,4869686,13445,9945,2003,5017,1989,3500,8428,0.3333333333333333,0.0,24,13.0,22,1,147,1785.0,0.2334865927696228,0.38627123832702637
8294456,7051577,5913354,13445,11107,2006,8573,1999,2338,4872,1.0,0.0,6,8.0,15,16,1134,329.0,0.6912508010864258,0.04834689199924469
8292964,6117175,6218579,13445,9021,2000,9238,2001,4424,4207,1.0,0.0,20,4.0,14,5,35,658.0,0.5201159715652466,0.19413858652114868
8291983,6932160,4211997,13445,10827,2005,1650,1980,2618,11795,1.0,0.0,13,18.0,11,4,21,364.0,0.4675576686859131,0.2591778337955475
8296862,6336220,6853735,13452,9504,2002,10631,2005,3948,2821,0.0,0.0,16,4.0,15,2,35,567.0,0.6057106256484985,0.05731653422117233
8299947,7308032,6440395,13452,11667,2007,9735,2002,1785,3717,0.0,0.0,4,3.0,3,12,301,21.0,0.33033648133277893,0.1792292445898056
8299046,5426183,5613384,13452,7110,1995,7754,1997,6342,5698,1.0,0.0,33,16.0,7,8,42,77.0,0.2285986691713333,0.009123582392930984
8298625,7164236,4004161,13452,11338,2007,383,1977,2114,13069,0.6666666666666666,0.0,1,4.0,24,1,2114,10612.0,0.6343973278999329,0.24308782815933228
8298815,5322771,6805430,13452,6746,1994,10519,2004,6706,2933,0.5,0.0,19,6.0,10,5,56,714.0,0.33986568450927734,0.2883850932121277
8299695,4794383,4125563,13452,4744,1988,1048,1978,8708,12404,0.0,0.0,63,4.0,7,2,56,10304.0,0.21655505895614624,0.10077568888664246
8302012,5644334,4898703,13452,7852,1997,5150,1990,5600,8302,0.0,0.0,27,2.0,8,9,112,7532.0,0.3974742293357849,0.16606774926185608
8298575,4863017,4377095,13452,4996,1989,2637,1983,8456,10815,0.0,0.0,11,2.0,6,3,343,616.0,0.4519786834716797,0.08546680957078934
8298251,5002562,6777298,13452,5563,1991,10456,2004,7889,2996,0.5,0.0,144,2.0,18,7,7,2702.0,0.3752373456954956,0.1957675814628601
8298142,6517508,4404630,13452,9903,2003,2812,1983,3549,10640,1.0,0.0,23,5.0,21,12,35,3269.0,0.44079142808914185,0.19767418503761292
8302965,6217025,4115333,13459,9238,2001,992,1978,4221,12467,1.0,0.0,2,15.0,3,4,3640,1449.0,0.4575137197971344,0.14154373109340668
8303235,4674941,5312397,13459,4191,1987,6711,1994,9268,6748,1.0,0.0,44,10.0,9,5,21,42.0,0.6447679996490479,0.29185807704925537
8306619,6088618,4185973,13459,8958,2000,1489,1980,4501,11970,1.0,0.0,55,10.0,3,2,7,560.0,0.35624003410339355,0.08350040763616562
8306451,7386251,5239912,13459,11849,2008,6452,1993,1610,7007,1.0,0.0,12,2.0,44,6,21,6622.0,0.5701864361763,0.39543455839157104
8307212,4817140,4622082,13459,4835,1989,3967,1986,8624,9492,0.0,0.0,319,11.0,31,2,21,119.0,0.39148491621017456,0.020535213872790337
8304596,4808379,6107178,13459,4807,1989,9000,2000,8652,4459,0.25,0.0,23,3.0,12,4,546,3556.0,0.5194012522697449,0.28177914023399353
8306972,6701305,4169217,13459,10288,2004,1363,1979,3171,12096,1.0,0.0,69,11.0,31,1,21,3787.0,0.40769413113594055,0.05342661216855049
8306598,6366793,6392185,13459,9588,2002,9637,2002,3871,3822,0.5,0.0,60,2.0,5,8,21,1484.0,0.6265631318092346,0.3109331429004669
8304398,6369038,6831518,13459,9595,2002,10575,2004,3864,2884,0.0,0.0,25,3.0,5,4,28,441.0,0.22186177968978882,0.0795457512140274
8312209,6735650,4035134,13466,10358,2004,558,1977,3108,12908,1.0,0.0,24,8.0,5,1,154,2674.0,0.34384477138519287,0.10704555362462997
8308768,6066325,4944510,13466,8909,2000,5325,1990,4557,8141,1.0,0.0,146,3.0,48,5,7,434.0,0.3295395076274872,0.3049793839454651
8308639,7766824,4286288,13466,12633,2010,2063,1981,833,11403,1.0,0.0,14,4.0,62,4,35,3402.0,0.5323297381401062,0.22805558145046234
8308623,4862905,4318980,13466,4996,1989,2259,1982,8470,11207,0.0,0.0,35,25.0,27,2,7,98.0,0.7380172610282898,0.22689594328403473
8311602,6356774,5485294,13466,9567,2002,7320,1996,3899,6146,1.0,0.0,144,21.0,25,15,0,77.0,0.4606561064720154,0.25922051072120667
8312060,7093200,4933854,13466,11184,2006,5276,1990,2282,8190,1.0,0.0,62,8.0,4,10,49,6909.0,0.3481932580471039,0.24467502534389496
8312805,4834036,5491576,13473,4898,1989,7348,1996,8575,6125,0.0,0.0,29,17.0,2,2,105,322.0,0.3460289537906647,0.031934306025505066
8315358,6041098,7516144,13473,8846,2000,12150,2009,4627,1323,0.0,0.0,30,2.0,3,2,98,931.0,0.3432779014110565,0.14617973566055298
8313485,6080128,4864409,13473,8944,2000,4996,1989,4529,8477,1.0,0.0,9,19.0,53,2,28,574.0,0.540837824344635,0.2016439586877823
8315144,7018696,7740330,13473,11044,2006,12591,2010,2429,882,0.0,0.0,16,1.0,38,3,119,882.0,0.3649604320526123,0.18564656376838684
8315444,7043644,4066353,13473,11086,2006,733,1978,2387,12740,1.0,0.0,46,5.0,1,2,35,5117.0,0.06053449213504791,0.2456207573413849
8315867,6122665,6949699,13473,9028,2000,10862,2005,4445,2611,0.0,0.0,144,9.0,8,4,35,35.0,0.5943320989608765,0.10055911540985107
8316191,6856622,5876680,13473,10638,2005,8461,1999,2835,5012,0.0,0.0,31,5.0,7,7,70,1134.0,0.2715766131877899,0.06196242943406105
8321576,6285659,4534269,13480,9378,2001,3512,1985,4102,9968,0.5,0.0,26,11.0,11,7,182,1155.0,0.40988484025001526,0.2351202815771103
8319045,7098390,7000915,13480,11198,2006,11009,2006,2282,2471,1.0,0.0,2,2.0,10,17,630,791.0,0.673826277256012,-0.001457546022720635
8317761,5928195,4239113,13480,8608,1999,1811,1980,4872,11669,1.0,0.0,117,41.0,9,3,0,210.0,0.3220363259315491,0.3304731845855713
8317057,5829603,6738126,13480,8342,1998,10365,2004,5138,3115,0.0,0.0,7,3.0,5,11,763,1680.0,0.6624922752380371,0.16567400097846985
8318069,4643041,5087028,13480,4065,1987,5885,1992,9415,7595,0.0,0.0,8,6.0,1,2,728,777.0,0.4027308523654938,0.37593773007392883
8320015,5950036,6332441,13480,8650,1999,9490,2001,4830,3990,0.0,0.0,26,5.0,5,10,14,630.0,0.4574054181575775,0.17856919765472412
8321013,5447525,4180935,13480,7187,1995,1461,1980,6293,12019,1.0,0.0,25,2.0,12,1,14,6867.0,0.6481661796569824,0.1629042774438858
8321257,7167893,4910030,13480,11345,2007,5192,1990,2135,8288,1.0,0.0,6,10.0,35,4,91,854.0,0.337332159280777,0.04165364056825638
8317786,5626576,7379557,13480,7796,1997,11835,2008,5684,1645,1.0,0.0,114,2.0,5,1,35,189.0,0.6524124145507812,0.2647004723548889
8320043,6774984,4168698,13480,10449,2004,1363,1979,3031,12117,0.3333333333333333,0.0,9,16.0,4,1,42,4403.0,0.6708890795707703,0.1644599586725235
8320934,6128492,6093896,13480,9042,2000,8972,2000,4438,4508,1.0,0.0,9,1.0,4,1,238,4508.0,0.5341570973396301,0.1796763390302658
8318754,6099562,7998549,13480,8986,2000,13011,2011,4494,469,0.3333333333333333,0.0,420,1.0,43,2,7,469.0,0.18815340101718903,0.1732395887374878
8324589,5548123,4970141,13487,7537,1996,5430,1990,5950,8057,1.0,0.0,27,7.0,4,3,196,3500.0,0.4062804579734802,0.09765296429395676
8326667,7650293,4319712,13487,12437,2010,2266,1982,1050,11221,1.0,0.0,8,20.0,9,3,28,14.0,0.43812400102615356,0.08011903613805771
8325693,4468538,4685908,13487,3162,1984,4240,1987,10325,9247,1.0,0.0,10,9.0,3,1,49,119.0,0.569395124912262,0.1445998102426529
8323334,6210432,4021527,13487,9224,2001,488,1977,4263,12999,1.0,0.0,181,13.0,3,1,77,3388.0,0.4283585548400879,0.09534221887588501
8324817,5161879,4294811,13487,6158,1992,2112,1981,7329,11375,0.0,0.0,143,6.0,5,2,35,511.0,0.49605098366737366,0.04541924223303795
8324960,7592858,6064554,13487,12318,2009,8902,2000,1169,4585,1.0,0.0,2,16.0,5,1,308,259.0,0.7370143532752991,0.11690293997526169
8322206,6948508,4351743,13487,10862,2005,2462,1982,2625,11025,0.0,0.0,12,13.0,28,5,77,49.0,0.348519891500473,0.2699456512928009
8331834,6898406,4011377,13494,10736,2005,432,1977,2758,13062,1.0,0.0,16,4.0,19,2,49,8246.0,0.6106716990470886,0.17853176593780518
8328877,4762128,5587244,13494,4604,1988,7663,1996,8890,5831,1.0,0.0,414,7.0,6,13,0,364.0,0.5154275298118591,0.2827204763889313
8331984,5687331,5235086,13494,7985,1997,6431,1993,5509,7063,0.0,0.0,263,4.0,5,4,0,4907.0,0.35332247614860535,0.14029234647750854
8327861,6202658,4142191,13494,9210,2001,1153,1979,4284,12341,1.0,0.0,18,3.0,23,2,168,4774.0,0.3921375870704651,0.15540780127048492
8327592,6668508,4030302,13494,10225,2003,537,1977,3269,12957,0.5,0.0,12,5.0,31,1,63,1939.0,0.5295619368553162,0.20475950837135315
8331984,7224851,4651779,13494,11471,2007,4100,1987,2023,9394,0.5,0.0,68,8.0,9,2,0,273.0,0.3644508123397827,0.2397313117980957
8332698,7752513,4958578,13494,12605,2010,5381,1990,889,8113,1.0,0.0,2,35.0,7,9,679,1344.0,0.5223191976547241,0.0642758309841156
8327926,5588907,8087002,13494,7670,1996,13144,2011,5824,350,0.0,0.0,26,3.0,8,7,7,56.0,0.21367819607257843,0.06560178101062775
8328709,4421502,4507155,13494,2910,1983,3372,1985,10584,10122,1.0,0.0,13,16.0,2,3,1638,98.0,0.4507015645503998,0.2815777063369751
8332791,7171542,5642505,13494,11352,2007,7845,1997,2142,5649,1.0,1.0,13,3.0,34,5,441,182.0,0.505922257900238,0.18333415687084198
8333991,5558879,4434807,13501,7572,1996,2987,1984,5929,10514,1.0,1.0,32,5.0,8,1,56,1785.0,0.2689442038536072,-0.008885581977665424
8333765,6966907,4578304,13501,10918,2005,3736,1986,2583,9765,1.0,0.0,152,12.0,7,4,21,56.0,0.37846025824546814,0.3129311800003052
8333778,5685311,3979697,13501,7985,1997,250,1976,5516,13251,1.0,0.0,18,6.0,10,1,42,1421.0,0.5983700156211853,0.4625961184501648
8334637,4260928,5761851,13501,1923,1981,8195,1998,11578,5306,1.0,0.0,4,6.0,1,6,1057,217.0,0.5832769274711609,0.0055628325790166855
8334607,4414871,4802172,13501,2875,1983,4779,1989,10626,8722,0.0,0.0,13,5.0,1,4,168,812.0,0.47822028398513794,0.3500465452671051
8333820,5846645,4354088,13501,8377,1998,2476,1982,5124,11025,0.0,0.0,10,9.0,9,2,392,1771.0,0.41213470697402954,0.3818919360637665
8336522,4867261,5778162,13508,5010,1989,8223,1998,8498,5285,0.0,0.0,4,7.0,3,3,2681,1694.0,0.5773643255233765,0.3375908136367798
8337420,6849456,6346202,13508,10624,2005,9539,2002,2884,3969,0.0,0.0,40,23.0,7,58,0,658.0,0.43833494186401367,-0.0035455534234642982
8336220,6166811,4072934,13508,9126,2000,768,1978,4382,12740,0.0,0.0,37,36.0,14,4,14,252.0,0.36784815788269043,0.25333017110824585
8336827,7874523,4968443,13508,12808,2011,5423,1990,700,8085,1.0,0.0,2,9.0,4,3,308,147.0,0.5571166276931763,0.11310003697872162
8340266,5867494,8030089,13508,8433,1999,13060,2011,5075,448,1.0,0.0,392,1.0,10,3,14,448.0,0.5074015855789185,0.17375032603740692
8337168,6339410,5088329,13508,9511,2002,5892,1992,3997,7616,0.0,0.0,25,31.0,32,2,7,98.0,0.27681177854537964,0.20557130873203278
8337753,5748978,7307140,13508,8160,1998,11667,2007,5348,1841,0.0,0.0,48,2.0,15,18,28,973.0,0.3046368956565857,0.12268310785293579
8340789,5946673,7089505,13508,8643,1999,11177,2006,4865,2331,0.0,0.0,23,2.0,41,5,21,553.0,0.40742525458335876,0.3105647563934326
8342893,5226682,5425182,13515,6403,1993,7110,1995,7112,6405,0.0,0.0,61,8.0,3,1,14,196.0,0.30943843722343445,0.1990332156419754
8344707,4980898,5024288,13515,5472,1990,5647,1991,8043,7868,0.0,0.0,36,13.0,5,6,21,980.0,0.16101902723312378,0.1011539027094841
8344727,7061241,6749184,13515,11121,2006,10393,2004,2394,3122,1.0,0.0,3,3.0,4,13,203,1617.0,0.43630078434944153,0.16540728509426117
8347336,6115074,4633512,13515,9014,2000,4016,1986,4501,9499,0.5,0.5,37,3.0,6,1,35,1505.0,0.48444652557373047,0.2684697210788727
8346336,5284140,7554454,13515,6613,1994,12234,2009,6902,1281,1.0,0.0,116,2.0,4,12,0,476.0,0.40153032541275024,0.36646953225135803
8342796,5344239,4222047,13515,6823,1994,1713,1980,6692,11802,0.0,0.0,18,18.0,14,2,98,3640.0,0.43768975138664246,0.218096524477005
8352277,6246977,5360860,13522,9294,2001,6879,1994,4228,6643,0.0,0.0,65,9.0,9,4,7,1078.0,0.41555583477020264,0.16604265570640564
8351713,6856705,4452079,13522,10638,2005,3078,1984,2884,10444,1.0,0.0,8,12.0,5,3,42,91.0,0.5376109480857849,0.05350843071937561
8352081,5634590,4012307,13522,7824,1997,439,1977,5698,13083,0.5,0.0,13,16.0,16,1,0,784.0,0.40342840552330017,0.3401157259941101
8349559,7032902,5693731,13522,11072,2006,8006,1997,2450,5516,0.0,0.0,5,4.0,2,2,1225,1302.0,-0.05198308452963829,0.06487422436475754
8349872,5686473,6417475,13522,7985,1997,9686,2002,5537,3836,1.0,0.0,6,2.0,3,13,2527,882.0,0.5104616284370422,0.04319113865494728
8351372,5953325,4419033,13522,8657,1999,2896,1983,4865,10626,1.0,0.0,71,12.0,24,2,56,1610.0,0.4480394124984741,0.19704806804656982
8351321,7414961,7139425,13522,11919,2008,11282,2006,1603,2240,1.0,0.0,23,11.0,127,9,49,266.0,0.5890138745307922,0.2889345586299896
8352086,7554105,6262072,13522,12234,2009,9329,2001,1288,4193,0.0,0.0,1,2.0,12,5,1288,553.0,0.5006159543991089,-0.013796073384582996
8351350,5526871,5454975,13522,7474,1996,7215,1995,6048,6307,0.0,0.0,22,4.0,11,14,161,861.0,0.2536880075931549,0.04380599781870842
8348675,6088004,5344033,13522,8958,2000,6823,1994,4564,6699,1.0,0.0,5,8.0,4,3,2149,2163.0,0.3750016391277313,0.22880375385284424
8352287,6738784,5700213,13522,10365,2004,8027,1997,3157,5495,0.5,0.0,26,5.0,22,11,42,42.0,0.25609999895095825,0.1845414787530899
8348963,6494909,4381185,13522,9847,2002,2672,1983,3675,10850,1.0,0.0,146,17.0,11,6,7,385.0,0.562660813331604,0.12581050395965576
8348425,4704016,4794757,13522,4324,1987,4751,1989,9198,8771,0.0,0.0,116,5.0,4,5,7,798.0,0.4238584339618683,0.044515740126371384
8349287,6660432,4638607,13522,10204,2003,4044,1987,3318,9478,0.5,0.0,31,9.0,9,3,42,273.0,0.4642544984817505,0.1154453456401825
8351562,5319686,4635806,13522,6732,1994,4030,1987,6790,9492,1.0,0.0,17,4.0,8,2,357,847.0,0.5131180882453918,0.23974749445915222
8355907,8155965,4294144,13529,13249,2012,2112,1981,280,11417,1.0,0.0,2,5.0,46,2,35,2499.0,0.9148217439651489,0.2914746105670929
8353369,6276453,5331605,13529,9364,2001,6774,1994,4165,6755,1.0,0.0,6,2.0,13,2,336,700.0,0.42870470881462097,0.23526513576507568
8353436,5100042,4991860,13529,5934,1992,5521,1991,7595,8008,1.0,0.0,61,4.0,11,1,7,1512.0,0.6047596335411072,0.40861237049102783
8353812,6991618,4419675,13529,10988,2006,2896,1983,2541,10633,1.0,0.0,6,9.0,22,3,91,175.0,0.2641242742538452,0.369267076253891
8355545,6148094,5487762,13529,9084,2000,7334,1996,4445,6195,1.0,0.0,151,3.0,13,8,0,392.0,0.37332645058631897,0.1473301649093628
8355511,7433907,4583996,13529,11968,2008,3764,1986,1561,9765,0.0,0.0,12,43.0,5,5,14,560.0,0.26320451498031616,0.10581713169813156
8356080,6317594,5869315,13529,9448,2001,8440,1999,4081,5089,0.0,0.0,183,6.0,7,2,0,637.0,0.4822799861431122,0.0969211608171463
8358040,7025837,5960859,13536,11058,2006,8678,1999,2478,4858,0.0,0.0,1,7.0,13,18,2478,721.0,0.5816332697868347,0.26758381724357605
8357148,6879339,3987926,13536,10694,2005,299,1976,2842,13237,0.0,0.0,22,7.0,8,1,7,2604.0,0.3706057667732239,0.15621726214885712
8357085,5443484,4059822,13536,7173,1995,691,1977,6363,12845,1.0,0.0,49,23.0,15,1,7,1036.0,0.534098207950592,0.23828962445259094
8361438,7060250,4617119,13543,11121,2006,3939,1986,2422,9604,0.5,0.0,1,2.0,53,1,2422,3619.0,0.39260557293891907,0.30705487728118896
8360455,5342073,7968952,13543,6816,1994,12962,2011,6727,581,1.0,0.0,22,2.0,2,8,91,273.0,0.6622592806816101,0.2502557933330536
8361496,5985259,7312749,13543,8720,1999,11681,2007,4823,1862,1.0,0.0,11,1.0,8,3,763,1862.0,0.5351722836494446,0.16642265021800995
8361090,5439000,6604320,13543,7159,1995,10085,2003,6384,3458,1.0,0.0,232,7.0,49,5,14,140.0,0.4497433602809906,0.11352194845676422
8365067,6754677,5533282,13543,10400,2004,7495,1996,3143,6048,1.0,0.0,12,20.0,22,6,126,105.0,0.3268108069896698,0.1506710797548294
8360498,5224720,6985516,13543,6396,1993,10967,2006,7147,2576,0.5,0.0,27,17.0,6,16,518,14.0,0.4985758364200592,0.1079184040427208
8362460,5484664,4468023,13543,7320,1996,3162,1984,6223,10381,1.0,0.0,156,12.0,20,2,56,1680.0,0.41399458050727844,0.0754479169845581
8363232,5222205,4977822,13543,6382,1993,5465,1990,7161,8078,0.0,0.0,111,10.0,2,3,7,4361.0,0.23237231373786926,0.15119624137878418
8361144,6942694,6926647,13543,10848,2005,10813,2005,2695,2730,1.0,0.0,60,7.0,8,5,14,707.0,0.4262436628341675,0.13193540275096893
8365287,7523500,6515195,13543,12164,2009,9896,2003,1379,3647,0.5,0.0,2,6.0,3,10,917,602.0,0.4907313883304596,0.24326951801776886
8361068,6827725,7561523,13543,10568,2004,12248,2009,2975,1295,1.0,0.0,37,3.0,8,6,0,63.0,0.614938497543335,0.16528290510177612
8360296,5535935,5313125,13543,7502,1996,6711,1994,6041,6832,1.0,0.0,258,6.0,51,3,7,756.0,0.6370818018913269,0.2919459044933319
8363917,6421411,4389577,13543,9693,2002,2728,1983,3850,10815,0.3333333333333333,0.0,22,3.0,12,3,588,259.0,0.6289095282554626,0.2119142860174179
8363814,5436965,3985481,13543,7145,1995,285,1976,6398,13258,1.0,0.0,116,17.0,18,1,7,2268.0,0.5892165899276733,0.34822916984558105
8363797,7181023,5329521,13543,11373,2007,6767,1994,2170,6776,0.0,1.0,20,11.0,20,8,56,455.0,0.3597091734409332,0.6417741179466248
8361105,6068610,6761838,13543,8916,2000,10421,2004,4627,3122,1.0,0.0,24,14.0,37,7,140,329.0,0.5767785906791687,0.05693906545639038
8366651,5586987,5564776,13550,7663,1996,7593,1996,5887,5957,1.0,0.0,16,25.0,7,15,14,119.0,0.3045181930065155,0.2494780719280243
8367317,6100380,7317273,13550,8986,2000,11695,2008,4564,1855,0.3333333333333333,0.0,22,3.0,48,2,105,147.0,0.3262051045894623,0.13978895545005798
8368534,6415150,7533601,13550,9679,2002,12192,2009,3871,1358,0.0,0.0,12,1.0,19,2,63,1358.0,0.36701878905296326,0.07849960774183273
8369967,7783304,5749212,13550,12654,2010,8167,1998,896,5383,0.0,0.0,7,9.0,124,13,203,798.0,0.35373082756996155,0.02516896277666092
8370018,6928349,6971446,13550,10813,2005,10932,2005,2737,2618,0.0,0.0,13,4.0,2,4,21,259.0,0.40229129791259766,0.2362843155860901
8370423,7003546,5236040,13550,11009,2006,6438,1993,2541,7112,1.0,0.0,58,6.0,20,7,7,658.0,0.5040421485900879,0.16449253261089325
8369470,7920621,6167466,13550,12878,2011,9126,2000,672,4424,1.0,0.0,2,13.0,5,14,224,147.0,0.6362860798835754,0.3672086000442505
8373443,7601984,4680665,13557,12339,2009,4212,1987,1218,9345,0.0,0.0,33,6.0,9,7,7,287.0,0.3305973410606384,0.3049025535583496
8373202,6495442,4292946,13557,9847,2002,2105,1981,3710,11452,1.0,0.0,105,2.0,8,1,7,9849.0,0.5769322514533997,0.19136016070842743
8372684,6632113,4421213,13557,10148,2003,2910,1983,3409,10647,1.0,0.0,25,3.0,11,1,42,1960.0,0.45149388909339905,0.0027293639723211527
8371494,5964394,6112139,13557,8685,1999,9007,2000,4872,4550,1.0,0.0,102,10.0,54,3,28,574.0,0.6719475984573364,0.25641340017318726
8372872,6037344,5496437,13557,8839,2000,7369,1996,4718,6188,0.0,0.0,6,3.0,3,4,2233,4823.0,0.1793474406003952,0.13238507509231567
8373516,7562708,5545700,13557,12255,2009,7530,1996,1302,6027,0.0,0.0,11,3.0,17,13,49,623.0,0.16204410791397095,0.17671999335289001
8372714,7354829,4085200,13557,11786,2008,838,1978,1771,12719,1.0,0.0,3,2.0,24,3,322,8561.0,0.3924660086631775,0.3265160918235779
8370999,7784159,5432788,13557,12661,2010,7131,1995,896,6426,0.5,0.0,1,4.0,39,3,896,1022.0,0.3837938606739044,0.25510549545288086
8373659,6304250,7568345,13557,9420,2001,12269,2009,4137,1288,1.0,0.0,43,3.0,12,2,7,210.0,0.5043438076972961,0.28195229172706604
8372036,7176030,7873572,13557,11366,2007,12801,2011,2191,756,0.0,0.0,42,1.0,24,65,84,756.0,0.3237362205982208,0.14952686429023743
8371161,5609205,4581323,13557,7740,1997,3750,1986,5817,9807,1.0,0.0,16,19.0,3,4,77,3416.0,0.41983652114868164,0.21077154576778412
8372276,7713413,7829662,13557,12549,2010,12731,2010,1008,826,1.0,0.0,8,1.0,11,2,77,826.0,0.3690473139286041,0.07105473428964615
8370966,5873788,5459755,13557,8454,1999,7229,1995,5103,6328,0.0,0.0,8,12.0,11,2,350,1022.0,0.47342604398727417,0.10013265907764435
re43993,5546461,7064810,13557,7530,1996,11128,2006,6027,2429,0.3333333333333333,0.0,50,15.0,13,25,105,14.0,0.5462385416030884,0.2938787639141083
8377566,7225542,5381239,13564,11478,2007,6949,1995,2086,6615,0.0,0.0,2,3.0,9,5,371,3073.0,0.29254254698753357,0.07319197058677673
8376961,5279562,7630744,13564,6592,1994,12395,2009,6972,1169,1.0,0.0,141,4.0,6,2,7,196.0,0.33458319306373596,0.2545567452907562
8377066,7704253,6532419,13564,12535,2010,9931,2003,1029,3633,1.0,0.0,13,24.0,93,30,21,84.0,0.12843959033489227,0.2980481684207916
8380874,5963551,4517795,13564,8678,1999,3428,1985,4886,10136,0.0,0.0,75,6.0,6,3,49,686.0,0.4797447621822357,0.3848589062690735
8380779,8090757,7388458,13564,13151,2012,11856,2008,413,1708,1.0,0.0,1,2.0,24,1,413,63.0,0.2544298470020294,0.09549569338560104
8376332,5439203,4184662,13564,7159,1995,1482,1980,6405,12082,0.0,0.0,14,4.0,4,1,315,6440.0,0.4245595633983612,0.24192465841770172
8380251,5651056,4291512,13564,7873,1997,2098,1981,5691,11466,1.0,0.0,88,5.0,21,2,56,3339.0,0.46401190757751465,0.18195544183254242
8378808,7170418,5422664,13564,11352,2007,7096,1995,2212,6468,1.0,0.0,9,30.0,26,6,7,210.0,0.42571336030960083,0.0839352086186409
8377092,6165198,7450160,13564,9126,2000,12003,2008,4438,1561,1.0,0.0,79,1.0,20,2,14,1561.0,0.5985769629478455,0.2655527591705322
8386081,5045769,6304140,13571,5724,1991,9420,2001,7847,4151,0.0,0.0,28,15.0,2,7,7,84.0,0.24541454017162323,0.2052576243877411
8384693,4818826,5956482,13571,4842,1989,8664,1999,8729,4907,0.0,0.0,49,35.0,1,2,7,7.0,0.3341436982154846,0.21381017565727234
8381806,8177305,4146836,13571,13284,2012,1181,1979,287,12390,0.5,0.0,4,3.0,728,1,35,7679.0,0.4477294981479645,0.12763231992721558
8382942,8043472,6178539,13571,13081,2011,9154,2001,490,4417,1.0,0.0,1,18.0,4,4,490,154.0,0.6534346342086792,0.20295967161655426
8381372,5845885,5309899,13571,8377,1998,6704,1994,5194,6867,0.0,0.0,82,14.0,7,2,21,84.0,0.45587822794914246,0.14353644847869873
8381815,7090013,4951304,13571,11184,2006,5346,1990,2387,8225,1.0,0.0,143,6.0,512,1,21,189.0,0.5462372899055481,0.06752727180719376
8382754,6387094,7528515,13571,9630,2002,12178,2009,3941,1393,1.0,0.0,116,9.0,4,9,21,154.0,0.5279219746589661,0.2075648307800293
8381711,4576072,5290351,13571,3729,1986,6634,1994,9842,6937,0.0,0.0,42,1.0,2,1,84,6937.0,0.4508216977119446,0.10533428937196732
8386237,6272456,4766825,13571,9350,2001,4625,1988,4221,8946,0.5,0.0,61,1.0,12,1,7,8946.0,0.36879950761795044,0.1863701492547989
8382311,7220013,6299723,13571,11464,2007,9413,2001,2107,4158,1.0,0.0,7,1.0,8,2,35,4158.0,0.5889112949371338,0.11403387784957886
8384296,7358686,4404345,13571,11793,2008,2812,1983,1778,10759,0.5,0.0,3,15.0,17,14,385,462.0,0.4887595474720001,0.0738372877240181
8386722,7277333,6358724,13571,11597,2007,9574,2002,1974,3997,0.0,0.0,28,1.0,16,3,21,3997.0,0.3939920663833618,0.030657457187771797
8392686,6167465,4759633,13578,9126,2000,4590,1988,4452,8988,1.0,0.0,140,8.0,5,4,63,462.0,0.460328072309494,0.40576574206352234
8392947,6536041,5185255,13578,9938,2003,6249,1993,3640,7329,1.0,0.0,135,6.0,11,6,0,63.0,0.46537113189697266,0.15872977674007416
8392499,6560639,4135119,13578,9987,2003,1111,1979,3591,12467,1.0,0.0,123,14.0,10,1,7,623.0,0.37299180030822754,0.230460524559021
8388551,5700695,4162908,13578,8027,1997,1307,1979,5551,12271,0.0,0.0,264,21.0,18,1,7,70.0,0.30986538529396057,0.247518852353096
8392747,5936539,6571419,13578,8622,1999,10015,2003,4956,3563,0.5,0.0,62,2.0,7,2,7,357.0,0.3791986405849457,0.15604861080646515
8392188,5210689,4319456,13578,6340,1993,2266,1982,7238,11312,0.0,0.0,60,9.0,10,1,217,4025.0,0.4409066438674927,0.17986123263835907
8387245,6086328,6270549,13578,8958,2000,9350,2001,4620,4228,0.0,0.0,17,21.0,12,52,63,301.0,0.4061204791069031,0.13160058856010437
8391258,5886894,5528649,13578,8482,1999,7474,1996,5096,6104,0.0,0.0,21,15.0,7,1,42,1428.0,0.4253176748752594,0.0631924718618393
8388611,5366490,6634971,13578,6900,1994,10155,2003,6678,3423,1.0,0.0,387,2.0,125,14,14,196.0,0.3034060299396515,0.16046108305454254
8390397,7388454,5286955,13578,11856,2008,6620,1994,1722,6958,1.0,0.0,26,20.0,157,3,56,7.0,0.6220791935920715,0.21090896427631378
8392549,6505254,4829429,13578,9868,2003,4877,1989,3710,8701,1.0,0.0,82,10.0,20,6,70,224.0,0.45407167077064514,0.331773966550827
8393448,5848675,4029184,13585,8384,1998,530,1977,5201,13055,0.5,1.0,38,3.0,49,1,133,3577.0,0.6126180291175842,0.39211151003837585
8396354,7260318,5106271,13585,11555,2007,5955,1992,2030,7630,0.5,0.0,4,3.0,3,13,252,3024.0,0.688169538974762,0.31702932715415955
8396527,5924982,6961422,13585,8601,1999,10897,2005,4984,2688,1.0,0.0,74,9.0,5,10,7,7.0,0.41500943899154663,0.1955324113368988
8394286,5895793,4227507,13585,8510,1999,1748,1980,5075,11837,0.5,0.0,25,5.0,5,5,14,2702.0,0.49987858533859253,0.19861149787902832
8396079,7356098,4157360,13585,11786,2008,1251,1979,1799,12334,0.5,0.0,2,49.0,4,4,826,105.0,0.4474918246269226,-0.016378050670027733
8396942,7607131,5722891,13585,12346,2009,8097,1998,1239,5488,0.5,0.0,2,8.0,11,5,602,7.0,0.46630218625068665,0.11416396498680115
8396914,7769797,4929732,13585,12633,2010,5262,1990,952,8323,1.0,0.0,8,3.0,8,5,14,1967.0,0.2858617901802063,0.12003299593925476
8396838,5226157,6193532,13585,6396,1993,9189,2001,7189,4396,1.0,0.0,226,8.0,13,5,7,560.0,0.31372061371803284,0.21449363231658936
8393120,5544455,7466575,13585,7530,1996,12038,2008,6055,1547,1.0,0.0,18,11.0,17,9,140,21.0,0.6607534289360046,0.0544138140976429
8397084,7043637,5892193,13585,11086,2006,8496,1999,2499,5089,1.0,0.0,56,4.0,33,2,14,952.0,0.5343258380889893,0.17959079146385193
8397108,7860016,6601272,13585,12780,2010,10078,2003,805,3507,0.0,0.0,5,5.0,22,7,252,147.0,0.4534113109111786,0.25753718614578247
8396825,7062447,5320535,13585,11121,2006,6739,1994,2464,6846,1.0,0.0,18,6.0,47,4,175,679.0,0.1325741857290268,0.05335957929491997
8397794,4811780,6190389,13592,4821,1989,9182,2001,8771,4410,1.0,0.0,15,18.0,1,11,203,154.0,0.40330007672309875,0.32960107922554016
8398559,6217524,7088733,13592,9238,2001,11177,2006,4354,2415,1.0,0.0,17,4.0,12,9,0,7.0,0.7228404879570007,0.2355535626411438
8401688,6405211,6824937,13592,9658,2002,10561,2004,3934,3031,1.0,0.5,27,1.0,28,2,91,3031.0,0.3012910485267639,0.10259763151407242
8399467,8003646,4182688,13592,13018,2011,1468,1980,574,12124,1.0,0.0,1,9.0,6,1,574,476.0,0.9999999403953552,0.28638219833374023
8398001,4871489,5293649,13592,5024,1989,6648,1994,8568,6944,0.0,0.0,77,10.0,3,7,28,259.0,0.1812986433506012,0.22651803493499756
8400811,7324387,6956036,13592,11716,2008,10883,2005,1876,2709,1.0,0.0,33,6.0,6,13,7,140.0,0.46477210521698,0.12437473237514496
8399629,6407213,4774627,13592,9665,2002,4653,1988,3927,8939,0.0,0.0,130,2.0,14,4,0,8029.0,0.1880805492401123,0.088430255651474
8400222,7863645,7946153,13592,12787,2011,12927,2011,805,665,0.0,0.0,7,1.0,22,14,91,665.0,0.5759617686271667,0.38629576563835144
8398611,re39587,7266539,13592,11436,2007,11569,2007,2156,2023,1.0,0.0,9,1.0,16,8,147,2023.0,0.34654414653778076,-0.01286275777965784
8397846,6725956,4694008,13592,10344,2004,4275,1987,3248,9317,0.5,0.0,24,2.0,3,12,98,8400.0,0.5485742688179016,0.1978793889284134
8397992,5714745,4930667,13592,8069,1998,5269,1990,5523,8323,1.0,0.0,83,22.0,65,9,35,1218.0,0.33151620626449585,0.06521172821521759
8398105,5521821,4555926,13592,7453,1996,3624,1985,6139,9968,0.0,0.0,9,6.0,15,1,406,210.0,0.47104522585868835,0.2604307234287262
8399828,6512225,4939954,13592,9889,2003,5304,1990,3703,8288,1.0,0.0,11,12.0,2,10,455,455.0,0.8135199546813965,0.180537149310112
8402142,5025486,5855219,13592,5647,1991,8405,1999,7945,5187,0.0,0.0,120,5.0,3,6,28,189.0,0.33022522926330566,0.18516595661640167
8398683,5545228,4232775,13592,7530,1996,1776,1980,6062,11816,1.0,0.0,100,11.0,24,1,49,70.0,0.4843475818634033,0.25506943464279175
8397841,6138779,4900878,13592,9070,2000,5157,1990,4522,8435,1.0,0.0,20,7.0,117,10,35,2618.0,0.5984082818031311,0.21028029918670654
8405350,6462510,5750498,13599,9777,2002,8167,1998,3822,5432,1.0,0.0,13,16.0,6,5,84,1722.0,0.5971588492393494,0.11418789625167847
8403578,5518014,7926606,13599,7446,1996,12892,2011,6153,707,0.0,0.0,2,2.0,1,1,4627,21.0,0.626388669013977,0.2145949900150299
8405162,6931617,4387198,13599,10820,2005,2714,1983,2779,10885,0.0,0.0,96,6.0,1,7,14,7385.0,0.20463615655899048,0.1604899764060974
8403864,6569157,5940163,13599,10008,2003,8629,1999,3591,4970,1.0,0.0,128,11.0,8,24,21,77.0,0.31039872765541077,0.20288792252540588
8407533,6311305,4779684,13599,9434,2001,4681,1988,4165,8918,0.0,0.0,23,16.0,8,4,441,56.0,0.5224786400794983,0.1272510588169098
8405608,6285896,4917269,13599,9378,2001,5220,1990,4221,8379,0.0,0.0,250,31.0,34,2,7,616.0,0.41312575340270996,0.16284941136837006
8404113,6289684,5441837,13599,9392,2001,7166,1995,4207,6433,0.5,0.0,14,6.0,5,9,189,175.0,0.5078811049461365,0.17386339604854584
8405594,4885211,6226990,13599,5087,1989,9259,2001,8512,4340,0.0,0.0,433,6.0,10,29,0,266.0,0.4520532488822937,0.191486656665802
8409131,7460898,4224510,13606,12024,2008,1727,1980,1582,11879,1.0,0.0,136,2.0,104,1,0,3171.0,0.6977328658103943,0.3697325587272644
8408905,6273720,4663243,13606,9357,2001,4142,1987,4249,9464,1.0,0.0,26,11.0,15,6,14,532.0,0.630560576915741,0.2745215594768524
8411530,5315562,5275819,13606,6718,1994,6578,1994,6888,7028,1.0,0.0,31,21.0,3,6,105,595.0,0.41959404945373535,0.05662163719534874
8408984,5123649,7054704,13606,6018,1992,11107,2006,7588,2499,1.0,0.0,244,7.0,2,147,28,308.0,0.5538708567619324,0.21185223758220673
8408290,4901794,6164722,13606,5164,1990,9126,2000,8442,4480,1.0,0.0,8,4.0,2,6,259,1141.0,0.5227435827255249,0.3956204652786255
8409167,6652577,6246077,13606,10190,2003,9294,2001,3416,4312,1.0,0.0,7,18.0,49,16,63,392.0,0.16635262966156006,0.10363895446062088
8410945,4709265,4101617,13606,4345,1987,929,1978,9261,12677,0.0,0.0,85,12.0,2,1,14,364.0,0.435282438993454,0.19687895476818085
8408370,6203105,7361177,13606,9210,2001,11800,2008,4396,1806,0.0,0.0,37,2.0,21,3,315,14.0,0.1835411638021469,0.23622995615005493
8409191,6926669,6710760,13606,10813,2005,10309,2004,2793,3297,1.0,0.0,18,13.0,60,14,196,112.0,0.7391147613525391,0.11557856947183609
8412675,7206806,3995638,13606,11429,2007,341,1976,2177,13265,0.0,0.0,49,24.0,15,1,14,28.0,0.39599373936653137,0.17161063849925995
8409188,7112199,4980803,13606,11226,2006,5472,1990,2380,8134,1.0,0.0,119,4.0,10,4,21,770.0,0.2604708671569824,0.32067981362342834
8409249,5844016,4148603,13606,8370,1998,1195,1979,5236,12411,0.0,0.0,50,32.0,62,3,35,1449.0,0.4444812536239624,0.2399384081363678
8415973,6703861,7181693,13613,10295,2004,11373,2007,3318,2240,0.5,0.5,86,4.0,30,28,91,322.0,0.4200114905834198,0.15269283950328827
8417823,7149780,6843829,13613,11303,2006,10610,2005,2310,3003,1.0,0.0,28,4.0,47,14,7,203.0,0.2464163452386856,0.013243605382740498
8417392,7567888,7226023,13613,12262,2009,11478,2007,1351,2135,0.0,0.0,1,4.0,7,2,1351,231.0,0.3994237780570984,0.22456158697605133
8417343,7717848,4321635,13613,12556,2010,2273,1982,1057,11340,1.0,0.0,25,47.0,69,4,21,84.0,0.231720969080925,0.07651959359645844
8417024,5801760,4692599,13613,8279,1998,4268,1987,5334,9345,0.0,0.0,40,13.0,11,3,14,7.0,0.6809569001197815,0.11902002990245819
8414577,5713505,7662001,13613,8069,1998,12465,2010,5544,1148,1.0,0.0,220,3.0,27,28,0,406.0,0.4801068603992462,0.3827725648880005
8413493,6109783,4958188,13613,9007,2000,5374,1990,4606,8239,1.0,0.0,23,8.0,3,6,126,2331.0,0.19096092879772186,0.3687400817871094
8416579,6027227,4296735,13613,8818,2000,2126,1981,4795,11487,0.0,0.0,8,2.0,4,8,343,6356.0,0.29946744441986084,0.26783376932144165
8417490,6571136,4133070,13613,10008,2003,1104,1979,3605,12509,0.0,0.0,21,16.0,10,1,42,2268.0,0.48362237215042114,0.17205555737018585
8417309,5588427,4359338,13613,7670,1996,2511,1982,5943,11102,1.0,0.0,120,2.0,3,3,21,10479.0,0.24711300432682037,0.10497216135263443
8417515,6449596,4600413,13613,9749,2002,3848,1986,3864,9765,1.0,0.0,45,17.0,5,2,14,63.0,0.5111339688301086,0.1364668905735016
8416339,5773814,4358033,13613,8216,1998,2504,1982,5397,11109,0.3333333333333333,0.0,33,9.0,10,1,84,1925.0,0.3662307560443878,0.1501096487045288
8419693,6911014,4521499,13620,10771,2005,3442,1985,2849,10178,0.5,0.0,13,17.0,24,6,126,133.0,0.6292839646339417,0.1203540787100792
8419598,7448986,5450704,13620,12003,2008,7201,1995,1617,6419,1.0,0.0,8,3.0,196,13,56,49.0,0.6009355783462524,0.3035568594932556
8422784,7551182,5378738,13620,12227,2009,6942,1995,1393,6678,0.3333333333333333,0.0,13,4.0,1,2,196,1820.0,0.5345264673233032,0.39722225069999695
8421524,6525614,6714778,13620,9917,2003,10316,2004,3703,3304,0.0,0.0,12,15.0,2,11,28,21.0,0.13167467713356018,-0.017482461407780647
8421606,6937150,4513523,13620,10834,2005,3407,1985,2786,10213,1.0,0.0,46,12.0,93,3,35,889.0,0.587008535861969,0.16831009089946747
8421902,5774746,4460738,13620,8216,1998,3120,1984,5404,10500,0.0,0.0,7,22.0,24,6,728,98.0,0.5720299482345581,0.275959849357605
8419653,4990148,4146421,13620,5514,1991,1181,1979,8106,12439,1.0,0.0,53,4.0,3,1,14,9870.0,0.21118420362472534,0.2522534430027008
8419034,6213486,5331856,13620,9231,2001,6781,1994,4389,6839,1.0,0.0,37,4.0,16,1,77,791.0,0.4317105710506439,0.2758558988571167
8419034,7434825,7822594,13620,11975,2008,12717,2010,1645,903,0.5,0.0,2,2.0,9,10,77,147.0,0.43638235330581665,0.15709106624126434
8420318,5741462,6620474,13620,8146,1998,10120,2003,5474,3500,0.2,0.0,94,17.0,155,18,28,21.0,0.43409624695777893,0.25693902373313904
8418549,5535633,4123398,13620,7502,1996,1034,1978,6118,12586,1.0,0.0,27,5.0,21,1,28,805.0,0.5066332221031189,0.007636457681655884
8422830,5339399,7575898,13620,6802,1994,12283,2009,6818,1337,1.0,0.0,42,2.0,3,3,259,357.0,0.4819723963737488,0.16705763339996338
8428773,6612494,6010245,13627,10106,2003,8769,2000,3521,4858,1.0,0.0,48,3.0,10,19,7,2373.0,0.27424323558807373,0.3464421331882477
8426166,3996345,4159854,13627,341,1976,1279,1979,13286,12348,0.0,0.0,531,5.0,1,1,14,112.0,0.28916671872138977,0.2539927065372467
8424203,6888720,7706034,13627,10715,2005,12535,2010,2912,1092,1.0,0.0,11,2.0,11,3,70,329.0,0.466433584690094,0.07967181503772736
8425894,4431427,5039247,13627,2966,1984,5703,1991,10661,7924,1.0,1.0,31,26.0,1,6,483,518.0,0.3568633794784546,0.1506076157093048
8425763,6271173,5204217,13627,9350,2001,6319,1993,4277,7308,0.0,0.0,18,6.0,9,2,245,763.0,0.6892460584640503,0.24018685519695282
8425417,5429485,4177934,13627,7124,1995,1440,1979,6503,12187,0.0,0.0,104,41.0,19,1,0,2541.0,0.2708890736103058,0.1562805324792862
8427337,5999141,4799900,13627,8741,1999,4772,1989,4886,8855,1.0,1.0,6,20.0,10,7,329,238.0,0.5669205188751221,0.33243614435195923
8429214,6978287,4151747,13627,10946,2005,1216,1979,2681,12411,1.0,0.0,18,5.0,17,1,21,1414.0,0.3018312156200409,0.24049653112888336
8429384,6163839,8085395,13627,9119,2000,13144,2011,4508,483,1.0,0.0,15,1.0,9,1,742,483.0,0.595056414604187,0.09102077037096024
8424764,6600160,4444095,13627,10071,2003,3036,1984,3556,10591,0.0,0.0,24,34.0,17,3,455,364.0,0.6748970150947571,0.11267344653606415
8428675,6597933,5171141,13627,10064,2003,6193,1992,3563,7434,1.0,0.0,256,5.0,15,5,7,42.0,0.2786387503147125,0.04530825838446617
8428995,7181477,4318052,13627,11373,2007,2252,1982,2254,11375,1.0,0.0,8,5.0,3,1,105,2338.0,0.17884483933448792,0.1439168006181717
8427336,7506541,4950128,13627,12136,2009,5346,1990,1491,8281,0.5,0.0,3,3.0,16,5,0,56.0,0.4076932966709137,0.22830751538276672
8429265,7343399,7755698,13627,11758,2008,12612,2010,1869,1015,1.0,0.0,16,1.0,11,12,35,1015.0,0.4443195164203644,0.2028043121099472
8426899,7105300,4215706,13627,11212,2006,1678,1980,2415,11949,0.0,0.0,44,13.0,60,1,0,497.0,0.4634244740009308,0.12317083775997162
8431752,5730784,6270712,13634,8118,1998,9350,2001,5516,4284,0.0,0.0,11,8.0,26,4,84,1701.0,0.2726692259311676,0.09184710681438446
8430893,6517553,4210411,13634,9903,2003,1643,1980,3731,11991,1.0,0.0,61,6.0,172,2,14,5306.0,0.6806086301803589,0.22235743701457977
8430901,6086605,4103971,13634,8958,2000,943,1978,4676,12691,1.0,0.0,202,3.0,27,1,14,84.0,0.6587064266204834,0.17851775884628296
8430507,5008548,8008255,13634,5584,1991,13025,2011,8050,609,0.0,0.0,65,1.0,6,26,126,609.0,0.18036796152591705,0.13242176175117493
8430105,5382260,6708444,13634,6956,1995,10309,2004,6678,3325,1.0,0.0,116,7.0,2,19,7,91.0,0.2760275900363922,0.23042090237140656
8430850,5147375,4163541,13634,6102,1992,1314,1979,7532,12320,1.0,0.0,83,6.0,5,3,28,5110.0,0.38264200091362,0.15360166132450104
8430433,4687017,5715073,13634,4247,1987,8069,1998,9387,5565,1.0,0.0,39,10.0,5,13,21,154.0,0.3569153845310211,0.12816458940505981
8430916,7513905,5275093,13634,12150,2009,6578,1994,1484,7056,1.0,0.0,25,20.0,54,11,49,567.0,0.32416388392448425,0.13608644902706146
8432293,5287112,7060414,13634,6620,1994,11121,2006,7014,2513,0.0,0.0,109,3.0,7,15,28,1974.0,0.5245224237442017,0.11463553458452225
8436792,6456337,5364413,13641,9763,2002,6893,1994,3878,6748,0.0,0.0,17,3.0,7,6,119,3486.0,0.538659930229187,0.07262472808361053
8437271,6947723,7997521,13641,10855,2005,13011,2011,2786,630,0.0,0.0,21,1.0,22,10,42,630.0,0.3540317118167877,0.3060292601585388
8437822,6542764,6504418,13641,9952,2003,9868,2003,3689,3773,1.0,0.0,256,9.0,22,13,7,21.0,0.3431905508041382,-0.013151127845048904
8434397,5589901,6263688,13641,7670,1996,9336,2001,5971,4305,0.0,0.0,31,4.0,5,5,28,798.0,0.3715769946575165,0.2447107583284378
8434244,4391048,5380724,13641,2742,1983,6949,1995,10899,6692,1.0,0.0,98,1.0,3,3,147,6692.0,0.4427568018436432,0.10358460247516632
8435236,7037322,5898023,13641,11079,2006,8517,1999,2562,5124,1.0,0.0,13,6.0,112,1,84,399.0,0.3637113869190216,0.0933242067694664
8438602,6907602,4396937,13641,10757,2005,2770,1983,2884,10871,0.0,1.0,45,11.0,9,2,42,4466.0,0.24177463352680206,0.2818046808242798
8435551,6437018,5856997,13641,9728,2002,8405,1999,3913,5236,1.0,0.0,46,16.0,17,2,7,252.0,0.5013940930366516,0.10274898260831833
8440567,7125582,8112130,13648,11254,2006,13186,2012,2394,462,0.0,0.0,17,2.0,1,8,70,84.0,0.320537269115448,0.23470868170261383
8438766,5778583,5448135,13648,8230,1998,7187,1995,5418,6461,1.0,0.0,10,12.0,1,4,168,7.0,0.6205765008926392,0.372359961271286
re44222,6282300,5573715,13648,9371,2001,7621,1996,4277,6027,0.0,0.0,115,10.0,1,4,77,42.0,0.3729388117790222,0.12889333069324493
8443134,7058769,4954532,13648,11114,2006,5360,1990,2534,8288,1.0,0.0,26,20.0,3,2,42,2009.0,0.39592963457107544,0.2915923595428467
8443294,7708015,8121022,13648,12542,2010,13200,2012,1106,448,0.0,0.0,2,1.0,22,4,147,448.0,0.35763582587242126,0.05679648369550705
8439687,6450975,4297455,13648,9756,2002,2126,1981,3892,11522,0.0,0.0,42,31.0,24,7,7,1106.0,0.2510193884372711,0.07673311233520508
8440044,4756973,4075299,13648,4576,1988,782,1978,9072,12866,0.0,1.0,65,2.0,5,1,14,5215.0,0.2653505802154541,0.3060404062271118
8440416,5698448,5500905,13648,8020,1997,7383,1996,5628,6265,1.0,0.0,17,7.0,5,8,42,1169.0,0.2634008228778839,0.09151562303304672
8440650,4920098,5894214,13648,5227,1990,8503,1999,8421,5145,0.5,0.0,77,14.0,12,11,14,595.0,0.6680794358253479,0.07794883847236633
8439369,7758289,7382740,13648,12619,2010,11842,2008,1029,1806,1.0,0.0,1,2.0,8,1,1029,539.0,0.5760448575019836,0.014752223156392574
8439032,8210173,4184416,13648,13333,2012,1482,1980,315,12166,0.5,0.0,14,14.0,8,4,7,77.0,0.4014907479286194,0.2046256959438324
8441699,7271935,4971576,13648,11583,2007,5437,1990,2065,8211,0.0,0.0,21,16.0,21,4,105,224.0,0.54446941614151,0.060451630502939224
8439262,5471533,5088932,13648,7271,1995,5892,1992,6377,7756,0.0,0.0,196,12.0,21,5,0,4333.0,0.5187128186225891,0.11973939090967178
8440201,4888280,6853735,13648,5101,1989,10631,2005,8547,3017,0.0,0.0,6,4.0,2,2,4116,77.0,0.44356516003608704,-0.008932139724493027
8444094,4471927,5568222,13655,3183,1984,7600,1996,10472,6055,1.0,0.0,46,5.0,1,13,84,1687.0,0.5944028496742249,0.33983924984931946
8448215,5684525,4382111,13655,7978,1997,2679,1983,5677,10976,1.0,0.0,202,13.0,9,4,14,595.0,0.4597468674182892,0.09747613221406937
8443828,4887667,5374267,13655,5101,1989,6928,1994,8554,6727,0.5,0.0,4,37.0,1,7,1204,21.0,0.3871881365776062,0.19571155309677124
8443757,8033247,5071434,13655,13067,2011,5822,1991,588,7833,1.0,0.0,4,13.0,59,3,140,189.0,0.5987406373023987,0.09057573229074478
8444464,7038855,4398802,13655,11079,2006,2784,1983,2576,10871,0.5,0.0,57,2.0,44,3,7,3829.0,0.35310059785842896,0.15276290476322174
8446120,6702594,6616156,13655,10295,2004,10113,2003,3360,3542,0.0,0.0,46,6.0,7,1,168,371.0,0.31171470880508423,0.3174792230129242
8443560,7415805,7830431,13655,11926,2008,12731,2010,1729,924,1.0,0.0,4,1.0,22,13,483,924.0,0.524286687374115,0.29728609323501587
8444117,6644626,6296605,13655,10176,2003,9406,2001,3479,4249,1.0,0.0,4,2.0,10,3,1673,1764.0,0.3420700430870056,0.18989038467407227
8448782,5582293,7823878,13662,7649,1996,12724,2010,6013,938,1.0,1.0,17,2.0,1,6,364,567.0,0.4163118600845337,0.14703680574893951
8449360,7589727,7129879,13662,12311,2009,11261,2006,1351,2401,0.0,0.0,18,3.0,38,9,7,56.0,0.5308530926704407,0.3334386646747589
8451857,6256317,7685866,13662,9315,2001,12507,2010,4347,1155,1.0,0.0,32,1.0,13,1,70,1155.0,0.2848367691040039,0.20833653211593628
8452629,5953533,6241879,13662,8657,1999,9287,2001,5005,4375,0.5,0.0,55,3.0,13,8,7,1820.0,0.46410495042800903,0.18407638370990753
8450069,5041733,4369407,13662,5710,1991,2574,1983,7952,11088,1.0,1.0,18,9.0,3,3,147,14.0,0.07232680171728134,0.1267504245042801
8449918,5632996,4381185,13662,7817,1997,2672,1983,5845,10990,1.0,0.0,24,20.0,12,6,175,7.0,0.5592712163925171,0.19262899458408356
8449452,5395366,5502511,13662,7005,1995,7390,1996,6657,6272,1.0,0.0,100,5.0,10,3,7,567.0,0.44241952896118164,0.2113037258386612
8449806,5977515,4161269,13662,8706,1999,1293,1979,4956,12369,0.0,0.0,28,12.0,5,1,203,3766.0,0.4953193664550781,0.23584285378456116
8453663,6517586,5500481,13669,9903,2003,7383,1996,3766,6286,0.5,0.0,18,15.0,1,9,147,2716.0,0.26238131523132324,0.27178916335105896
8453907,5485947,4650082,13669,7327,1996,4093,1987,6342,9576,1.0,0.0,311,16.0,55,3,14,203.0,0.4510895013809204,0.10847320407629013
8456125,5216777,7972509,13669,6368,1993,12969,2011,7301,700,0.0,0.0,41,2.0,5,8,21,420.0,0.2758331000804901,0.1709679514169693
8457108,6801940,4878333,13669,10505,2004,5059,1989,3164,8610,0.5,0.0,200,7.0,13,5,28,476.0,0.37894296646118164,0.2822928726673126
8458530,7178050,5481413,13669,11366,2007,7306,1996,2303,6363,1.0,0.0,30,6.0,15,6,35,3773.0,0.2969372272491455,0.11041414737701416
8458032,7374096,4448959,13669,11828,2008,3057,1984,1841,10612,1.0,0.0,8,2.0,88,2,7,9975.0,0.5039974451065063,0.05483284220099449
8458287,7546342,7513709,13669,12213,2009,12150,2009,1456,1519,0.3333333333333333,0.0,11,4.0,9,7,189,245.0,0.49549877643585205,0.15679968893527985
8453764,5220963,4563809,13669,6382,1993,3666,1986,7287,10003,0.5,0.0,98,8.0,9,1,84,2919.0,0.47946855425834656,0.16059337556362152
8457707,6697658,4931573,13669,10281,2004,5269,1990,3388,8400,1.0,0.0,279,9.0,2,5,0,224.0,0.366231769323349,0.022971898317337036
8453632,5497512,5907409,13669,7376,1996,8545,1999,6293,5124,0.0,0.0,4,2.0,3,5,343,3248.0,0.5676698088645935,0.21667228639125824
8453908,7721930,6491486,13669,12563,2010,9840,2002,1106,3829,1.0,0.0,41,1.0,9,5,0,3829.0,0.6350864171981812,0.3148829936981201
8455141,6444343,4451519,13669,9742,2002,3071,1984,3927,10598,1.0,0.0,40,5.0,16,1,63,196.0,0.5935987234115601,0.12598644196987152
8462683,5781859,6433464,13676,8230,1998,9721,2002,5446,3955,1.0,0.0,35,15.0,9,58,112,49.0,0.4221426844596863,0.24855604767799377
8461672,6340845,5469973,13676,9518,2002,7271,1995,4158,6405,1.0,0.0,24,18.0,7,13,42,35.0,0.3119273781776428,0.12854112684726715
8461985,5617851,4655579,13676,7768,1997,4114,1987,5908,9562,0.0,0.0,232,21.0,34,4,7,1197.0,0.24347032606601715,0.268067330121994
8460828,6780207,4053221,13676,10463,2004,649,1977,3213,13027,1.0,0.0,3,5.0,5,1,28,10591.0,0.6335684657096863,0.25278526544570923
8460762,4954371,6867994,13676,5360,1990,10666,2005,8316,3010,0.0,0.0,166,8.0,20,4,42,231.0,0.5489821434020996,0.14723868668079376
8460449,7632344,4300990,13676,12402,2009,2147,1981,1274,11529,1.0,0.0,4,36.0,17,4,14,133.0,0.5985846519470215,0.019210686907172203
8461789,7180262,7686992,13676,11373,2007,12507,2010,2303,1169,0.5,0.0,5,1.0,6,21,7,1169.0,0.3016698956489563,0.009015440940856934
8464224,7293260,6581524,13676,11632,2007,10036,2003,2044,3640,1.0,0.0,41,2.0,6,9,7,637.0,0.46703803539276123,0.1863563507795334
8460203,5503151,5098372,13676,7397,1996,5927,1992,6279,7749,1.0,1.0,29,12.0,11,5,861,7.0,0.5036901831626892,0.37461206316947937
8465546,4932975,4156850,13683,5276,1990,1244,1979,8407,12439,1.0,0.0,460,33.0,7,4,7,21.0,0.41307029128074646,0.20495657622814178
8466837,7190322,6232302,13683,11394,2007,9266,2001,2289,4417,1.0,0.0,5,2.0,3,1,378,56.0,0.48287656903266907,0.034159090369939804
8467238,6075719,4625348,13683,8930,2000,3988,1986,4753,9695,1.0,0.0,85,11.0,1,3,84,1617.0,0.458430677652359,0.16703929007053375
8464939,5970478,8038989,13683,8692,1999,13074,2011,4991,609,1.0,0.0,136,1.0,6,1,14,609.0,0.4381445646286011,0.15699800848960876
8465163,5751246,5738007,13683,8167,1998,8139,1998,5516,5544,0.0,0.0,157,6.0,6,7,0,1673.0,0.39626652002334595,0.19894379377365112
8465223,5941655,4453100,13683,8636,1999,3078,1984,5047,10605,0.5,0.0,9,4.0,20,2,56,1183.0,0.255462110042572,0.16420793533325195
8473756,6684330,5910906,13690,10253,2004,8559,1999,3437,5131,0.0,1.0,22,8.0,19,10,147,518.0,0.45239487290382385,0.12883423268795013
8472325,7583677,5908281,13690,12297,2009,8552,1999,1393,5138,0.5,0.0,1,2.0,10,13,1393,266.0,0.5361114740371704,0.3644143342971802
8473021,6773565,5196791,13690,10449,2004,6291,1993,3241,7399,0.0,0.0,89,17.0,3,9,7,609.0,0.2821618616580963,0.2789437174797058
8472326,6934249,4515936,13690,10827,2005,3414,1985,2863,10276,0.0,0.0,74,3.0,73,2,14,8344.0,0.43215346336364746,0.13056477904319763
8472326,7889660,7816587,13690,12829,2011,12710,2010,861,980,0.0,0.0,24,1.0,142,14,91,980.0,0.6966537237167358,0.12209152430295944
8472651,5287331,5008074,13690,6620,1994,5584,1991,7070,8106,1.0,0.0,35,8.0,3,4,49,1316.0,0.4530722200870514,0.1139974296092987
8470972,5770414,4377287,13690,8209,1998,2637,1983,5481,11053,0.0,0.0,33,9.0,2,1,14,5075.0,0.4678841829299927,0.12550760805606842
8472516,7742525,4755492,13690,12591,2010,4569,1988,1099,9121,1.0,0.0,4,5.0,25,4,301,434.0,0.21285417675971985,-0.016499744728207588
8473265,7020586,4244785,13690,11044,2006,1839,1981,2646,11851,1.0,0.0,22,1.0,3,3,63,11851.0,0.4223532974720001,0.17624656856060028
8476292,6818650,5498420,13697,10547,2004,7376,1996,3150,6321,1.0,0.5,83,17.0,37,2,21,63.0,0.5890284180641174,0.2955144941806793
8478442,4912643,4402221,13697,5199,1990,2805,1983,8498,10892,0.0,0.0,94,8.0,5,1,0,3703.0,0.399295449256897,0.13113455474376678
8479301,7515717,5251684,13697,12150,2009,6494,1993,1547,7203,1.0,0.0,9,4.0,9,4,63,2394.0,0.5273193120956421,0.05839505046606064
8479291,8136162,6831263,13697,13221,2012,10575,2004,476,3122,0.5,0.0,2,4.0,3,24,35,749.0,0.261675626039505,0.27345359325408936
8478019,6705470,4565036,13697,10302,2004,3673,1986,3395,10024,0.0,0.0,79,10.0,33,1,14,1008.0,0.41743096709251404,0.2755841016769409
8478138,6151150,5156037,13697,9091,2000,6137,1992,4606,7560,1.0,0.0,49,4.0,3,2,231,1722.0,0.41823863983154297,0.17174187302589417
8479207,6904483,4493919,13697,10750,2005,3302,1985,2947,10395,0.5,0.0,6,7.0,9,6,14,5446.0,0.6876484155654907,0.1778104603290558
8478791,6675161,6215749,13697,10232,2004,9231,2001,3465,4466,1.0,0.0,25,2.0,15,1,77,1281.0,0.446336567401886,0.15544834733009338
8476928,5355097,7959795,13697,6858,1994,12948,2011,6839,749,0.5,0.0,73,1.0,1,2,105,749.0,0.3501047194004059,0.17190292477607727
8475346,6585626,5222178,13697,10043,2003,6382,1993,3654,7315,1.0,0.0,21,8.0,3,4,175,2121.0,0.5406577587127686,0.264920711517334
8474628,6073138,6612235,13697,8923,2000,10106,2003,4774,3591,1.0,0.0,198,6.0,8,6,7,777.0,0.2173331081867218,0.20498166978359222
8479992,5821518,8063776,13704,8321,1998,13109,2011,5383,595,0.0,1.0,224,1.0,27,19,7,595.0,0.39033302664756775,0.26023051142692566
8479651,5877448,4746775,13704,8461,1999,4527,1988,5243,9177,0.5,0.0,18,2.0,4,4,511,126.0,0.4859081208705902,0.2539680302143097
8480696,6042538,4754005,13704,8853,2000,4562,1988,4851,9142,1.0,0.0,92,4.0,17,1,35,6790.0,0.2598569691181183,0.1077941358089447
8482939,5936480,6055645,13704,8622,1999,8881,2000,5082,4823,0.0,0.0,4,6.0,1,5,1358,441.0,0.2827528119087219,0.09918306022882462
8483879,5499320,3992703,13704,7376,1996,320,1976,6328,13384,0.25,0.0,20,6.0,13,1,196,3318.0,0.5689821243286133,0.21295295655727386
8482048,7988744,4644791,13704,12997,2011,4072,1987,707,9632,0.5,0.0,1,15.0,34,3,707,196.0,0.44344478845596313,0.2255074828863144
8483974,6294997,7086247,13704,9399,2001,11177,2006,4305,2527,0.0,0.0,146,7.0,13,19,14,63.0,0.3174872398376465,0.27142879366874695
8479542,7036243,5290826,13704,11079,2006,6634,1994,2625,7070,0.0,0.0,30,3.0,1,11,28,2394.0,0.4820473790168762,0.17744463682174683
8482417,7860666,5288094,13704,12780,2010,6627,1994,924,7077,0.0,0.0,1,17.0,258,1,924,7.0,0.4342910945415497,0.16656409204006195
8480852,5566724,6608587,13704,7600,1996,10092,2003,6104,3612,0.0,0.0,96,8.0,14,2,49,553.0,0.2134459912776947,0.09287069737911224
re44355,6409073,4737128,13704,9672,2002,4485,1988,4032,9219,0.0,0.0,29,28.0,26,8,182,182.0,0.46038228273391724,0.2396089732646942
8481227,7074841,7405186,13704,11149,2006,11898,2008,2555,1806,0.0,0.0,3,5.0,56,36,350,77.0,0.3979959487915039,0.27166223526000977
8481838,8079901,5392502,13704,13137,2011,6998,1995,567,6706,0.3333333333333333,0.0,7,14.0,8,8,21,119.0,0.5048683881759644,0.36716699600219727
8486052,6932983,6245588,13711,10827,2005,9294,2001,2884,4417,1.0,0.0,22,2.0,35,14,35,2961.0,0.3630782961845398,0.24518831074237823
8487315,6052162,4131795,13711,8874,2000,1090,1978,4837,12621,0.0,0.5,47,1.0,22,2,119,12621.0,0.29253262281417847,0.25262993574142456
8486387,5827313,4750141,13711,8335,1998,4541,1988,5376,9170,1.0,0.0,82,3.0,28,7,0,210.0,0.3557247817516327,0.12930214405059814
8488293,6396179,7172981,13711,9644,2002,11359,2007,4067,2352,0.0,0.5,4,7.0,14,11,693,14.0,0.46540725231170654,0.30251893401145935
8485192,5005571,4458952,13711,5577,1991,3113,1984,8134,10598,1.0,0.0,106,21.0,7,3,7,1148.0,0.4257708787918091,0.28312501311302185
8489176,6242745,5925628,13711,9287,2001,8601,1999,4424,5110,0.0,0.5,10,30.0,7,14,7,441.0,0.379997193813324,0.02472095750272274
8490005,6959223,7367844,13711,10890,2005,11814,2008,2821,1897,0.25,0.0,2,2.0,9,5,7,672.0,0.37301844358444214,0.08718236535787582
8486575,6306354,4596113,13711,9427,2001,3827,1986,4284,9884,0.0,0.0,3,5.0,2,2,3045,4781.0,0.41746923327445984,0.07334794849157333
8489218,7742177,5910637,13711,12591,2010,8559,1999,1120,5152,0.0,0.0,4,15.0,1,11,406,70.0,0.42945584654808044,0.24202537536621094
8485709,5504661,4420781,13711,7397,1996,2903,1983,6314,10808,0.0,0.0,18,6.0,16,3,112,1680.0,0.5090345144271851,0.3218323886394501
8490972,6588751,5300218,13718,10050,2003,6669,1994,3668,7049,1.0,0.0,101,8.0,40,10,7,238.0,0.6716712117195129,0.188874751329422
8493459,7634109,5181597,13718,12402,2009,6235,1993,1316,7483,0.5,0.0,12,12.0,233,3,175,154.0,0.4755546450614929,0.12071773409843445
8491876,5132047,4773362,13718,6046,1992,4653,1988,7672,9065,0.0,0.0,20,10.0,4,3,42,1162.0,0.6147052645683289,0.036263298243284225
8492431,6503884,5686786,13718,9868,2003,7985,1997,3850,5733,1.0,0.0,17,5.0,6,1,0,2506.0,0.5288018584251404,0.05780390277504921
8493081,6145918,3983450,13718,9084,2000,271,1976,4634,13447,0.0,0.0,7,4.0,12,1,504,4543.0,0.3973816931247711,0.3537910282611847
8490332,4399636,4296364,13718,2791,1983,2119,1981,10927,11599,1.0,0.0,7,20.0,4,1,420,1379.0,0.5241487622261047,0.12113616615533829
8490534,7237467,5069632,13718,11506,2007,5815,1991,2212,7903,1.0,0.0,18,18.0,7,3,14,490.0,0.4079235792160034,0.24136993288993835
8494008,7190970,7464739,13718,11394,2007,12038,2008,2324,1680,0.0,0.0,5,1.0,6,1,245,1680.0,0.4857918620109558,0.06337898224592209
8497339,5451637,5253277,13725,7201,1995,6494,1993,6524,7231,0.3333333333333333,0.0,17,2.0,20,3,1806,5215.0,0.33296674489974976,0.16379748284816742
8499279,6738901,6789521,13725,10365,2004,10484,2004,3360,3241,0.0,0.0,31,4.0,22,7,217,1218.0,0.295677125453949,0.16374139487743378
8498072,5987562,5631539,13725,8720,1999,7810,1997,5005,5915,0.0,0.0,32,2.0,12,16,0,4760.0,0.25611022114753723,0.05413426458835602
8495860,6293097,4609263,13725,9399,2001,3897,1986,4326,9828,1.0,0.0,23,3.0,16,2,189,3983.0,0.5648903846740723,0.03480967879295349
8496194,6179223,5380655,13725,9161,2001,6949,1995,4564,6776,1.0,0.0,16,2.0,36,1,0,4928.0,0.272043377161026,0.2626049220561981
8497777,4538616,5945958,13725,3533,1985,8643,1999,10192,5082,0.0,0.0,286,9.0,2,5,21,203.0,0.523373007774353,0.12012272328138351
8496601,7160678,5360008,13725,11331,2007,6879,1994,2394,6846,0.0,1.0,113,5.0,69,3,7,77.0,0.008257679641246796,0.25240573287010193
8504256,4727710,5014846,13732,4443,1988,5612,1991,9289,8120,0.0,0.0,17,8.0,2,4,42,483.0,0.4928211569786072,0.07103744149208069
8500740,7881768,6631599,13732,12815,2011,10148,2003,917,3584,1.0,0.0,35,7.0,321,12,28,105.0,0.5461967587471008,0.24353456497192383
8500636,6961285,4161269,13732,10897,2005,1293,1979,2835,12439,0.0,0.0,50,12.0,12,1,35,3836.0,0.39266300201416016,0.16167910397052765
8500019,7225537,4404630,13732,11478,2007,2812,1983,2254,10920,0.0,0.0,35,6.0,24,12,21,70.0,0.20353645086288452,0.4095442295074463
8505192,6713162,4367404,13739,10316,2004,2560,1983,3423,11179,0.0,1.0,43,2.0,9,2,7,1246.0,0.43072786927223206,0.15264621376991272
8509436,8378474,5168961,13739,13564,2013,6186,1992,175,7553,0.0,0.0,1,10.0,1,8,175,77.0,0.29851606488227844,0.14953452348709106
8505440,5134924,7432510,13739,6060,1992,11968,2008,7679,1771,0.0,0.0,47,2.0,1,2,133,448.0,0.32484421133995056,0.03734905272722244
8507009,5616346,6321111,13739,7761,1997,9455,2001,5978,4284,1.0,1.0,20,2.0,9,26,112,175.0,0.7978596687316895,0.19843512773513794
8505821,6606511,7604310,13739,10085,2003,12346,2009,3654,1393,0.0,0.0,297,1.0,23,4,14,1393.0,0.5597581267356873,0.2867352068424225
8508593,7817205,4220819,13739,12710,2010,1706,1980,1029,12033,1.0,0.0,3,62.0,3,3,35,49.0,0.5308295488357544,0.05607003718614578
8506822,4226714,5155722,13739,1741,1980,6130,1992,11998,7609,0.5,0.0,41,32.0,2,1,273,49.0,0.27757999300956726,0.24466091394424438
8506096,5327288,4493690,13739,6760,1994,3302,1985,6979,10437,1.0,0.0,142,10.0,7,3,7,1099.0,0.4062516391277313,0.2449130117893219
8505320,7201441,4232726,13739,11422,2007,1776,1980,2317,11963,0.0,0.0,28,13.0,171,1,63,581.0,0.546157956123352,0.1588650345802307
8507243,5776757,4597009,13739,8223,1998,3827,1986,5516,9912,0.5,0.0,43,16.0,3,2,28,259.0,0.22454765439033508,0.03423001244664192
8505486,6645597,5414779,13739,10176,2003,7068,1995,3563,6671,0.0,0.0,1,21.0,7,12,3563,560.0,0.41915106773376465,0.15573132038116455
8515387,6925160,4298175,13746,10806,2005,2133,1981,2940,11613,0.3333333333333333,0.0,33,9.0,9,1,105,1652.0,0.6436229348182678,0.23277465999126434
8512435,5089119,8044061,13746,5892,1992,13081,2011,7854,665,1.0,0.0,22,3.0,4,3,70,161.0,0.3715021014213562,0.07952780276536942
8515354,7720507,4523857,13746,12556,2010,3456,1985,1190,10290,1.0,0.0,3,2.0,6,4,392,1582.0,0.8241615295410156,0.41113510727882385
8516552,7058968,5157935,13746,11114,2006,6144,1992,2632,7602,0.5,0.0,62,7.0,2,3,49,84.0,0.32772794365882874,0.26513051986694336
8512422,6982865,4048634,13746,10960,2006,621,1977,2786,13125,1.0,0.0,4,5.0,5,1,1414,5558.0,0.41190028190612793,0.15477554500102997
8513053,6890783,4493749,13746,10722,2005,3302,1985,3024,10444,1.0,0.0,8,2.0,21,3,14,630.0,0.4936058819293976,0.12154804170131683
8515825,5600778,4784293,13746,7705,1997,4702,1988,6041,9044,1.0,0.0,95,10.0,13,5,77,1582.0,0.3139915466308594,0.19673870503902435
8513953,8063506,5715073,13746,13109,2011,8069,1998,637,5677,0.0,0.0,1,11.0,9,13,637,7.0,0.48798125982284546,0.14239847660064697
8512243,5665222,4720464,13746,7922,1997,4401,1988,5824,9345,0.0,0.0,207,5.0,3,2,0,6146.0,0.291368305683136,0.256408154964447
8515014,7388906,5097081,13746,11856,2008,5920,1992,1890,7826,1.0,0.0,3,5.0,55,2,231,5971.0,0.4465347230434418,0.08489242941141129
8517998,6601823,4404200,13753,10078,2003,2812,1983,3675,10941,0.0,1.0,4,11.0,12,1,1477,3934.0,0.46620628237724304,0.22220255434513092
8521561,7743054,6336112,13753,12591,2010,9497,2002,1162,4256,1.0,1.0,2,28.0,2,6,35,140.0,0.43373969197273254,0.4168694317340851
8519439,7005685,7318002,13753,11016,2006,11695,2008,2737,2058,1.0,0.0,3,1.0,31,4,343,2058.0,0.5636329054832458,0.10017358511686325
8521737,7930292,7991262,13753,12892,2011,12997,2011,861,756,1.0,0.0,21,1.0,8,1,14,756.0,0.3366081714630127,0.3437149226665497
8519263,4375104,5293430,13753,2609,1983,6641,1994,11144,7112,0.0,0.0,6,23.0,4,14,203,7.0,0.38347041606903076,0.0631028488278389
8518578,4865933,4387598,13753,5003,1989,2721,1983,8750,11032,0.3333333333333333,0.0,29,6.0,3,1,98,42.0,0.39479610323905945,0.12251845747232437
8517106,4774975,4498169,13753,4660,1988,3323,1985,9093,10430,0.0,0.0,12,23.0,11,3,0,588.0,0.3793904781341553,0.22351402044296265
8518210,6759098,7136120,13753,10414,2004,11275,2006,3339,2478,0.25,0.0,32,1.0,37,3,7,2478.0,0.07353343069553375,0.21616727113723755
8519466,6406772,4497397,13753,9665,2002,3323,1985,4088,10430,0.0,0.0,24,22.0,3,1,70,2961.0,0.29106858372688293,0.151374951004982
8522265,5796718,5710619,13753,8265,1998,8055,1998,5488,5698,0.5,0.0,36,17.0,5,3,112,413.0,0.42992180585861206,0.07375240325927734
8519379,7052927,5204954,13753,11107,2006,6319,1993,2646,7434,1.0,0.0,11,14.0,7,7,7,1092.0,0.42546969652175903,0.1119329035282135
8517255,6898283,6642678,13753,10736,2005,10169,2003,3017,3584,0.0,0.0,50,4.0,7,8,14,567.0,0.42602160573005676,0.17106470465660095
8524959,5961786,4023787,13760,8678,1999,502,1977,5082,13258,0.0,0.0,28,7.0,20,1,7,6384.0,0.4396880269050598,0.14316435158252716
8523063,6058482,4930978,13760,8888,2000,5269,1990,4872,8491,0.0,0.0,86,22.0,5,10,14,7.0,0.1992870569229126,0.20829012989997864
8525402,5528720,5841276,13760,7474,1996,8363,1998,6286,5397,0.0,0.0,82,7.0,115,4,84,1463.0,0.5804722309112549,0.13675886392593384
8526412,6947408,4877056,13760,10855,2005,5052,1989,2905,8708,0.5,0.0,22,3.0,7,5,21,3710.0,0.4889616370201111,0.15967559814453125
8526602,8189770,6956036,13760,13298,2012,10883,2005,462,2877,1.0,0.0,1,7.0,3,13,462,91.0,0.6872067451477051,0.1253526210784912
8523881,7431692,7272925,13760,11968,2008,11590,2007,1792,2170,1.0,0.0,11,3.0,10,6,28,497.0,0.4183513820171356,-0.07272779941558838
8523898,7678111,7430862,13760,12493,2010,11968,2008,1267,1792,1.0,0.0,10,2.0,627,39,91,56.0,0.4422578811645508,0.3188779950141907
8524948,5530021,7899633,13760,7481,1996,12843,2011,6279,917,0.3333333333333333,0.0,8,1.0,3,13,392,917.0,0.10123514384031296,0.11766639351844788
8527038,7542878,4264072,13760,12206,2009,1944,1981,1554,11816,0.0,0.0,36,4.0,4,6,14,175.0,0.5996097326278687,0.36991414427757263
8525327,7633146,4552327,13760,12402,2009,3603,1985,1358,10157,1.0,0.0,15,16.0,16,6,14,448.0,0.4229913651943207,0.24746344983577728
8524185,re39041,7824238,13760,11044,2006,12724,2010,2716,1036,0.5,0.0,2,1.0,1,22,455,1036.0,0.6769825220108032,0.11785974353551865
8526496,5301019,7275034,13760,6669,1994,11590,2007,7091,2170,0.5,0.0,100,3.0,3,10,28,630.0,0.7410311698913574,0.18433868885040283
8524268,6835277,6340266,13760,10589,2004,9518,2002,3171,4242,0.0,0.0,5,5.0,5,7,7,623.0,0.240687757730484,0.08692974597215652
8525173,7656491,4301434,13760,12451,2010,2147,1981,1309,11613,0.0,1.0,15,11.0,227,4,84,231.0,0.6102464199066162,0.20649710297584534
8532628,5703567,4576173,13767,8034,1997,3729,1986,5733,10038,0.0,0.0,8,28.0,7,1,1764,672.0,0.3895968198776245,0.2601603865623474
8531038,6140197,4983814,13767,9070,2000,5486,1991,4697,8281,1.0,0.0,27,20.0,8,3,56,168.0,0.47394728660583496,0.23147128522396088
8530632,6123965,5907912,13767,9035,2000,8552,1999,4732,5215,0.0,0.0,144,5.0,19,6,7,1134.0,0.4346344769001007,0.15986965596675873
8531073,7462965,4182544,13767,12031,2008,1468,1980,1736,12299,1.0,0.0,6,13.0,14,2,77,3871.0,0.45030397176742554,0.15432459115982056
8529800,6656635,7213819,13767,10197,2003,11450,2007,3570,2317,0.5,0.0,20,4.0,1,13,126,609.0,0.43134647607803345,0.1594456285238266
re44492,6728517,4254561,13767,10344,2004,1895,1981,3423,11872,1.0,0.0,99,6.0,16,1,56,1078.0,0.46964409947395325,0.17562821507453918
8532803,5668885,7171910,13767,7929,1997,11359,2007,5838,2408,0.0,0.0,17,2.0,4,24,28,161.0,0.7172735333442688,0.0958157405257225
8532751,6699194,7446489,13767,10288,2004,11996,2008,3479,1771,1.0,0.0,307,2.0,51,3,0,1568.0,0.40810275077819824,0.2323470413684845
8529458,6776764,7184173,13767,10456,2004,11380,2007,3311,2387,1.0,0.0,11,1.0,12,15,140,2387.0,0.5468939542770386,0.21675588190555573
8529618,6706062,6338880,13767,10302,2004,9511,2002,3465,4256,1.0,0.0,114,12.0,168,2,7,651.0,0.3793793320655823,0.08298645168542862
8528640,7926565,6314087,13767,12892,2011,9441,2001,875,4326,1.0,0.0,2,3.0,13,16,217,1001.0,0.41231057047843933,0.1605110913515091
8529116,6454452,5283720,13767,9763,2002,6606,1994,4004,7161,0.5,1.0,74,5.0,11,4,7,140.0,0.6302387714385986,0.4474985897541046
8529532,6071267,6296605,13767,8923,2000,9406,2001,4844,4361,1.0,1.0,296,2.0,56,3,0,1876.0,0.40590277314186096,0.3387649357318878
8529814,6127433,4020762,13767,9042,2000,488,1977,4725,13279,0.0,0.0,2,40.0,22,1,588,2947.0,0.4607293903827667,0.14543117582798004
8535138,6450887,6174365,13774,9756,2002,9147,2001,4018,4627,1.0,0.0,132,12.0,10,3,28,63.0,0.535340428352356,0.1636149138212204
8533889,6779851,4037550,13774,10463,2004,572,1977,3311,13202,1.0,0.0,35,26.0,4,1,7,35.0,0.3444523215293884,0.22526560723781586
8536391,7226886,8022171,13774,11478,2007,13046,2011,2296,728,0.0,0.0,40,1.0,39,4,14,728.0,0.5300785303115845,0.2867530584335327
8534566,5896403,5554471,13774,8510,1999,7558,1996,5264,6216,0.0,0.0,118,14.0,7,7,28,1246.0,0.3082849383354187,0.14228883385658264
8538777,6351735,4419675,13774,9553,2002,2896,1983,4221,10878,1.0,0.0,95,9.0,122,3,7,420.0,0.399397075176239,0.15643124282360077
8538345,7184938,4093936,13774,11380,2007,887,1978,2394,12887,0.0,0.0,41,6.0,1,1,14,4130.0,0.1394307017326355,0.40133950114250183
8534328,5301723,5442230,13774,6676,1994,7166,1995,7098,6608,0.5,0.0,28,16.0,5,2,707,1183.0,0.3613215386867523,0.2815215587615967
8538843,6779016,6851555,13774,10456,2004,10631,2005,3318,3143,1.0,0.0,121,2.0,22,12,7,1526.0,0.35282641649246216,0.2952303886413574
8543720,6937770,4646294,13781,10834,2005,4072,1987,2947,9709,1.0,0.0,37,12.0,34,15,21,5705.0,0.3970523178577423,0.3270695209503174
8541749,7781747,4317026,13781,12654,2010,2245,1982,1127,11536,0.0,0.0,7,7.0,3,4,14,4550.0,0.5721805095672607,0.19083470106124878
8539937,4257383,5089364,13781,1909,1981,5892,1992,11872,7889,0.5,0.0,5,11.0,1,10,224,1477.0,0.4069611132144928,0.31954535841941833
8543503,6363364,4337937,13781,9581,2002,2378,1982,4200,11403,0.5,0.0,45,5.0,22,1,42,6888.0,0.30667051672935486,0.044332511723041534
8541633,5206434,4067769,13781,6326,1993,740,1978,7455,13041,1.0,0.0,10,3.0,1,1,105,4452.0,0.5479342937469482,0.16028091311454773
8543157,6385465,5092524,13781,9623,2002,5906,1992,4158,7875,1.0,0.0,69,10.0,2,7,7,224.0,0.4434184730052948,0.04458432272076607
8540765,6221997,7444294,13781,9245,2001,11989,2008,4536,1792,0.0,0.0,13,2.0,99,5,14,196.0,0.3038460314273834,0.17063307762145996
8543184,6325978,4091787,13781,9469,2001,880,1978,4312,12901,0.0,0.0,168,12.0,73,1,14,6489.0,0.32615768909454346,-0.022573594003915787
8542738,5812194,6248818,13781,8300,1998,9301,2001,5481,4480,0.5,0.0,38,10.0,5,5,21,273.0,0.6735683083534241,0.06114339455962181
8540545,7481692,5030697,13781,12080,2009,5668,1991,1701,8113,1.0,0.0,3,43.0,4,1,182,595.0,0.5271719098091125,0.0999593734741211
8547248,6673474,7185915,13788,10232,2004,11387,2007,3556,2401,0.0,0.0,21,6.0,7,21,0,861.0,0.17556138336658478,0.05384733900427818
8545547,6685736,7452733,13788,10260,2004,12010,2008,3528,1778,1.0,0.0,46,3.0,149,2,7,140.0,0.44841712713241577,0.08584615588188171
8547677,6327134,5729253,13788,9469,2001,8111,1998,4319,5677,0.0,0.0,77,9.0,30,7,581,434.0,0.24042312800884247,0.024407420307397842
8546996,6110127,4379186,13788,9007,2000,2651,1983,4781,11137,0.5,0.0,64,4.0,10,1,21,2695.0,0.4164518415927887,0.07224149256944656
8544614,6386335,5422991,13788,9630,2002,7096,1995,4158,6692,1.0,0.0,4,12.0,7,13,7,2317.0,0.48550042510032654,0.17773106694221497
8548551,4753652,4103333,13788,4562,1988,936,1978,9226,12852,1.0,0.0,183,7.0,7,5,7,777.0,0.18899734318256378,0.17322659492492676
8544285,5467921,5493518,13788,7264,1995,7355,1996,6524,6433,0.0,0.0,14,17.0,3,20,21,28.0,0.4540063142776489,0.29675978422164917
8549131,6628764,6895924,13788,10134,2003,10736,2005,3654,3052,0.0,0.0,104,3.0,42,21,14,497.0,0.5983613133430481,0.19715817272663116
8545309,6645077,7051246,13788,10176,2003,11100,2006,3612,2688,1.0,0.0,270,7.0,35,4,7,546.0,0.36328908801078796,0.12404182553291321
8549440,6685565,7072292,13788,10260,2004,11142,2006,3528,2646,0.0,0.0,22,2.0,1,7,0,1834.0,0.3217121958732605,0.18914903700351715
8547872,8320949,6435514,13788,13480,2012,9728,2002,308,4060,0.0,0.0,4,11.0,49,3,28,119.0,0.30421707034111023,0.22972477972507477
8548576,4596255,4431952,13788,3827,1986,2966,1984,9961,10822,1.0,0.0,97,2.0,4,1,42,371.0,0.5197045803070068,0.07474089413881302
8550624,7988291,5503670,13795,12997,2011,7397,1996,798,6398,1.0,0.0,5,5.0,147,6,7,1225.0,0.47477132081985474,-0.0037113602738827467
8552999,6958749,4539821,13795,10890,2005,3540,1985,2905,10255,0.0,0.0,45,19.0,10,3,14,3535.0,0.5992719531059265,0.23535285890102386
8555116,7340641,6260976,13795,11751,2008,9329,2001,2044,4466,1.0,0.0,5,9.0,9,3,273,21.0,0.567379355430603,0.1598375290632248
8550082,5355893,4368828,13795,6865,1994,2574,1983,6930,11221,0.0,0.0,78,25.0,16,6,0,917.0,0.3286777436733246,0.19422174990177155
8551724,4375514,6331164,13795,2616,1983,9483,2001,11179,4312,1.0,0.0,25,9.0,2,9,14,28.0,0.3311944901943207,0.1071794182062149
8552999,8291344,4198680,13795,13438,2012,1566,1980,357,12229,1.0,0.5,1,9.0,12,5,357,6608.0,0.5821515917778015,0.3213823735713959
8550322,7059509,6539297,13795,11121,2006,9945,2003,2674,3850,0.0,0.0,21,2.0,54,1,84,196.0,0.49794527888298035,0.09825053811073303
8554322,5527348,5441811,13795,7474,1996,7166,1995,6321,6629,1.0,0.0,52,7.0,3,5,14,497.0,0.4346308410167694,0.2239375114440918
8554673,6016484,4307516,13795,8783,2000,2189,1981,5012,11606,1.0,0.0,261,13.0,50,1,7,3395.0,0.5442385673522949,0.32016098499298096
8550880,8138445,6671240,13795,13228,2012,10225,2003,567,3570,0.0,0.0,1,2.0,4,2,567,3122.0,0.3951933979988098,0.24465881288051605
8554010,8050512,4342844,13795,13088,2011,2406,1982,707,11389,1.0,0.0,1,10.0,232,3,707,1925.0,0.5254417657852173,0.33673712611198425
8555116,7562285,5649045,13795,12248,2009,7866,1997,1547,5929,0.5,0.0,7,22.0,31,18,273,1316.0,0.537381649017334,0.12105880677700043
8554569,5079547,7614475,13795,5850,1992,12367,2009,7945,1428,0.0,0.0,35,1.0,5,13,168,1428.0,0.508086621761322,0.04527562856674194
8554774,8005863,7825150,13795,13018,2011,12724,2010,777,1071,1.0,0.0,14,2.0,98,22,7,637.0,0.2761770784854889,0.09392857551574707
8559694,6554185,5121183,13802,9980,2003,6004,1992,3822,7798,0.5,0.0,52,14.0,10,2,14,49.0,0.5356773734092712,0.1627599596977234
8556978,6663647,4230356,13802,10211,2003,1762,1980,3591,12040,1.0,0.0,62,8.0,63,1,0,266.0,0.23460347950458527,0.16131505370140076
8561061,7500244,4732818,13802,12115,2009,4464,1988,1687,9338,1.0,0.0,2,2.0,7,17,105,7.0,0.5499956011772156,0.007524852175265551
8556936,5562735,6881217,13802,7586,1996,10701,2005,6216,3101,1.0,1.0,113,1.0,2,6,21,3101.0,0.3247930705547333,0.27560722827911377
8557430,7485392,4523857,13802,12087,2009,3456,1985,1715,10346,1.0,0.0,2,2.0,3,4,84,1638.0,0.8152380585670471,0.22002924978733063
8556890,6261285,4854213,13802,9329,2001,4968,1989,4473,8834,1.0,0.0,59,8.0,5,3,42,714.0,0.44170448184013367,0.22764648497104645
8555682,6044669,4311575,13802,8860,2000,2210,1982,4942,11592,1.0,0.0,31,3.0,8,1,28,35.0,0.42124778032302856,0.09213315695524216
8556723,5192854,5148255,13802,6277,1993,6102,1992,7525,7700,0.0,0.0,191,29.0,9,1,14,231.0,0.23177950084209442,0.2016000747680664
8560038,4425920,4583117,13802,2938,1984,3757,1986,10864,10045,1.0,0.0,162,17.0,1,6,14,21.0,0.5183560848236084,0.33067288994789124
8557286,5240400,4956775,13802,6452,1993,5367,1990,7350,8435,0.0,0.0,17,23.0,5,7,441,28.0,0.46987855434417725,0.051295116543769836
8557730,7256049,4395640,13802,11548,2007,2763,1983,2254,11039,0.0,0.0,6,12.0,19,4,105,1904.0,0.21999652683734894,0.18629033863544464
8560621,6662340,4460096,13802,10204,2003,3120,1984,3598,10682,1.0,0.0,81,32.0,22,1,56,7.0,0.4883163571357727,0.13450026512145996
8556984,5080677,5109449,13802,5857,1992,5962,1992,7945,7840,1.0,0.0,30,17.0,15,7,98,1533.0,0.8108659982681274,0.13616017997264862
8556592,6431834,3984364,13802,9721,2002,278,1976,4081,13524,1.0,0.0,4,4.0,11,1,861,6251.0,0.5747870802879333,0.11832829564809799
8556440,7736010,4466502,13802,12584,2010,3155,1984,1218,10647,0.5,0.0,5,13.0,3,1,42,7602.0,0.5989671945571899,0.15926262736320496
8556723,6850643,6345951,13802,10624,2005,9539,2002,3178,4263,0.0,0.0,32,7.0,10,8,56,1134.0,0.25414684414863586,0.24972915649414062
8560568,5317729,7091261,13802,6725,1994,11184,2006,7077,2618,1.0,0.0,76,1.0,9,7,343,2618.0,0.3311455249786377,0.13276103138923645
8561175,7543056,4697089,13802,12206,2009,4289,1987,1596,9513,1.0,0.0,20,16.0,4,3,0,280.0,0.4391871988773346,0.04779685288667679
8566767,7543283,4999527,13809,12206,2009,5549,1991,1603,8260,1.0,0.0,6,5.0,14,3,70,4137.0,0.4527035355567932,0.22756412625312805
8564073,5308682,4117989,13809,6697,1994,1006,1978,7112,12803,0.0,0.0,79,3.0,2,1,7,4004.0,0.3489588797092438,0.30609971284866333
8562683,6261293,7877079,13809,9329,2001,12808,2011,4480,1001,1.0,0.0,67,1.0,1,7,14,1001.0,0.4650287628173828,0.13772618770599365
8565274,6580532,4103333,13809,10029,2003,936,1978,3780,12873,0.0,0.0,98,7.0,16,5,0,798.0,0.4178895056247711,0.02791469916701317
8565018,8203876,6748211,13809,13319,2012,10386,2004,490,3423,1.0,0.0,1,17.0,1,20,490,7.0,0.9106305837631226,0.2570745348930359
8561669,4669526,4685908,13809,4170,1987,4240,1987,9639,9569,1.0,0.0,7,11.0,4,1,3164,140.0,0.5829674601554871,0.22341129183769226
8562803,5007989,8167912,13809,5584,1991,13270,2012,8225,539,0.0,0.0,11,1.0,15,26,364,539.0,0.26927050948143005,0.17332765460014343
8564315,7239156,4716927,13809,11506,2007,4387,1988,2303,9422,1.0,0.0,2,2.0,34,5,581,4935.0,0.6261861324310303,0.18897762894630432
8565880,5007864,5536395,13809,5584,1991,7502,1996,8225,6307,0.0,0.0,45,15.0,5,69,28,77.0,0.2782144546508789,0.13579963147640228
8561213,7150217,6923237,13809,11310,2006,10806,2005,2499,3003,0.5,0.0,8,1.0,13,14,35,3003.0,0.5046207308769226,0.20796407759189606
8568428,5312436,4821171,13816,6711,1994,4849,1989,7105,8967,1.0,0.0,49,11.0,6,11,49,630.0,0.6782602667808533,0.16392278671264648
8571023,6731644,5814194,13816,10351,2004,8307,1998,3465,5509,1.0,0.0,36,7.0,16,4,7,49.0,0.3304045498371124,0.19348859786987305
8569717,6792078,4210411,13816,10484,2004,1643,1980,3332,12173,0.0,0.0,47,6.0,3,2,56,5488.0,0.4092346429824829,0.12794387340545654
8571617,7438683,5045186,13816,11982,2008,5724,1991,1834,8092,1.0,0.0,77,7.0,109,9,0,693.0,0.37236934900283813,0.23086555302143097
8570373,5541773,4012351,13816,7516,1996,439,1977,6300,13377,0.0,0.0,18,9.0,7,3,35,5222.0,0.11232781410217285,0.08447617292404175
8572197,7882542,4060369,13816,12815,2011,698,1977,1001,13118,0.5,0.0,4,2.0,17,1,14,10171.0,0.516904890537262,0.1407557725906372
8568172,5947771,4381349,13816,8650,1999,2672,1983,5166,11144,1.0,0.0,14,10.0,7,2,210,350.0,0.42111366987228394,0.20267809927463531
8571793,7526492,4065924,13816,12171,2009,733,1978,1645,13083,0.0,0.0,4,12.0,17,1,42,119.0,0.7539681792259216,0.14392969012260437
8569128,8188542,8131462,13816,13298,2012,13214,2012,518,602,1.0,0.0,7,2.0,3,6,7,308.0,0.4668814539909363,0.2702183723449707
8569841,5908827,4363326,13816,8552,1999,2539,1982,5264,11277,0.0,0.0,104,27.0,1,2,7,154.0,-0.07041393965482712,0.24598070979118347
8567503,4595512,4413058,13816,3820,1986,2861,1983,9996,10955,1.0,0.0,13,17.0,1,1,4228,287.0,0.4916505813598633,0.2079150378704071
8568405,5057105,7256678,13816,5766,1991,11548,2007,8050,2268,1.0,0.0,224,4.0,9,22,105,14.0,0.2515593469142914,0.23341432213783264
8569885,7391112,5279752,13816,11863,2008,6592,1994,1953,7224,1.0,0.0,13,14.0,1,8,21,2709.0,0.3728600740432739,0.26432186365127563
8576077,5402104,4862430,13823,7026,1995,4989,1989,6797,8834,0.5,0.0,54,2.0,2,2,112,8477.0,0.4935116767883301,0.1382373720407486
8577436,5776059,8282355,13823,8223,1998,13431,2012,5600,392,1.0,0.0,99,1.0,7,2,0,392.0,0.49459463357925415,0.1365814507007599
8573162,5199384,7141316,13823,6305,1993,11289,2006,7518,2534,1.0,0.0,12,5.0,4,6,1092,112.0,0.6097908020019531,0.11985409259796143
8577549,7586566,5464038,13823,12304,2009,7250,1995,1519,6573,0.0,0.0,68,12.0,14,8,21,3381.0,0.3556091785430908,0.19266515970230103
8577667,6223059,4217722,13823,9245,2001,1692,1980,4578,12131,0.25,0.0,120,18.0,2,3,0,210.0,0.5117978453636169,0.20209883153438568
8579569,5146668,7426116,13830,6102,1992,11947,2008,7728,1883,0.3333333333333333,0.0,26,4.0,3,3,84,189.0,0.40226152539253235,0.4518773555755615
8583594,6366986,4287521,13830,9588,2002,2070,1981,4242,11760,1.0,0.0,75,9.0,18,2,14,4368.0,0.36563822627067566,0.20331017673015594
8581735,6003008,4635913,13830,8748,1999,4030,1987,5082,9800,0.0,0.0,95,9.0,43,1,21,2226.0,0.4111035466194153,0.2356894165277481
8580233,5227168,4783958,13830,6403,1993,4702,1988,7427,9128,1.0,0.0,55,9.0,4,6,0,1960.0,0.36874839663505554,0.20423659682273865
8579920,4471780,7706034,13830,3183,1984,12535,2010,10647,1295,1.0,0.0,48,2.0,6,3,14,532.0,0.5436680316925049,0.1280132234096527
8584150,5883623,5480080,13830,8475,1999,7306,1996,5355,6524,1.0,0.0,116,7.0,5,1,7,546.0,0.6114663481712341,0.12152067571878433
8581721,5050881,6348637,13830,5745,1991,9546,2002,8085,4284,0.0,0.0,55,4.0,6,15,91,1162.0,0.2942725718021393,0.01090282667428255
8583593,7277900,4323571,13830,11597,2007,2287,1982,2233,11543,1.0,0.0,27,4.0,66,3,154,9268.0,0.3415270447731018,0.061853229999542236
8578801,7124659,5391420,13830,11254,2006,6991,1995,2576,6839,1.0,0.0,5,46.0,13,22,7,217.0,0.5457531213760376,0.09338017553091049
8580559,6043080,4494865,13830,8853,2000,3309,1985,4977,10521,1.0,0.0,235,17.0,29,3,35,4816.0,0.6139320731163025,0.2089477926492691
8579658,6027373,4807636,13830,8818,2000,4807,1989,5012,9023,1.0,0.0,23,17.0,1,12,140,1162.0,0.3980785608291626,0.1622224897146225
8580988,6312826,4892766,13830,9441,2001,5122,1990,4389,8708,0.0,0.0,6,11.0,3,4,259,378.0,0.33738988637924194,0.028343617916107178
8579702,4679143,5823386,13830,4205,1987,8328,1998,9625,5502,0.3333333333333333,0.0,171,11.0,4,5,21,245.0,0.3927561640739441,0.3191848397254944
8579888,6130671,5859797,13830,9049,2000,8412,1999,4781,5418,0.0,0.0,29,10.0,5,4,7,189.0,0.1560075581073761,0.14824660122394562
8580313,6551617,4991116,13830,9973,2003,5514,1991,3857,8316,0.5,0.0,16,3.0,23,6,112,2961.0,0.6548871397972107,0.15928500890731812
8583016,5790153,6915778,13830,8251,1998,10785,2005,5579,3045,0.0,0.0,3,1.0,3,11,1967,3045.0,0.3234907388687134,-0.032294489443302155
8582325,6639814,4375810,13830,10162,2003,2623,1983,3668,11207,1.0,0.0,12,16.0,3,1,168,91.0,0.6635294556617737,0.1072034165263176
8587280,5444608,4272022,13837,7173,1995,1986,1981,6664,11851,0.0,0.0,24,17.0,4,2,7,203.0,0.23746773600578308,0.13937291502952576
8584940,6112189,6213394,13837,9007,2000,9231,2001,4830,4606,1.0,1.0,190,19.0,47,2,7,168.0,0.4226430058479309,0.4418189227581024
8589300,7571141,7141103,13837,12269,2009,11289,2006,1568,2548,1.0,0.0,3,2.0,64,32,497,343.0,0.5321778059005737,0.14601702988147736
8587915,5625166,4784262,13837,7789,1997,4702,1988,6048,9135,0.0,0.0,15,4.0,3,3,49,469.0,0.34940236806869507,0.3609883785247803
8585482,5910046,6916869,13837,8559,1999,10785,2005,5278,3052,0.5,0.0,85,2.0,4,4,14,1372.0,0.4439101219177246,0.12836498022079468
8585280,5698299,4659320,13837,8020,1997,4128,1987,5817,9709,0.0,0.0,23,10.0,4,3,84,7.0,0.3619637191295624,0.1385243833065033
8585739,6007487,8100012,13837,8762,1999,13172,2012,5075,665,1.0,0.0,139,1.0,56,45,7,665.0,0.31798505783081055,0.20148813724517822
8585717,5665097,6842916,13837,7922,1997,10610,2005,5915,3227,1.0,0.0,32,3.0,6,16,7,238.0,0.718054473400116,0.5059199929237366
8589466,4383322,4737368,13837,2686,1983,4485,1988,11151,9352,0.0,0.0,39,12.0,7,6,0,2485.0,0.5031562447547913,0.14069338142871857
8587720,4424532,6124607,13837,2924,1984,9035,2000,10913,4802,1.0,0.0,91,12.0,3,16,7,1428.0,0.4796110689640045,0.1275804489850998
8595096,5832140,4156665,13844,8342,1998,1244,1979,5502,12600,1.0,0.0,30,5.0,11,4,0,4130.0,0.3777892291545868,0.17253267765045166
8594806,6496733,5251470,13844,9847,2002,6494,1993,3997,7350,1.0,0.0,8,6.0,27,4,49,1729.0,0.36961477994918823,0.10669748485088348
8590197,8117954,7749617,13844,13200,2012,12605,2010,644,1239,0.5,0.0,1,1.0,5,18,644,1239.0,0.5081380605697632,0.101640984416008
8590376,4269624,4677407,13844,1972,1981,4198,1987,11872,9646,0.0,0.0,22,11.0,2,3,56,7245.0,0.03387422114610672,0.15430307388305664
8591506,7972331,4396387,13844,12969,2011,2770,1983,875,11074,1.0,0.0,5,2.0,5,2,28,10199.0,0.640337347984314,0.06038101017475128
8591560,7621940,4723215,13844,12381,2009,4415,1988,1463,9429,1.0,0.0,27,11.0,13,6,0,245.0,0.5265055894851685,0.14536191523075104
8592053,8288012,4693840,13844,13438,2012,4275,1987,406,9569,0.5,0.0,1,18.0,8,9,406,42.0,0.8798373937606812,0.07550452649593353
8592036,4733665,6555944,13844,4471,1988,9980,2003,9373,3864,0.0,0.0,2035,10.0,19,5,0,385.0,0.3018827438354492,0.009514974430203438
8593971,7406630,4157325,13844,11898,2008,1251,1979,1946,12593,0.0,0.0,8,18.0,21,5,56,133.0,0.5042750835418701,0.12612015008926392
8595394,6418496,5282548,13844,9686,2002,6606,1994,4158,7238,1.0,0.0,21,10.0,7,2,273,686.0,0.36714959144592285,0.1937899887561798
8591314,4815741,7127851,13844,4835,1989,11261,2006,9009,2583,1.0,0.0,359,4.0,12,7,14,1225.0,0.4499052166938782,0.10252279788255692
8595468,7373481,5210366,13844,11821,2008,6340,1993,2023,7504,1.0,0.0,4,35.0,4,11,560,91.0,0.3912527859210968,0.18634046614170074
8598524,6176023,4379535,13851,9154,2001,2658,1983,4697,11193,0.0,0.0,21,4.0,25,2,399,35.0,0.2706608772277832,0.2496805340051651
8599089,6686886,5628818,13851,10260,2004,7803,1997,3591,6048,1.0,0.0,24,9.0,7,3,252,1519.0,0.5153356790542603,0.2997230887413025
8596813,6995681,7665376,13851,10995,2006,12472,2010,2856,1379,0.0,0.0,28,3.0,220,30,49,21.0,0.4416354298591614,0.1155087873339653
8600830,6061794,5183856,13851,8895,2000,6242,1993,4956,7609,1.0,0.0,232,7.0,24,3,7,784.0,0.24163396656513214,0.19420789182186127
8599111,7379044,4586370,13851,11835,2008,3778,1986,2016,10073,1.0,0.0,4,10.0,9,1,98,2961.0,0.6708431243896484,0.2712096869945526
8599850,6154446,5497166,13851,9098,2000,7369,1996,4753,6482,1.0,0.0,91,12.0,7,1,7,987.0,0.3148617148399353,0.07334177941083908
8596491,6641854,5167405,13851,10169,2003,6179,1992,3682,7672,0.5,0.0,8,14.0,17,4,7,49.0,0.5566719174385071,0.10759218782186508
8597186,7373196,4776796,13851,11821,2008,4667,1988,2030,9184,1.0,0.0,25,14.0,10,1,21,56.0,0.25483086705207825,0.19906865060329437
8600681,7591801,7543649,13851,12318,2009,12213,2009,1533,1638,0.5,0.0,243,4.0,171,31,0,77.0,0.5241174697875977,0.29817309975624084
8600467,6045509,4929405,13851,8860,2000,5262,1990,4991,8589,1.0,0.0,202,3.0,8,6,14,1162.0,0.39715370535850525,0.29847386479377747
8600559,7317970,6440395,13851,11695,2008,9735,2002,2156,4116,1.0,0.0,21,3.0,3,12,0,420.0,0.5328296422958374,0.11949111521244049
8597358,6540748,6259267,13851,9952,2003,9322,2001,3899,4529,1.0,0.0,167,7.0,18,5,21,1729.0,0.3139212727546692,-0.05582441762089729
8597297,5722421,4394372,13851,8097,1998,2756,1983,5754,11095,1.0,1.0,169,50.0,2,7,0,14.0,0.39838707447052,0.26846450567245483
8597575,5531878,6965707,13851,7488,1996,10911,2005,6363,2940,0.5,0.0,406,4.0,2,34,0,945.0,0.4487098753452301,0.08783503621816635
8603824,5968773,4363326,13858,8692,1999,2539,1982,5166,11319,1.0,0.0,11,27.0,4,2,77,196.0,0.33692947030067444,0.2620919346809387
8602288,5307976,6358724,13858,6697,1994,9574,2002,7161,4284,1.0,0.0,366,1.0,7,3,0,4284.0,0.40391919016838074,-0.054532770067453384
8602724,7269955,5837179,13858,11583,2007,8356,1998,2275,5502,0.0,0.0,3,10.0,39,29,525,28.0,0.6241689324378967,0.14362244307994843
8606091,4425967,6434890,13858,2938,1984,9728,2002,10920,4130,1.0,0.0,142,4.0,7,2,28,343.0,0.5643776059150696,0.17802554368972778
8604990,5638079,5114936,13858,7831,1997,5983,1992,6027,7875,1.0,0.0,20,10.0,19,1,7,1848.0,0.7094557285308838,0.099271759390831
8603319,5162248,4213315,13858,6158,1992,1664,1980,7700,12194,0.0,0.0,170,8.0,1,1,168,1876.0,0.2667481005191803,0.10661612451076508
re44641,5341330,6581038,13858,6809,1994,10029,2003,7049,3829,0.0,1.0,145,24.0,14,18,14,42.0,0.5337399840354919,0.2421351671218872
8601928,7220076,5181989,13858,11464,2007,6235,1993,2394,7623,0.0,0.0,16,13.0,18,31,7,4634.0,0.2939625382423401,0.22657319903373718
8603536,5455040,4343441,13858,7215,1995,2413,1982,6643,11445,0.5,0.0,343,5.0,4,1,0,4963.0,0.2983053922653198,0.21922869980335236
8604215,8088741,6090809,13858,13151,2012,8965,2000,707,4893,0.0,0.5,2,10.0,30,2,224,35.0,0.3997281789779663,0.3962157368659973
8606396,4944335,4267012,13858,5325,1990,1958,1981,8533,11900,0.0,0.0,13,46.0,21,6,413,308.0,0.5230867266654968,0.16264347732067108
8612235,6151574,4873169,13865,9091,2000,5031,1989,4774,8834,1.0,0.0,30,5.0,13,7,168,6979.0,0.5015227198600769,0.18723934888839722
8610719,5619632,4580477,13865,7768,1997,3750,1986,6097,10115,1.0,0.0,124,2.0,12,1,7,8582.0,0.4364605247974396,0.3505101501941681
8609430,5994066,4740428,13865,8734,1999,4499,1988,5131,9366,0.0,0.0,130,3.0,11,9,0,4424.0,0.1774202138185501,0.3301404118537903
8612404,6134583,6602779,13865,9056,2000,10078,2003,4809,3787,1.0,0.0,89,26.0,11,6,14,14.0,0.38293230533599854,0.0034216197673231363
8612427,7567959,5505233,13865,12262,2009,7404,1996,1603,6461,1.0,0.0,41,5.0,72,12,35,3444.0,0.9141110181808472,0.16474796831607819
8610992,6433914,7078196,13865,9721,2002,11156,2006,4144,2709,0.5,0.0,84,4.0,6,9,0,21.0,0.5075975060462952,-0.03626393899321556
8610056,5572022,6359356,13865,7614,1996,9574,2002,6251,4291,0.5,0.0,56,6.0,6,5,14,168.0,0.4259810149669647,0.10390215367078781
8612310,6154203,4177934,13865,9098,2000,1440,1979,4767,12425,0.0,0.0,41,41.0,6,1,182,2779.0,0.2624484896659851,0.21593260765075684
8611311,6788733,4456533,13865,10477,2004,3099,1984,3388,10766,0.0,0.0,12,16.0,4,3,175,252.0,0.7083624005317688,0.04569358378648758
8611328,6377573,4982555,13865,9609,2002,5486,1991,4256,8379,0.3333333333333333,0.0,31,25.0,6,8,21,259.0,0.4696463942527771,0.07373055070638657
re44642,5381635,4936586,13865,6956,1995,5290,1990,6909,8575,1.0,0.0,26,24.0,16,2,21,203.0,0.5549057126045227,0.27431705594062805
8615456,6188403,5674169,13872,9175,2001,7950,1997,4697,5922,1.0,0.0,115,18.0,10,7,7,91.0,0.467805951833725,0.24912898242473602
8613419,6337635,4803894,13872,9504,2002,4793,1989,4368,9079,0.3333333333333333,0.0,52,16.0,10,6,63,2828.0,0.5230721235275269,0.13666078448295593
8614463,6049113,7942674,13872,8867,2000,12920,2011,5005,952,1.0,0.0,10,1.0,4,16,1106,952.0,0.3775405287742615,0.19308504462242126
8613161,4940297,4964955,13872,5304,1990,5409,1990,8568,8463,0.0,0.0,15,3.0,3,12,609,889.0,0.5983093976974487,0.23852261900901794
8613249,6396036,5557497,13872,9644,2002,7565,1996,4228,6307,0.0,0.0,13,21.0,97,8,7,112.0,0.19245149195194244,0.17276553809642792
8613654,6824465,4115331,13872,10561,2004,992,1978,3311,12880,1.0,0.0,43,24.0,12,1,21,3514.0,0.5931084752082825,0.10447418689727783
8614539,6903380,7336612,13872,10750,2005,11744,2008,3122,2128,1.0,0.0,46,3.0,22,10,7,539.0,0.5562841892242432,0.05662520229816437
8614596,5999848,8301598,13872,8741,1999,13452,2012,5131,420,0.0,0.0,331,1.0,13,5,7,420.0,0.314960777759552,0.22675877809524536
8617175,8337501,4575652,13879,13508,2012,3722,1986,371,10157,1.0,0.0,22,49.0,227,2,0,238.0,0.5078630447387695,0.1736697554588318
8616430,7547312,4538239,13879,12220,2009,3526,1985,1659,10353,1.0,0.0,112,27.0,25,2,7,21.0,0.7897390127182007,0.12461905926465988
8619133,4440457,5631462,13879,3015,1984,7810,1997,10864,6069,0.0,0.0,68,11.0,3,7,77,2639.0,0.3670928180217743,0.23279546201229095
8619558,7660247,6364346,13879,12458,2010,9588,2002,1421,4291,1.0,0.0,1,6.0,6,53,1421,623.0,0.3474692404270172,0.23134660720825195
8619147,7262798,7518910,13879,11562,2007,12157,2009,2317,1722,1.0,0.0,22,3.0,9,39,28,147.0,0.3350617587566376,0.2249746322631836
8620236,6608603,6434890,13879,10092,2003,9728,2002,3787,4151,0.3333333333333333,0.0,22,4.0,2,2,35,364.0,0.46435773372650146,0.21585427224636078
8626568,7043365,5271401,13886,11086,2006,6564,1993,2800,7322,0.5,0.0,2,15.0,9,7,784,35.0,0.41973230242729187,0.10286665707826614
8626970,5875343,6985941,13886,8454,1999,10967,2006,5432,2919,1.0,1.0,92,17.0,21,16,7,77.0,0.22893506288528442,0.1394810825586319
8623557,6395423,7566781,13886,9644,2002,12262,2009,4242,1624,1.0,0.0,36,1.0,10,2,7,1624.0,0.4360174834728241,0.1563117504119873
8626300,4587975,6708762,13886,3785,1986,10309,2004,10101,3577,1.0,0.0,135,14.0,6,23,7,280.0,0.14340917766094208,0.11092054843902588
8624908,5539449,4317499,13886,7509,1996,2252,1982,6377,11634,0.0,0.0,207,7.0,14,2,7,3339.0,0.44213300943374634,0.23026520013809204
8627236,7317473,5893683,13886,11695,2008,8503,1999,2191,5383,0.0,0.0,5,13.0,15,9,28,308.0,0.3763430118560791,0.24323013424873352
8625920,4777525,5688848,13886,4667,1988,7992,1997,9219,5894,0.0,0.0,85,4.0,16,29,7,1106.0,0.6668990850448608,0.10312962532043457
8621990,6336603,4811790,13886,9504,2002,4821,1989,4382,9065,0.0,0.0,11,21.0,16,4,0,1743.0,0.49532920122146606,0.35634174942970276
8624956,6260050,6245644,13886,9322,2001,9294,2001,4564,4592,0.0,0.0,210,3.0,23,8,28,3339.0,0.2608513832092285,0.033938031643629074
8626630,6839686,8286632,13886,10596,2005,13438,2012,3290,448,1.0,0.0,73,1.0,24,5,0,448.0,0.3958110511302948,0.2872946262359619
8622335,4505442,6534196,13886,3365,1985,9938,2003,10521,3948,0.0,0.0,15,2.0,5,8,161,2464.0,0.4135303199291229,0.14867547154426575
8622905,6481440,4937323,13886,9819,2002,5290,1990,4067,8596,1.0,0.5,143,30.0,4,6,7,105.0,0.11910742521286011,0.06862126290798187
8621715,6173475,pp19591,13886,9147,2001,12045,2008,4739,1841,1.0,0.0,11,2.0,5,1,70,196.0,0.5991215705871582,0.033210333436727524
8624076,5244523,4801244,13886,6466,1993,4779,1989,7420,9107,0.5,0.0,35,12.0,15,2,42,7.0,0.4079740643501282,0.19211193919181824
8622220,7337860,4313338,13886,11751,2008,2224,1982,2135,11662,0.0,0.0,7,35.0,13,1,77,476.0,0.1352495551109314,0.227656751871109
8628707,6733737,4001386,13893,10358,2004,369,1977,3535,13524,0.0,0.25,7,13.0,3,1,14,5817.0,0.44697731733322144,0.25153106451034546
8629554,6265771,4881712,13893,9336,2001,5073,1989,4557,8820,1.0,0.0,61,10.0,23,7,126,588.0,0.3723716139793396,0.22766345739364624
8628784,6936255,7166081,13893,10834,2005,11345,2007,3059,2548,1.0,1.0,9,2.0,1,29,14,14.0,0.20766420662403107,0.12976151704788208
8635526,5233423,6704974,13900,6424,1993,10302,2004,7476,3598,0.0,0.0,182,2.0,9,8,21,2583.0,0.3594950735569,0.1397078037261963
8634814,7411493,5746194,13900,11912,2008,8160,1998,1988,5740,0.2,0.0,19,7.0,41,8,14,1386.0,0.34570926427841187,0.02389865182340145
8635650,7246365,7859803,13900,11520,2007,12780,2010,2380,1120,1.0,0.0,37,3.0,6,15,7,7.0,0.7746391296386719,0.24570751190185547
8635309,4945216,5915695,13900,5325,1990,8580,1999,8575,5320,1.0,0.0,54,6.0,7,6,14,1512.0,0.2879277765750885,0.1050298735499382
8635444,5371783,5074609,13900,6914,1994,5836,1991,6986,8064,1.0,0.0,47,30.0,2,4,133,49.0,0.23338617384433746,0.11233467608690262
8632198,6608453,6546433,13900,10092,2003,9959,2003,3808,3941,0.0,0.0,269,19.0,133,1,14,189.0,0.5291646122932434,0.25718700885772705
8632655,6569284,5619198,13900,10008,2003,7768,1997,3892,6132,1.0,0.0,7,24.0,8,1,140,854.0,0.5340917110443115,0.21206489205360413
8635105,5848399,4460426,13900,8377,1998,3120,1984,5523,10780,1.0,0.0,231,6.0,95,3,14,322.0,0.3328247368335724,0.024542421102523804
8634891,5995855,4792184,13900,8734,1999,4737,1988,5166,9163,1.0,0.0,357,9.0,6,6,0,1820.0,0.3319436013698578,0.29640093445777893
8635696,6981279,7095638,13900,10953,2005,11191,2006,2947,2709,0.5,0.0,45,9.0,8,10,70,147.0,0.6495222449302673,0.26057904958724976
8635644,4847699,5686687,13900,4940,1989,7985,1997,8960,5915,0.5,0.0,156,2.0,2,4,21,805.0,0.42094406485557556,0.20516492426395416
8636944,5690244,5693416,13907,7999,1997,8006,1997,5908,5901,0.5,0.0,62,3.0,11,2,14,70.0,0.432068794965744,0.278999388217926
8636545,7824219,5622086,13907,12724,2010,7782,1997,1183,6125,1.0,0.0,2,4.0,5,7,707,1344.0,0.7821072340011597,0.25945135951042175
8638320,6495387,5467684,13907,9847,2002,7264,1995,4060,6643,0.0,0.0,22,6.0,5,26,91,630.0,0.2486879527568817,0.21407942473888397
8636133,5966345,5912164,13907,8685,1999,8566,1999,5222,5341,0.5,0.0,9,4.0,23,2,98,546.0,0.5834518671035767,-0.012571820057928562
8639829,6151589,5647432,13907,9091,2000,7866,1997,4816,6041,1.0,0.0,111,11.0,11,9,0,259.0,0.250929594039917,0.15532931685447693
8636648,4817131,5474535,13907,4835,1989,7285,1995,9072,6622,0.0,1.0,31,3.0,16,1,147,77.0,0.36076676845550537,0.09950651228427887
8636794,6162244,7561290,13907,9119,2000,12248,2009,4788,1659,1.0,0.0,40,3.0,8,3,56,602.0,0.25180697441101074,0.12263289093971252
8645273,7194422,4507155,13914,11401,2007,3372,1985,2513,10542,0.5,0.0,19,16.0,6,3,7,518.0,0.3692270815372467,0.15286672115325928
8642116,4362486,6547919,13914,2532,1982,9966,2003,11382,3948,0.0,0.0,21,2.0,5,4,2436,3675.0,0.3724064826965332,0.18225327134132385
8641699,5304187,4572403,13914,6683,1994,3708,1986,7231,10206,1.0,0.0,50,3.0,12,6,91,665.0,0.4822256565093994,0.062403976917266846
8643724,5245422,7516144,13914,6466,1993,12150,2009,7448,1764,1.0,0.0,173,2.0,5,2,7,1372.0,0.48946091532707214,0.22823980450630188
8644396,6556621,4563659,13914,9980,2003,3659,1986,3934,10255,0.5,0.0,80,21.0,17,1,49,77.0,0.21770107746124268,0.14691008627414703
8641704,6014581,7003234,13914,8776,2000,11009,2006,5138,2905,1.0,0.0,139,4.0,5,12,35,644.0,0.3979848325252533,0.13748374581336975
8642457,7030430,7294176,13914,11065,2006,11639,2007,2849,2275,1.0,0.0,26,8.0,16,5,14,224.0,0.33917665481567383,0.192092165350914
8645421,7805698,5034536,13914,12689,2010,5682,1991,1225,8232,1.0,0.0,1,6.0,9,8,1225,154.0,0.3953612148761749,0.06322217732667923
8642974,7176469,5074032,13914,11366,2007,5836,1991,2548,8078,0.3333333333333333,1.0,13,6.0,37,6,70,889.0,0.5486778616905212,0.11383975297212601
8641358,4635921,5446003,13914,4030,1987,7180,1995,9884,6734,0.5,0.0,12,15.0,9,1,770,357.0,0.3676263093948364,0.252824991941452
8646149,6425931,4410301,13921,9707,2002,2847,1983,4214,11074,0.0,0.0,13,5.0,4,1,203,5040.0,0.3477399945259094,0.18428175151348114
8648161,6187902,6580931,13921,9175,2001,10029,2003,4746,3892,1.0,0.0,12,4.0,2,20,35,1498.0,0.4600432217121124,0.18946263194084167
8648830,6081259,6987046,13921,8944,2000,10974,2006,4977,2947,0.0,0.0,15,3.0,14,2,63,252.0,0.6003003716468811,0.2514650523662567
8650027,4547894,7334447,13921,3575,1985,11744,2008,10346,2177,0.0,0.0,8,2.0,3,4,3927,175.0,0.46154093742370605,0.17694419622421265
8647424,5195430,5391248,13921,6291,1993,6991,1995,7630,6930,0.0,0.0,128,19.0,7,5,0,14.0,0.21629801392555237,0.14452682435512543
8650466,7322004,4102463,13921,11709,2008,936,1978,2212,12985,1.0,0.0,5,14.0,11,3,287,161.0,0.5601784586906433,0.12368234992027283
8652083,7227237,6605885,13928,11478,2007,10085,2003,2450,3843,0.0,0.0,1,7.0,5,19,2450,420.0,0.1674986332654953,-0.017661426216363907
8652474,7862817,6502340,13928,12787,2011,9868,2003,1141,4060,0.6666666666666666,0.0,14,2.0,108,6,35,1946.0,0.3738478422164917,0.27984628081321716
8652043,7366556,5940142,13928,11807,2008,8629,1999,2121,5299,1.0,0.0,219,19.0,103,1,7,28.0,0.6978341341018677,0.3148243725299835
8652400,6539765,4724057,13928,9952,2003,4422,1988,3976,9506,0.0,0.0,17,8.0,15,5,42,1078.0,0.39369434118270874,0.12672989070415497
8651033,6109193,7144978,13928,9007,2000,11296,2006,4921,2632,1.0,0.0,31,4.0,78,4,364,147.0,0.5012813210487366,0.053435228765010834
8652222,6180843,4347169,13928,9161,2001,2434,1982,4767,11494,0.0,0.0,54,22.0,9,4,7,1127.0,0.3464489281177521,0.1995779275894165
8655093,6829730,5538938,13928,10568,2004,7509,1996,3360,6419,1.0,0.0,45,3.0,7,3,14,2737.0,0.1846407800912857,0.3053458333015442
8654433,6594614,4458831,13928,10057,2003,3113,1984,3871,10815,0.0,0.0,114,16.0,3,3,0,2835.0,0.41662970185279846,0.004863573703914881
8655482,7243043,7774989,13928,11513,2007,12647,2010,2415,1281,0.5,0.0,40,2.0,15,19,14,364.0,0.5902029871940613,0.06166761741042137
8652171,5908421,4592467,13928,8552,1999,3806,1986,5376,10122,1.0,0.0,56,8.0,2,2,28,889.0,0.6019617915153503,0.2298533022403717
8652769,6087352,5670885,13928,8958,2000,7936,1997,4970,5992,0.5,0.0,27,2.0,10,8,203,3241.0,0.2874607741832733,-0.025928068906068802
8652809,6001640,4200803,13928,8748,1999,1580,1980,5180,12348,0.0,0.0,36,14.0,2,1,126,651.0,0.38735800981521606,0.14426492154598236
8660795,7792636,re38901,13935,12668,2010,10925,2005,1267,3010,0.0,0.0,3,7.0,3,8,7,112.0,0.6763843297958374,0.16310642659664154
8660088,8331906,5945958,13935,13494,2012,8643,1999,441,5292,1.0,0.0,1,9.0,15,5,441,413.0,0.43093281984329224,0.15127795934677124
8657842,6923813,4738070,13935,10806,2005,4492,1988,3129,9443,1.0,0.0,148,10.0,52,2,7,35.0,0.48020505905151367,0.04920554533600807
8661029,5488725,5108078,13935,7334,1996,5962,1992,6601,7973,1.0,0.0,284,13.0,17,9,7,126.0,0.5247493386268616,0.1742532104253769
8660734,5906645,5712843,13935,8545,1999,8062,1998,5390,5873,0.0,0.0,52,6.0,20,1,0,1414.0,0.40258586406707764,0.1325099617242813
8656817,7069970,6129876,13935,11142,2006,9049,2000,2793,4886,0.0,0.0,3,3.0,106,44,2191,1253.0,0.2919410765171051,0.163010373711586
8657952,5417975,6218579,13935,7082,1995,9238,2001,6853,4697,0.0,0.0,46,4.0,2,5,35,1148.0,0.41705122590065,0.2580803632736206
8660505,7002517,4171102,13935,11009,2006,1384,1979,2926,12551,0.0,0.0,10,2.0,10,2,0,10605.0,0.47892990708351135,0.17347410321235657
8658893,8067690,6231418,13935,13116,2011,9266,2001,819,4669,0.0,0.0,4,10.0,6,11,98,196.0,0.5882905125617981,0.37014827132225037
8656855,5615634,7334550,13935,7761,1997,11744,2008,6174,2191,1.0,0.0,9,1.0,11,5,2086,2191.0,0.6968979239463806,0.15071868896484375
8659379,7294366,6994203,13935,11639,2007,10995,2006,2296,2940,0.0,0.0,22,2.0,98,23,14,2275.0,0.1367788016796112,0.2494385540485382
8660675,5772213,6851817,13935,8216,1998,10631,2005,5719,3304,0.5,0.0,12,6.0,6,14,0,231.0,0.2965964078903198,0.2666572332382202
8660311,5983237,6692745,13935,8713,1999,10274,2004,5222,3661,1.0,0.0,127,9.0,10,4,56,1029.0,0.28103452920913696,0.21067290008068085
8658783,8017760,6171100,13935,13039,2011,9140,2001,896,4795,1.0,0.0,1,6.0,7,7,896,7.0,0.7652314305305481,-0.0058410316705703735
8661111,5042027,7614475,13935,5710,1991,12367,2009,8225,1568,0.0,0.0,200,1.0,9,13,49,1568.0,0.403171569108963,0.06415636092424393
8661573,6826257,4602602,13942,10561,2004,3862,1986,3381,10080,0.0,0.0,25,8.0,5,3,14,6020.0,0.3123646080493927,0.13340048491954803
8663154,4346715,4949749,13942,2434,1982,5346,1990,11508,8596,1.0,0.0,132,2.0,4,2,0,4634.0,0.3659685254096985,0.10227876156568527
8663230,7118578,5079843,13942,11240,2006,5857,1992,2702,8085,1.0,0.0,49,6.0,33,13,14,2597.0,0.39189019799232483,0.36958828568458557
8664695,6033948,5145323,13942,8832,2000,6095,1992,5110,7847,1.0,0.0,20,7.0,4,7,98,322.0,0.4580402076244354,0.1688857078552246
8666144,7224830,4446959,13942,11471,2007,3050,1984,2471,10892,0.5,0.0,21,2.0,4,2,14,2716.0,0.295590877532959,0.29014939069747925
8666432,5848373,7083779,13942,8377,1998,11170,2006,5565,2772,0.0,0.0,552,2.0,27,18,0,749.0,0.3855518102645874,0.08163481205701828
8663286,7785351,4200607,13942,12661,2010,1580,1980,1281,12362,1.0,0.0,33,17.0,274,3,21,98.0,0.45782795548439026,0.22128653526306152
8667571,7984130,5882913,13942,12983,2011,8475,1999,959,5467,1.0,0.0,54,1.0,12,9,0,5467.0,0.36830827593803406,0.10407976061105728
8662075,5009338,4661274,13942,5591,1991,4135,1987,8351,9807,0.0,0.0,72,5.0,8,2,91,4144.0,0.5630204677581787,0.3538432717323303
8670654,6697568,6740447,13949,10281,2004,10372,2004,3668,3577,1.0,0.0,11,3.0,8,7,112,1638.0,0.5772053003311157,0.25436633825302124
8667742,6981937,5736946,13949,10960,2006,8132,1998,2989,5817,0.0,0.0,2,7.0,7,1,448,3010.0,0.4572065770626068,0.35444051027297974
8667889,6584888,6022503,13949,10043,2003,8804,2000,3906,5145,1.0,0.0,9,8.0,2,5,1190,378.0,0.5623378753662109,0.3083953559398651
8668689,5601224,6468323,13949,7712,1997,9791,2002,6237,4158,1.0,0.0,480,15.0,122,10,0,126.0,0.44996315240859985,0.30339059233665466
8668732,4994071,4305590,13949,5528,1991,2175,1981,8421,11774,1.0,0.0,896,13.0,8,4,0,1582.0,0.32119593024253845,0.22887346148490906
8670931,6202026,6040859,13949,9203,2001,8846,2000,4746,5103,0.5,0.0,109,13.0,4,5,28,7.0,0.39964091777801514,0.2279002070426941
8668146,6306035,5427054,13949,9427,2001,7117,1995,4522,6832,0.0,0.0,49,10.0,1,4,21,238.0,0.2855927646160126,0.11924292892217636
8672953,4957499,7048082,13956,5374,1990,11100,2006,8582,2856,1.0,0.0,255,10.0,4,18,21,126.0,0.42509832978248596,0.11878593266010284
8676351,6289250,4640379,13956,9385,2001,4051,1987,4571,9905,1.0,0.0,27,7.0,3,6,0,8148.0,0.6715570092201233,0.09254555404186249
8673350,6290990,5751817,13956,9392,2001,8167,1998,4564,5789,1.0,0.0,32,8.0,4,7,266,49.0,0.43886590003967285,0.14928771555423737
8672662,5661872,5695074,13956,7915,1997,8013,1997,6041,5943,0.0,0.0,14,21.0,3,5,1134,1022.0,0.2673220932483673,0.12053681910037994
8671658,6345495,4107854,13956,9539,2002,964,1978,4417,12992,1.0,0.0,13,7.0,5,2,70,5978.0,0.5964019894599915,0.30948102474212646
8677450,7299294,6877164,13956,11646,2007,10687,2005,2310,3269,0.0,0.0,52,3.0,57,8,35,98.0,0.3345619738101959,0.05085844546556473
8675671,5659597,6738747,13956,7901,1997,10365,2004,6055,3591,0.5,0.0,131,4.0,34,13,42,7.0,0.6351268887519836,0.30610090494155884
8671959,4156619,4307934,13956,1244,1979,2189,1981,12712,11767,1.0,0.0,46,8.0,2,9,196,105.0,0.27772536873817444,0.3407232463359833
8673994,7619015,4555670,13956,12374,2009,3617,1985,1582,10339,0.25,0.0,6,8.0,3,1,84,2331.0,0.7027460932731628,0.16182425618171692
8673994,6890049,7851470,13956,10722,2005,12766,2010,3234,1190,0.0,0.0,11,5.0,12,3,84,105.0,0.5468186736106873,0.1572365164756775
8677489,8302186,4198693,13956,13452,2012,1566,1980,504,12390,0.3333333333333333,0.0,1,6.0,28,1,504,5103.0,0.4937743842601776,0.14285250008106232
8679849,7988854,7829662,13963,12997,2011,12731,2010,966,1232,0.0,0.0,1,1.0,70,2,966,1232.0,0.04892635717988014,0.1515466421842575
8682130,6049317,4419793,13963,8867,2000,2903,1983,5096,11060,0.0,0.0,244,2.0,4,1,56,9086.0,0.3641510009765625,0.11314265429973602
8680353,6444866,4677561,13963,9742,2002,4198,1987,4221,9765,1.0,0.0,12,21.0,3,4,84,749.0,0.6468862891197205,0.09748242795467377
8679003,5685820,5323815,13963,7985,1997,6753,1994,5978,7210,1.0,0.0,124,26.0,24,4,7,91.0,0.5031556487083435,0.04998721554875374
8681010,6514718,7132614,13963,9896,2003,11268,2006,4067,2695,0.0,0.0,444,5.0,215,14,0,329.0,0.13031630218029022,0.2163349986076355
8682678,6231500,8235715,13963,9266,2001,13368,2012,4697,595,0.0,0.0,14,1.0,2,10,84,595.0,0.48428794741630554,0.23499146103858948
8680794,6864646,7309734,13963,10659,2005,11674,2007,3304,2289,0.3333333333333333,0.0,18,1.0,11,7,14,2289.0,0.5155032277107239,0.030762242153286934
8688451,7072750,4235492,13970,11142,2006,1790,1980,2828,12180,0.0,0.0,9,5.0,5,2,105,2380.0,0.5140098929405212,0.20453161001205444
8684990,4950264,5709176,13970,5346,1990,8055,1998,8624,5915,1.0,0.0,354,4.0,16,1,0,1827.0,0.5033099055290222,0.3243408799171448
8688174,6529722,4897613,13970,9924,2003,5143,1990,4046,8827,1.0,0.0,64,8.0,19,1,7,3213.0,0.13900581002235413,0.20889505743980408
8685016,6113592,6882525,13970,9014,2000,10701,2005,4956,3269,1.0,0.0,154,9.0,9,3,0,133.0,0.3966924250125885,0.25136691331863403
8685815,6806211,4922982,13970,10519,2004,5241,1990,3451,8729,0.5,0.0,45,8.0,3,2,168,1680.0,0.4265477657318115,0.11380146443843842
8687826,6717392,7397938,13970,10323,2004,11877,2008,3647,2093,0.0,0.0,27,2.0,3,7,84,14.0,0.45636647939682007,0.09608477354049683
8683837,7107804,5569826,13970,11219,2006,7607,1996,2751,6363,1.0,0.0,6,2.0,11,1,77,2324.0,0.7923166751861572,0.19054014980793
8683978,5339636,4376233,13970,6809,1994,2623,1983,7161,11347,1.0,0.0,27,20.0,8,2,147,392.0,0.5109606385231018,0.25643497705459595
8686475,6081903,4149523,13970,8944,2000,1202,1979,5026,12768,0.0,0.0,82,20.0,74,4,35,70.0,0.49388429522514343,0.1982409507036209
re44823,8274360,4791111,13970,13417,2012,4730,1988,553,9240,0.0,0.5,9,15.0,252,5,14,3675.0,0.3690569996833801,0.07872005552053452
8689224,6883116,5407309,13970,10701,2005,7047,1995,3269,6923,1.0,0.0,8,18.0,8,14,1078,28.0,0.34817036986351013,0.1613684743642807
8688474,4591974,4948321,13970,3799,1986,5339,1990,10171,8631,1.0,0.0,61,6.0,16,13,154,1953.0,0.37623131275177,0.13905872404575348
8687610,5371738,5588737,13970,6914,1994,7670,1996,7056,6300,1.0,0.0,97,8.0,3,15,98,63.0,0.4634275436401367,0.30615416169166565
8684297,5553522,5437249,13970,7558,1996,7152,1995,6412,6818,1.0,0.0,29,8.0,5,10,672,882.0,0.4160991311073303,0.2383815497159958
8685031,7399041,7597058,13970,11884,2008,12332,2009,2086,1638,0.0,0.0,16,1.0,11,8,21,1638.0,0.16926978528499603,0.1324603259563446
8685341,6592821,7584771,13970,10057,2003,12304,2009,3913,1666,1.0,0.0,70,1.0,50,3,7,1666.0,0.35448387265205383,0.33134669065475464
8690029,5673836,7500801,13977,7950,1997,12122,2009,6027,1855,0.0,0.0,24,2.0,5,2,105,1652.0,0.6305867433547974,0.13488394021987915
8691754,4795698,4230357,13977,4751,1989,1762,1980,9226,12215,0.0,0.0,139,14.0,6,1,0,224.0,0.41391026973724365,0.13485461473464966
8690798,5437999,4403935,13977,7152,1995,2812,1983,6825,11165,0.0,0.0,547,11.0,5,1,0,553.0,0.47447362542152405,0.36294302344322205
8692152,5183992,4226790,13977,6242,1993,1741,1980,7735,12236,1.0,0.0,13,6.0,5,5,154,3696.0,0.7426403164863586,0.09098690003156662
8691288,6686346,7686076,13977,10260,2004,12507,2010,3717,1470,1.0,0.0,14,3.0,3,6,91,770.0,0.2680175006389618,0.19524650275707245
8693705,5597970,5102987,13977,7698,1997,5941,1992,6279,8036,0.0,0.0,4,4.0,4,1,5495,5915.0,0.6431142687797546,0.06349651515483856
8691594,7229840,6503573,13977,11485,2007,9868,2003,2492,4109,1.0,0.0,6,2.0,3,9,105,1295.0,0.39857998490333557,0.2981887757778168
8690114,6186467,6435074,13977,9175,2001,9728,2002,4802,4249,1.0,0.0,14,4.0,13,6,77,2555.0,0.3841193914413452,0.4028781056404114
8697192,6846758,5632234,13984,10617,2005,7817,1997,3367,6167,0.0,0.0,25,10.0,41,3,0,147.0,0.3539262115955353,-0.02715938165783882
8700535,7490356,5327806,13984,12094,2009,6767,1994,1890,7217,1.0,0.0,28,12.0,14,5,21,98.0,0.1940072476863861,0.09443099796772003
8698463,7786837,7150641,13984,12661,2010,11310,2006,1323,2674,0.5,0.0,23,6.0,7,5,84,301.0,0.4365466237068176,0.2944382429122925
8700163,6425852,6777298,13984,9707,2002,10456,2004,4277,3528,1.0,0.0,101,2.0,5,7,7,3234.0,0.41107177734375,-0.04460998997092247
8700923,7237129,7747888,13984,11499,2007,12598,2010,2485,1386,1.0,1.0,34,2.0,35,3,182,805.0,1.0,0.22712720930576324
8700360,5394744,4385649,13984,7005,1995,2707,1983,6979,11277,0.5,0.0,12,7.0,11,1,546,1918.0,0.5466790795326233,0.24327871203422546
8699474,5835696,5975800,13984,8349,1998,8706,1999,5635,5278,0.0,0.0,133,21.0,6,6,0,182.0,0.3601202070713043,0.19408169388771057
8699097,7259895,7686076,13984,11555,2007,12507,2010,2429,1477,1.0,0.0,3,3.0,3,6,1155,777.0,0.6866381168365479,0.10037071257829666
8695417,5357793,5888668,13984,6872,1994,8489,1999,7112,5495,1.0,0.0,19,2.0,7,2,49,5271.0,0.5711440443992615,0.1656685322523117
8696685,5098426,5024048,13984,5927,1992,5647,1991,8057,8337,1.0,0.0,366,8.0,5,9,0,2933.0,0.3773704171180725,0.18878065049648285
8701048,7266545,4045805,13984,11569,2007,607,1977,2415,13377,1.0,0.0,25,8.0,12,1,0,8141.0,0.2847091555595398,0.28303346037864685
8701362,4750302,4833748,13991,4548,1988,4898,1989,9443,9093,1.0,0.0,30,13.0,6,7,231,2114.0,0.7240411639213562,0.10934499651193619
8701353,7300190,6550628,13991,11653,2007,9973,2003,2338,4018,0.0,0.0,4,3.0,7,1,294,364.0,0.43951356410980225,0.22413425147533417
8704756,6864875,4169771,13991,10659,2005,1370,1979,3332,12621,1.0,0.0,198,9.0,372,4,35,1036.0,0.5225297808647156,0.3785828649997711
8701768,7798221,4675929,13991,12682,2010,4198,1987,1309,9793,1.0,0.0,71,21.0,614,4,49,371.0,0.6816041469573975,0.13297471404075623
8706211,7744555,4372313,13991,12598,2010,2595,1983,1393,11396,0.5,1.0,16,15.0,32,6,0,497.0,0.3743532598018646,0.2433992326259613
8706829,6243826,6138814,13991,9287,2001,9070,2000,4704,4921,0.0,0.0,10,2.0,10,3,301,112.0,0.5729216933250427,0.060049913823604584
8701997,6129277,5253156,13991,9049,2000,6494,1993,4942,7497,1.0,0.0,57,25.0,7,15,0,287.0,0.5370188355445862,0.20638138055801392
8701937,7203572,4017040,13991,11422,2007,467,1977,2569,13524,0.0,0.0,21,22.0,205,1,133,133.0,0.49733689427375793,0.1463761329650879
8701556,6047639,4435320,13991,8867,2000,2987,1984,5124,11004,1.0,0.0,18,2.0,5,1,385,5852.0,0.531975269317627,0.1454470306634903
8706991,8239646,4946900,13991,13368,2012,5332,1990,623,8659,1.0,0.0,4,7.0,4,4,189,4788.0,1.0000001192092896,0.1493007391691208
8703868,5241106,4999482,13991,6452,1993,5549,1991,7539,8442,0.0,0.0,44,17.0,2,1,28,1589.0,0.5310717821121216,0.21802958846092224
8703259,4184601,7616964,13991,1482,1980,12367,2009,12509,1624,0.0,0.0,25,3.0,2,7,133,231.0,0.49142661690711975,0.1478758007287979
8707008,6457017,5364057,13991,9763,2002,6893,1994,4228,7098,1.0,0.0,146,7.0,25,7,0,455.0,0.4363158643245697,0.32811957597732544
8705921,5748823,5709405,13991,8160,1998,8055,1998,5831,5936,1.0,0.0,23,8.0,14,9,21,1043.0,0.598611056804657,0.19426517188549042
8706630,6032859,4573833,13991,8832,2000,3715,1986,5159,10276,1.0,0.0,165,8.0,41,1,0,2198.0,0.5258732438087463,0.06649757921695709
8704377,7458150,4015506,13991,12024,2008,460,1977,1967,13531,1.0,0.0,4,4.0,3,1,112,4193.0,0.5779070258140564,0.2957633435726166
8706078,7113797,6553161,13991,11226,2006,9973,2003,2765,4018,1.0,0.0,26,2.0,9,3,70,2933.0,0.3567410409450531,0.2883744239807129
8709797,4317525,5341698,13998,2252,1982,6816,1994,11746,7182,0.0,0.0,16,7.0,2,3,826,49.0,0.557486891746521,0.010218223556876183
8713591,6918084,4761236,13998,10785,2005,4597,1988,3213,9401,0.0,0.0,77,6.0,129,9,7,539.0,0.20845156908035278,0.07442395389080048
8712441,6985839,5062357,13998,10967,2006,5787,1991,3031,8211,0.5,0.0,43,6.0,1,2,0,5670.0,0.5115967392921448,0.12822921574115753
8708200,5816453,4198533,13998,8314,1998,1566,1980,5684,12432,1.0,0.0,20,7.0,13,3,1162,805.0,0.724247395992279,-0.14572371542453766
8712123,4774265,5189645,13998,4653,1988,6263,1993,9345,7735,0.0,0.0,42,16.0,7,5,21,98.0,0.05808337405323982,0.10244778543710709
8713267,7822939,7168742,13998,12717,2010,11352,2007,1281,2646,1.0,0.0,47,6.0,9,13,0,231.0,0.5690374970436096,0.2165507674217224
8709287,8430947,5334562,13998,13634,2013,6788,1994,364,7210,0.0,0.0,1,6.0,13,8,364,3416.0,0.47971415519714355,0.23997078835964203
8709494,7045148,6613695,13998,11093,2006,10106,2003,2905,3892,0.3333333333333333,0.0,60,21.0,27,20,0,21.0,0.5753976702690125,0.19632308185100555
8713092,6992974,5393928,13998,10988,2006,6998,1995,3010,7000,0.0,0.0,19,15.0,3,17,0,161.0,0.4349919259548187,-0.04293115809559822
8710894,5379178,5081993,13998,6942,1995,5864,1992,7056,8134,0.0,0.0,7,15.0,2,20,938,7.0,0.41630831360816956,0.10423967987298965
8714049,7438318,7837241,14005,11982,2008,12745,2010,2023,1260,0.3333333333333333,0.0,3,1.0,14,13,427,1260.0,0.48559170961380005,0.37148579955101013
8715709,4088864,5742655,14005,859,1978,8146,1998,13146,5859,0.0,0.0,292,9.0,1,6,35,189.0,0.16059529781341553,0.026700450107455254
8714227,6629553,4354369,14005,10141,2003,2483,1982,3864,11522,1.0,0.0,26,40.0,22,6,35,1267.0,0.5620242357254028,0.22256948053836823
8713956,6313987,6025069,14005,9441,2001,8811,2000,4564,5194,0.0,0.0,11,30.0,36,1,126,7.0,0.5699978470802307,0.2620318830013275
8717203,4745559,4022308,14005,4520,1988,495,1977,9485,13510,0.0,0.0,141,11.0,2,2,7,1365.0,0.4137668013572693,-0.005363122094422579
8714213,7617851,6861113,14005,12374,2009,10652,2005,1631,3353,0.0,0.0,2,2.0,26,6,476,42.0,0.412556916475296,0.011607623659074306
8718673,6591112,4116761,14005,10050,2003,999,1978,3955,13006,1.0,0.0,35,7.0,19,1,0,5621.0,0.5355242490768433,0.28975772857666016
8726304,6614914,4369837,14012,10106,2003,2581,1983,3906,11431,1.0,0.0,470,16.0,292,2,49,329.0,0.44304490089416504,0.04723216965794563
8723278,7341839,3990241,14012,11758,2008,313,1976,2254,13699,0.0,0.0,2,9.0,1,1,1764,3815.0,0.14762888848781586,0.1509065479040146
8725240,4649924,4136465,14012,4093,1987,1125,1979,9919,12887,0.0,0.0,154,11.0,5,1,35,5019.0,0.6259084939956665,0.20801669359207153
8725239,7801618,4384002,14012,12682,2010,2693,1983,1330,11319,1.0,0.0,9,3.0,46,3,42,4417.0,0.3863690197467804,-0.03676113486289978
8720566,7059406,6836715,14012,11121,2006,10589,2004,2891,3423,1.0,0.0,25,6.0,346,12,35,378.0,0.19225504994392395,0.33569416403770447
8723260,6160292,6697639,14012,9112,2000,10281,2004,4900,3731,1.0,0.0,12,4.0,44,2,63,574.0,0.334213525056839,0.20466914772987366
8724916,5999656,7529118,14012,8741,1999,12178,2009,5271,1834,0.5,0.0,22,4.0,85,3,357,203.0,0.4032242000102997,0.2424769252538681
8726078,6718538,5183523,14012,10323,2004,6242,1993,3689,7770,1.0,0.0,44,8.0,6,19,98,189.0,0.2925194799900055,0.30144962668418884
8723969,5513016,7904898,14012,7425,1996,12850,2011,6587,1162,1.0,0.0,28,4.0,13,14,7,224.0,0.5122515559196472,0.0802982896566391
8721879,7214210,7801866,14012,11450,2007,12682,2010,2562,1330,0.5,0.0,38,2.0,58,15,7,812.0,0.37748345732688904,0.0496094673871994
8721578,5778563,4599665,14012,8230,1998,3841,1986,5782,10171,0.5,0.0,19,3.0,12,3,98,8169.0,0.4989505410194397,0.18638697266578674
8722198,6514512,6732234,14012,9896,2003,10351,2004,4116,3661,0.0,0.0,15,4.0,4,72,105,203.0,0.260582834482193,0.07540514320135117
8728937,7208337,6352372,14019,11436,2007,9560,2002,2583,4459,1.0,0.0,22,15.0,4,14,14,189.0,0.5438412427902222,0.19036313891410828
8732775,7272658,5687037,14019,11583,2007,7985,1997,2436,6034,0.5,0.0,19,4.0,10,6,42,2919.0,0.44322502613067627,0.35681983828544617
8730726,6670671,4557603,14019,10225,2003,3631,1985,3794,10388,0.0,0.0,34,32.0,8,2,315,469.0,0.4597015082836151,0.18746532499790192
8730455,6967710,7193550,14019,10918,2005,11401,2007,3101,2618,0.5,0.0,5,2.0,85,1,133,1456.0,0.5603882074356079,0.4138924181461334
8727944,8052562,6805782,14019,13095,2011,10519,2004,924,3500,0.5,0.0,3,2.0,3,5,574,1288.0,0.6441067457199097,0.19348621368408203
8732152,6388714,7639917,14019,9630,2002,12416,2009,4389,1603,0.0,0.0,240,2.0,29,24,7,14.0,0.6428730487823486,0.21579337120056152
8728032,5469994,6055645,14019,7271,1995,8881,2000,6748,5138,0.0,0.0,16,6.0,3,5,98,756.0,0.40370768308639526,0.23016183078289032
8728213,6715767,7751198,14019,10323,2004,12605,2010,3696,1414,0.0,0.0,7,1.0,5,8,7,1414.0,0.35587626695632935,0.37081781029701233
8736042,6504236,6710747,14026,9868,2003,10309,2004,4158,3717,1.0,1.0,15,11.0,38,4,84,371.0,0.6881736516952515,0.31715166568756104
8738154,5509410,4109249,14026,7418,1996,964,1978,6608,13062,1.0,0.0,511,5.0,23,1,0,4837.0,0.306017130613327,0.17446105182170868
8733358,6820617,6426847,14026,10554,2004,9707,2002,3472,4319,1.0,0.0,43,23.0,75,20,35,140.0,0.6127103567123413,0.280160129070282
8736590,6794119,4055443,14026,10491,2004,663,1977,3535,13363,0.0,0.0,375,2.0,5,1,0,8330.0,0.3345860540866852,0.24347804486751556
8734369,4762121,7337985,14026,4604,1988,11751,2008,9422,2275,1.0,0.0,58,8.0,4,18,14,7.0,0.3470379114151001,0.3665054440498352
8736462,6233567,6053353,14026,9266,2001,8881,2000,4760,5145,0.0,0.0,77,12.0,12,11,14,21.0,0.37689417600631714,0.26730597019195557
8734273,5033748,6106429,14026,5682,1991,9000,2000,8344,5026,1.0,0.0,95,7.0,2,12,35,273.0,0.6292974948883057,0.07407889515161514
8737962,5598457,8461711,14026,7698,1997,13676,2013,6328,350,1.0,0.0,19,1.0,7,6,0,350.0,0.27751022577285767,0.17328406870365143
8733719,7884735,5139156,14026,12822,2011,6074,1992,1204,7952,0.25,0.0,7,7.0,106,7,455,504.0,0.36803197860717773,0.17322131991386414
8734210,6869468,6764139,14026,10673,2005,10428,2004,3353,3598,0.0,0.0,10,6.0,11,6,371,287.0,0.3590652346611023,0.17637556791305542
8738189,7640079,7417085,14026,12416,2009,11926,2008,1610,2100,1.0,0.0,22,1.0,54,1,0,2100.0,0.5296822190284729,0.05314250662922859
8739118,6243709,4324787,14026,9287,2001,2294,1982,4739,11732,1.0,0.0,50,4.0,8,2,168,4837.0,0.6481786370277405,0.1815846562385559
8738518,7249098,4495471,14026,11527,2007,3309,1985,2499,10717,1.0,0.0,11,6.0,29,1,469,1652.0,0.5599035024642944,0.3055759370326996
8733351,5273031,4848745,14026,6571,1993,4947,1989,7455,9079,0.0,0.0,17,14.0,1,24,343,21.0,0.579867422580719,0.2903592884540558
8737538,5008900,7730318,14026,5584,1991,12570,2010,8442,1456,1.0,1.0,60,3.0,8,16,49,161.0,0.402065634727478,0.2116287648677826
8738678,4441165,5485757,14026,3015,1984,7327,1996,11011,6699,1.0,0.0,16,9.0,4,3,413,504.0,0.4763241708278656,0.09603121131658554
8734360,6239706,4293089,14026,9280,2001,2105,1981,4746,11921,0.0,0.0,24,7.0,11,1,7,1267.0,0.2737342417240143,0.09119173139333725
8740020,7308851,5859257,14033,11674,2007,8412,1999,2359,5621,0.5,0.0,4,6.0,106,3,189,63.0,0.6339413523674011,-0.003987862262874842
8742531,7763158,4527807,14033,12626,2010,3477,1985,1407,10556,0.0,0.0,8,15.0,3,6,21,196.0,0.3899295926094055,0.15336358547210693
8742489,5937295,4142534,14033,8622,1999,1160,1979,5411,12873,1.0,0.0,73,14.0,2,1,7,602.0,0.7445235252380371,0.1673772931098938
8744120,6633654,5719521,14033,10148,2003,8083,1998,3885,5950,1.0,0.0,23,7.0,13,7,14,91.0,0.4411351978778839,0.10899414867162704
8743004,5173714,5488481,14033,6200,1992,7334,1996,7833,6699,1.0,0.0,17,5.0,1,6,182,959.0,0.4018558859825134,0.14404752850532532
8740400,7387405,8469189,14033,11856,2008,13690,2013,2177,343,1.0,0.0,109,1.0,151,8,7,343.0,0.5083956122398376,0.12712393701076508
8744629,7261762,6479303,14033,11562,2007,9812,2002,2471,4221,0.0,0.0,44,6.0,17,39,7,98.0,0.24365851283073425,-0.010332700796425343
8745358,5579253,4192887,14033,7635,1996,1531,1980,6398,12502,1.0,0.0,52,5.0,1,2,0,8316.0,0.5027385950088501,0.07347290962934494
8741606,7537897,5317674,14033,12199,2009,6725,1994,1834,7308,0.5,0.0,12,2.0,44,4,7,5670.0,0.4459112584590912,0.04794498160481453
8742462,6269472,4958578,14033,9343,2001,5381,1990,4690,8652,0.0,0.0,195,35.0,13,9,7,1883.0,0.14127396047115326,0.10497827082872391
8740895,4799479,4790442,14033,4772,1989,4730,1988,9261,9303,1.0,0.0,290,19.0,11,11,7,273.0,0.32334116101264954,0.12103056907653809
8740237,8607942,6522215,14033,13865,2013,9910,2003,168,4123,0.0,0.0,1,7.0,156,11,168,91.0,0.5534509420394897,0.151667058467865
8746343,4794989,4072198,14040,4751,1989,768,1978,9289,13272,0.0,0.0,18,4.0,6,1,441,3479.0,0.4171483814716339,0.3129621148109436
8751498,6804667,4104570,14040,10512,2004,943,1978,3528,13097,1.0,0.0,64,13.0,15,3,0,5894.0,0.37181776762008667,0.17427189648151398
8750261,7013145,5868565,14040,11030,2006,8440,1999,3010,5600,1.0,0.0,30,6.0,8,9,7,266.0,0.41655677556991577,0.11253628879785538
8750488,8229102,5571325,14040,13354,2012,7614,1996,686,6426,1.0,0.0,10,10.0,20,7,14,35.0,0.4539300799369812,0.20957209169864655
8750898,7409384,4448356,14040,11905,2008,3057,1984,2135,10983,0.0,0.0,5,14.0,2,2,42,5320.0,0.45866718888282776,0.1312231719493866
8750937,7107079,5662221,14040,11212,2006,7915,1997,2828,6125,1.0,0.0,2,15.0,4,19,273,357.0,0.627204418182373,0.13223913311958313
8750317,6040867,5599467,14040,8846,2000,7705,1997,5194,6335,1.0,0.0,58,10.0,8,3,7,322.0,0.5186744928359985,0.007825033739209175
8751044,5710708,7033913,14040,8055,1998,11072,2006,5985,2968,0.0,0.0,27,8.0,5,5,602,413.0,0.5458536148071289,0.043565429747104645
8751124,7582041,5255633,14040,12297,2009,6508,1993,1743,7532,0.0,0.0,6,3.0,5,1,112,2464.0,0.4256168603897095,0.1593039482831955
8746412,6484850,5688525,14040,9826,2002,7992,1997,4214,6048,1.0,0.0,2,9.0,6,6,2156,1463.0,0.4523281753063202,-0.011599543504416943
8747459,7780726,4873407,14040,12654,2010,5031,1989,1386,9009,1.0,0.0,29,3.0,277,5,28,7063.0,0.6086841821670532,0.04986967518925667
8746362,4685354,5358288,14040,4240,1987,6872,1994,9800,7168,0.0,0.0,18,3.0,3,5,189,420.0,0.5138494968414307,0.15666349232196808
8750574,8649604,5490569,14040,13921,2014,7348,1996,119,6692,1.0,0.0,1,21.0,222,11,119,28.0,0.5470314621925354,0.03433643653988838
8753135,7557497,4455922,14047,12241,2009,3099,1984,1806,10948,1.0,0.0,6,6.0,6,1,427,63.0,0.4718391001224518,0.2565865218639374
8753197,6217448,4537388,14047,9238,2001,3526,1985,4809,10521,0.0,0.0,485,7.0,40,1,0,952.0,0.5915460586547852,0.16434212028980255
8752747,5716366,5074245,14047,8076,1998,5836,1991,5971,8211,1.0,0.0,505,7.0,12,2,0,1568.0,0.565686047077179,0.20013034343719482
8760750,6859114,6309160,14054,10645,2005,9434,2001,3409,4620,0.0,0.0,49,2.0,1,11,7,1813.0,0.09007546305656433,0.1394481211900711
8760185,6104198,7472758,14054,8993,2000,12059,2009,5061,1995,1.0,0.0,24,4.0,15,6,0,70.0,0.5497122406959534,0.22022821009159088
8762687,7649421,6820351,14054,12437,2010,10554,2004,1617,3500,0.0,0.0,9,3.0,28,12,182,1498.0,0.23933938145637512,0.1566445678472519
8759872,7855118,4706949,14054,12773,2010,4338,1987,1281,9716,1.0,0.0,20,18.0,25,6,14,217.0,0.46540436148643494,0.10345570743083954
8761894,7206640,7949292,14054,11429,2007,12927,2011,2625,1127,1.0,0.0,18,5.0,26,18,175,98.0,0.4315257966518402,0.11833985149860382
8758166,5316293,5785013,14054,6725,1994,8244,1998,7329,5810,1.0,0.0,20,31.0,10,7,98,511.0,0.5214513540267944,0.050572991371154785
8759167,7105868,4533707,14054,11212,2006,3505,1985,2842,10549,1.0,0.0,540,5.0,17,8,0,1722.0,0.4946213960647583,0.2630305588245392
8762267,5483445,6860262,14054,7313,1996,10652,2005,6741,3402,1.0,0.0,402,7.0,3,7,0,147.0,0.5041654706001282,0.2446991354227066
8757323,4298095,4462861,14054,2133,1981,3134,1984,11921,10920,0.3333333333333333,0.0,7,2.0,1,1,1638,588.0,0.48941975831985474,0.1942574828863144
8762281,6178425,5482072,14054,9154,2001,7313,1996,4900,6741,0.5,0.0,125,10.0,4,8,7,287.0,0.3477291464805603,0.07214026898145676
8756725,5561873,4335960,14054,7586,1996,2364,1982,6468,11690,1.0,0.0,85,5.0,8,1,14,3220.0,0.4367423355579376,0.28774961829185486
8758136,7489299,4017513,14054,12094,2009,467,1977,1960,13587,0.0,0.0,56,2.0,49,1,0,4704.0,0.2194274216890335,-0.0892070084810257
8757438,8240934,4748720,14054,13375,2012,4541,1988,679,9513,0.0,0.0,1,2.0,270,3,679,3493.0,0.6240344643592834,0.35595595836639404
8758323,7967773,4742391,14054,12962,2011,4506,1988,1092,9548,0.5,0.0,7,5.0,44,12,49,8085.0,0.48074042797088623,0.12991821765899658
8764796,7172595,4522099,14061,11359,2007,3449,1985,2702,10612,1.0,0.0,43,5.0,30,1,0,4991.0,0.36941659450531006,0.06964628398418427
8769508,5768593,8375952,14061,8202,1998,13564,2013,5859,497,1.0,0.0,123,1.0,8,15,56,497.0,0.5758218169212341,0.09965658187866211
8766217,8093564,5557497,14061,13158,2012,7565,1996,903,6496,0.0,0.0,8,21.0,222,8,91,63.0,0.6647723913192749,0.17608487606048584
8765622,5059331,4385605,14061,5773,1991,2707,1983,8288,11354,0.5,0.0,39,23.0,2,4,49,1414.0,0.4182043671607971,0.02851945534348488
8768148,5724103,7276230,14061,8097,1998,11597,2007,5964,2464,0.5,0.0,55,2.0,4,1,7,1106.0,0.5239278674125671,0.1115022599697113
8764370,7210924,4256264,14061,11443,2007,1902,1981,2618,12159,0.0,0.0,3,4.0,16,1,700,2051.0,0.3155263066291809,0.2580798268318176
8773026,6095661,6781281,14068,8979,2000,10463,2004,5089,3605,0.0,0.0,342,9.0,19,2,28,1232.0,0.500264585018158,0.13303068280220032
8775245,4896791,7346669,14068,5143,1990,11765,2008,8925,2303,0.0,0.5,132,4.0,6,10,35,329.0,0.5035064220428467,0.3324013650417328
8773503,4982218,6008305,14068,5479,1991,8762,1999,8589,5306,0.0,0.0,5,6.0,8,15,5488,77.0,0.48442384600639343,0.1712145358324051
8772886,6165287,4609816,14068,9126,2000,3897,1986,4942,10171,0.0,0.3333333333333333,12,12.0,5,2,945,308.0,0.45132049918174744,0.1861066371202469
8769729,6294758,4257885,14068,9399,2001,1909,1981,4669,12159,0.0,0.0,26,28.0,16,1,7,2268.0,0.3249013423919678,0.15295621752738953
8772646,6613413,7148807,14068,10106,2003,11303,2006,3962,2765,0.5,0.0,20,4.0,12,8,119,28.0,0.39828482270240784,0.14831672608852386
8772459,7452539,7965538,14068,12010,2008,12955,2011,2058,1113,0.5,0.0,1,1.0,10,6,2058,1113.0,0.14821648597717285,0.10657579451799393
8770199,6983749,4352268,14068,10967,2006,2469,1982,3101,11599,0.6666666666666666,0.0,15,7.0,12,1,56,3402.0,0.36890774965286255,0.1958516389131546
8778338,6395889,5854857,14075,9644,2002,8398,1998,4431,5677,0.5,0.0,12,14.0,3,13,84,245.0,0.47097235918045044,0.12125268578529358
8776790,6084380,4375625,14075,8951,2000,2616,1983,5124,11459,0.3333333333333333,0.0,35,3.0,16,5,14,749.0,0.3048577606678009,0.21755017340183258
8782734,6701318,4012704,14075,10288,2004,439,1977,3787,13636,1.0,0.0,75,7.0,22,2,0,4235.0,0.1862953007221222,0.14960098266601562
8776756,6006714,5431935,14075,8762,1999,7131,1995,5313,6944,1.0,0.0,6,2.0,19,1,399,1806.0,0.4556547701358795,0.26333606243133545
8780552,5903432,5025256,14075,8531,1999,5647,1991,5544,8428,1.0,0.0,11,17.0,5,5,7,168.0,0.4970982074737549,0.053991202265024185
8776738,6082328,6072622,14075,8951,2000,8923,2000,5124,5152,0.0,0.0,42,9.0,21,11,735,525.0,0.5381117463111877,0.1072140634059906
8781769,8013545,4733638,14075,13032,2011,4471,1988,1043,9604,0.0,0.0,15,28.0,5,8,14,2555.0,0.33024367690086365,0.2222142368555069
8781582,6253108,5843391,14075,9308,2001,8370,1998,4767,5705,1.0,0.0,25,2.0,13,1,63,2751.0,0.5134770274162292,0.040735188871622086
8784243,7115055,5451374,14082,11233,2006,7201,1995,2849,6881,1.0,0.0,18,14.0,17,3,56,35.0,0.6299846172332764,0.2213078737258911
8784745,5160702,4410497,14082,6151,1992,2847,1983,7931,11235,0.0,0.0,91,7.0,7,3,7,1477.0,0.4996196925640106,0.028861064463853836
8784330,5928162,4993423,14082,8608,1999,5528,1991,5474,8554,1.0,1.0,37,12.0,7,19,84,399.0,0.550517201423645,0.0894131287932396
8787549,5991377,6145011,14082,8727,1999,9077,2000,5355,5005,1.0,0.0,97,10.0,9,4,84,84.0,0.48471254110336304,0.35338205099105835
8787223,7403742,4980249,14082,11891,2008,5472,1990,2191,8610,1.0,0.0,2,7.0,10,2,455,238.0,0.5077973008155823,0.2762799561023712
8785102,4935326,8148956,14082,5283,1990,13242,2012,8799,840,1.0,0.0,260,3.0,10,5,0,35.0,0.2678259313106537,0.13892950117588043
8784174,6811483,4897873,14082,10533,2004,5143,1990,3549,8939,0.0,0.0,150,20.0,82,4,7,189.0,0.49191439151763916,0.1534986048936844
8788296,7309001,re44080,14082,11674,2007,13592,2013,2408,490,1.0,0.0,23,1.0,5,25,7,490.0,0.44067686796188354,0.06650262326002121
8787947,6405197,5188131,14082,9658,2002,6263,1993,4424,7819,0.0,0.0,114,9.0,68,2,7,1288.0,0.31315362453460693,0.056504324078559875
8783131,4872368,5892193,14082,5031,1989,8496,1999,9051,5586,1.0,0.0,30,4.0,1,2,315,1449.0,0.5085081458091736,0.2755228281021118
8784357,5722945,4368828,14082,8097,1998,2574,1983,5985,11508,1.0,0.0,37,25.0,61,6,14,1204.0,0.5057340264320374,0.13797062635421753
8785826,5039364,7380870,14082,5703,1991,11842,2008,8379,2240,0.0,0.0,44,5.0,9,7,0,154.0,0.6180213093757629,0.055146101862192154
8784478,6830575,4433582,14082,10575,2004,2980,1984,3507,11102,1.0,0.0,95,6.0,23,1,7,427.0,0.4982142746448517,0.13976937532424927
8786262,7112944,4665936,14082,11226,2006,4156,1987,2856,9926,0.5,0.0,8,15.0,11,2,252,546.0,0.39245328307151794,0.33109086751937866
8787755,6847484,5647353,14082,10617,2005,7866,1997,3465,6216,0.0,0.0,10,6.0,19,2,7,336.0,0.6731941103935242,-0.00016475655138492584
8792986,5690691,7391068,14089,7999,1997,11863,2008,6090,2226,1.0,0.0,365,10.0,9,1,0,168.0,0.6090584397315979,0.14895282685756683
8790304,6148634,5470183,14089,9091,2000,7271,1995,4998,6818,0.0,0.0,43,5.0,22,6,105,4557.0,0.5029795169830322,0.36534586548805237
8790243,6451027,6487699,14089,9756,2002,9826,2002,4333,4263,1.0,0.0,81,16.0,12,6,7,7.0,0.4838850200176239,0.11495745182037354
8789256,5927667,7218275,14089,8608,1999,11457,2007,5481,2632,0.0,0.0,18,11.0,12,5,7,35.0,0.525861918926239,0.12827236950397491
8790370,5725556,7938751,14089,8104,1998,12913,2011,5985,1176,1.0,0.0,192,13.0,3,55,7,49.0,0.6283886432647705,0.25142696499824524
8792200,5109306,8039971,14089,5962,1992,13074,2011,8127,1015,1.0,0.0,12,4.0,8,13,14,42.0,0.537082314491272,0.13536201417446136
8793443,6944785,6028452,14089,10848,2005,8818,2000,3241,5271,1.0,0.0,165,3.0,32,8,7,840.0,0.3132587969303131,0.3450077176094055
8790380,6375656,4293558,14089,9609,2002,2105,1981,4480,11984,1.0,0.5,7,3.0,7,1,56,1645.0,0.46472740173339844,0.05710874870419502
8797260,5889672,7200872,14096,8489,1999,11422,2007,5607,2674,0.0,0.0,202,5.0,9,22,14,623.0,0.4139460027217865,0.09789383411407471
8799413,6466978,5833990,14096,9784,2002,8349,1998,4312,5747,1.0,0.0,120,2.0,4,9,7,4802.0,0.5981497168540955,0.14899544417858124
8795347,6123723,4075819,14096,9035,2000,789,1978,5061,13307,1.0,0.0,157,11.0,26,1,14,7091.0,0.4497682452201843,0.21971842646598816
8796695,7691752,4213649,14096,12514,2010,1664,1980,1582,12432,1.0,0.0,20,16.0,3,1,35,805.0,0.44417253136634827,0.09817472845315933
8798934,5382331,4519621,14096,6956,1995,3435,1985,7140,10661,0.3333333333333333,0.0,34,4.0,4,1,168,420.0,0.2260262370109558,0.11932948231697083
8796155,6638441,4230778,14096,10162,2003,1762,1980,3934,12334,1.0,1.0,152,10.0,8,4,28,420.0,0.4157401919364929,0.25706201791763306
8795577,5716395,7915674,14096,8076,1998,12871,2011,6020,1225,0.0,0.0,43,1.0,25,3,56,1225.0,0.14941145479679108,0.2684342861175537
8797225,6634564,6968964,14096,10155,2003,10925,2005,3941,3171,0.0,0.0,105,6.0,5,15,0,28.0,0.358443021774292,0.3465999662876129
8801792,6936132,5805500,14103,10834,2005,8286,1998,3269,5817,0.0,0.0,23,41.0,7,6,35,511.0,0.16331355273723602,0.11944439262151718
8800588,4365643,7314582,14103,2553,1982,11688,2008,11550,2415,1.0,0.0,26,1.0,2,6,1393,2415.0,0.19708473980426788,0.18671879172325134
8806084,8135774,5904158,14103,13221,2012,8538,1999,882,5565,1.0,0.0,5,2.0,14,8,119,105.0,0.25890490412712097,0.28018149733543396
8800557,5701883,5272563,14103,8034,1997,6564,1993,6069,7539,1.0,0.0,73,1.0,7,2,14,7539.0,0.413800448179245,0.1680179387331009
8802981,6931645,7163997,14103,10820,2005,11338,2007,3283,2765,0.2,0.0,34,2.0,11,2,7,2520.0,0.28463563323020935,0.12473305314779282
8803888,6226396,6194586,14103,9252,2001,9189,2001,4851,4914,1.0,0.0,147,1.0,3,4,0,4914.0,0.36802437901496887,0.06690526008605957
8801389,5767606,7146546,14103,8202,1998,11296,2006,5901,2807,0.0,0.0,22,2.0,7,10,217,147.0,0.32537034153938293,0.08940452337265015
8802006,6379301,4227507,14103,9616,2002,1748,1980,4487,12355,0.25,0.0,610,5.0,4,5,0,3220.0,0.25579747557640076,0.15725184977054596
8805632,6424595,4852341,14103,9700,2002,4961,1989,4403,9142,0.0,0.0,13,4.0,9,5,567,315.0,0.6128202676773071,0.142140731215477
8805519,7455666,4269011,14103,12017,2008,1972,1981,2086,12131,1.0,0.0,4,7.0,68,1,147,1197.0,0.4565831124782562,0.19456608593463898
8803768,6909242,4730594,14103,10764,2005,4457,1988,3339,9646,0.0,0.0,34,5.0,10,6,91,8617.0,0.576738715171814,0.21131932735443115
8801613,6157850,4528667,14103,9105,2000,3477,1985,4998,10626,1.0,0.0,420,39.0,34,4,21,301.0,0.5194428563117981,0.39200296998023987
8800838,6270508,5596569,14103,9350,2001,7691,1997,4753,6412,1.0,0.0,253,47.0,27,9,7,42.0,0.4623264670372009,0.1144838035106659
8805900,8200509,4074415,14103,13312,2012,782,1978,791,13321,1.0,0.0,49,5.0,58,4,7,9849.0,0.4579283595085144,0.19974710047245026
8806803,4677785,4157578,14110,4205,1987,1251,1979,9905,12859,1.0,0.0,14,3.0,2,1,287,1218.0,0.6230125427246094,0.24601799249649048
8809854,8367489,7855973,14110,13550,2013,12773,2010,560,1337,1.0,0.0,9,3.0,31,4,49,287.0,0.7254044413566589,0.17384682595729828
8809628,7795503,6352771,14110,12675,2010,9560,2002,1435,4550,0.5,0.0,1,7.0,56,28,1435,350.0,0.5193061232566833,-0.014019829221069813
8810024,8659162,7028439,14110,13935,2014,11065,2006,175,3045,1.0,0.0,1,11.0,4,25,175,154.0,0.7513681650161743,0.279204398393631
8808350,6514281,4429020,14110,9896,2003,2952,1984,4214,11158,1.0,0.0,65,23.0,35,4,0,91.0,0.5865090489387512,0.22326898574829102
8809736,4897523,5204234,14110,5143,1990,6319,1993,8967,7791,1.0,0.0,29,7.0,4,1,392,3759.0,0.6795689463615417,0.08710863441228867
8809073,5767001,4040264,14110,8202,1998,586,1977,5908,13524,0.5,0.0,208,25.0,7,1,7,1106.0,0.17439889907836914,0.11760205030441284
8806667,8069499,4102264,14110,13123,2011,936,1978,987,13174,1.0,0.0,2,2.0,20,1,434,10934.0,0.647624135017395,0.28298690915107727
8811386,7330460,5152783,14110,11730,2008,6123,1992,2380,7987,1.0,0.0,8,12.0,12,3,189,532.0,0.599384069442749,0.1313823163509369
8812327,5864801,6471116,14110,8426,1999,9798,2002,5684,4312,0.3333333333333333,0.0,38,6.0,23,14,315,1484.0,0.5998914837837219,0.3088681697845459
8808438,7053227,5548117,14110,11107,2006,7537,1996,3003,6573,1.0,0.0,46,37.0,19,4,21,1029.0,0.34169644117355347,0.29281172156333923
8807191,7475715,5195932,14110,12066,2009,6291,1993,2044,7819,1.0,0.0,5,10.0,4,9,315,399.0,0.3302997052669525,0.289713054895401
8811068,5624863,4019519,14110,7789,1997,481,1977,6321,13629,0.0,0.0,57,20.0,3,1,7,49.0,0.41169965267181396,0.20686188340187073
8814587,8398029,5376046,14117,13592,2013,6935,1994,525,7182,0.25,0.0,1,10.0,8,8,525,595.0,0.3497319519519806,0.2179916799068451
8814908,7445637,8529463,14117,11996,2008,13767,2013,2121,350,1.0,0.5,139,1.0,5,34,49,350.0,0.42221516370773315,0.16279715299606323
8818514,5324255,4929363,14117,6753,1994,5262,1990,7364,8855,1.0,0.0,251,8.0,35,5,7,1470.0,0.33712586760520935,0.17749176919460297
8815513,5705332,4135645,14117,8041,1998,1118,1979,6076,12999,0.5,0.0,15,12.0,4,1,14,973.0,0.518727719783783,0.07856958359479904
8814755,5721539,5530361,14117,8090,1998,7481,1996,6027,6636,0.0,0.0,83,3.0,5,8,35,2856.0,0.40140682458877563,0.10109783709049225
8814507,7665962,8271313,14117,12472,2010,13410,2012,1645,707,1.0,0.0,8,3.0,21,85,84,91.0,0.5021366477012634,0.16283868253231049
8817578,5446701,5108122,14117,7180,1995,5962,1992,6937,8155,1.0,0.0,26,14.0,26,4,35,1288.0,0.40409308671951294,0.0811762735247612
8819744,5023931,6235283,14117,5640,1991,9273,2001,8477,4844,1.0,0.0,40,2.0,5,1,161,2667.0,0.5392301082611084,0.23952195048332214
8824437,7114024,4308528,14124,11226,2006,2189,1981,2898,11935,0.0,0.0,10,7.0,8,5,70,3885.0,0.2886686623096466,0.32072705030441284
8821039,8104977,5458505,14124,13179,2012,7229,1995,945,6895,1.0,0.0,6,27.0,5,2,0,245.0,0.6388481855392456,0.17613154649734497
8822545,5834409,5515101,14124,8349,1998,7432,1996,5775,6692,0.0,0.0,19,29.0,37,3,0,14.0,0.2762954533100128,0.07726021111011505
8821536,6599289,5090539,14124,10071,2003,5899,1992,4053,8225,1.0,0.0,70,11.0,102,6,21,777.0,0.5529934167861938,0.33357909321784973
re45109,5522083,4944357,14124,7453,1996,5325,1990,6671,8799,1.0,0.0,200,11.0,13,1,7,385.0,0.38818007707595825,0.32131442427635193
8821555,6582468,4599101,14124,10036,2003,3841,1986,4088,10283,1.0,0.0,204,4.0,21,5,7,1610.0,0.6895777583122253,0.06940114498138428
8821268,7427233,6152335,14124,11954,2008,9098,2000,2170,5026,1.0,0.0,41,22.0,94,40,7,42.0,0.44817134737968445,0.14284543693065643
8821889,6812219,5064707,14124,10533,2004,5794,1991,3591,8330,0.3333333333333333,0.0,51,4.0,4,5,70,4361.0,0.46271181106567383,0.06367020308971405
8827133,5139513,5572452,14131,6074,1992,7614,1996,8057,6517,1.0,0.0,290,6.0,7,12,7,77.0,0.434344083070755,0.1817847490310669
8828664,5554516,5158105,14131,7558,1996,6144,1992,6573,7987,0.5,0.0,165,16.0,3,9,21,322.0,0.5220057964324951,0.13291214406490326
8831754,7103524,4451891,14131,11205,2006,3071,1984,2926,11060,1.0,0.0,17,11.0,42,4,7,2695.0,0.28420692682266235,0.11962660402059555
8828058,5176679,4131359,14131,6214,1993,1090,1978,7917,13041,1.0,0.0,70,24.0,6,1,378,5194.0,0.5486025810241699,0.27386409044265747
8830977,6535502,6943284,14131,9938,2003,10848,2005,4193,3283,1.0,0.0,19,2.0,4,3,112,1890.0,0.7107964158058167,0.23467136919498444
8829250,4471136,6287607,14131,3176,1984,9385,2001,10955,4746,1.0,0.0,73,17.0,1,10,21,7.0,0.5017747282981873,0.1604277342557907
8827977,4600040,4345142,14131,3848,1986,2420,1982,10283,11711,1.0,0.0,30,8.0,2,3,42,5831.0,0.4112050533294678,0.22829881310462952
8830563,6014478,7993585,14131,8776,2000,13004,2011,5355,1127,1.0,0.0,6,1.0,11,35,546,1127.0,0.4289981424808502,0.3749484121799469
8828077,5911752,7872017,14131,8566,1999,12801,2011,5565,1330,0.5,0.3333333333333333,94,6.0,27,3,21,126.0,0.6411736011505127,0.26447731256484985
8832742,5812931,8273045,14131,8300,1998,13417,2012,5831,714,1.0,0.0,76,1.0,6,33,7,714.0,0.2893577814102173,0.11073733866214752
8828778,4964713,7249176,14131,5409,1990,11527,2007,8722,2604,0.0,0.0,24,14.0,7,13,91,63.0,0.4186241328716278,0.19547167420387268
8832043,5860103,6275960,14131,8412,1999,9357,2001,5719,4774,1.0,0.0,9,11.0,6,6,14,546.0,0.3191564679145813,0.41134145855903625
8829661,5134463,6876071,14131,6053,1992,10687,2005,8078,3444,1.0,0.5,18,4.0,2,9,7,525.0,0.4889053404331207,0.30086711049079895
8839032,6000046,5703825,14138,8741,1999,8034,1997,5397,6104,1.0,0.0,20,16.0,7,8,140,896.0,0.6211371421813965,0.19916939735412598
8834544,6159686,4732033,14138,9112,2000,4464,1988,5026,9674,0.0,0.0,57,12.0,39,2,14,259.0,0.2979338765144348,0.20556214451789856
8834401,7064103,5388972,14138,11128,2006,6984,1995,3010,7154,1.0,0.0,13,23.0,5,12,21,105.0,0.2563311457633972,0.23091576993465424
8834271,6315673,6244322,14138,9448,2001,9294,2001,4690,4844,1.0,0.0,53,3.0,27,29,7,154.0,0.247097909450531,0.203031986951828
8836561,7576675,6994650,14138,12283,2009,10995,2006,1855,3143,1.0,0.0,4,3.0,3,18,420,595.0,0.30343881249427795,0.23520247638225555
8833453,5316664,8551506,14138,6725,1994,13795,2013,7413,343,0.0,0.0,310,1.0,47,128,14,343.0,0.3038768470287323,0.19889836013317108
8833475,4765143,8273819,14138,4618,1988,13417,2012,9520,721,0.25,0.0,80,2.0,8,23,7,336.0,0.470193088054657,0.16115885972976685
8839486,8096743,4419793,14145,13165,2012,2903,1983,980,11242,0.5,0.0,5,2.0,7,1,119,9268.0,0.5810039639472961,0.23074321448802948
8843754,4805222,4480972,14145,4793,1989,3232,1984,9352,10913,1.0,0.0,94,8.0,4,2,7,140.0,0.570512056350708,0.22660042345523834
8840030,6266413,5023781,14145,9336,2001,5640,1991,4809,8505,0.0,0.5,43,5.0,5,4,84,2996.0,0.4155397415161133,0.35908204317092896
8840918,5206385,5405273,14145,6326,1993,7040,1995,7819,7105,0.0,0.0,31,3.0,2,34,21,2933.0,0.20120540261268616,0.24354219436645508
8849975,6006260,5116659,14152,8755,1999,5990,1992,5397,8162,1.0,0.0,202,30.0,14,8,21,7.0,0.5266785025596619,0.07097286731004715
8847371,8604600,7614126,14152,13858,2013,12367,2009,294,1785,1.0,0.0,1,2.0,2,3,294,371.0,0.3965689241886139,0.16370496153831482
8848484,5550788,7414488,14152,7544,1996,11919,2008,6608,2233,1.0,0.0,9,4.0,3,4,252,21.0,0.4696609377861023,0.1321185976266861
8844181,5669527,8028455,14152,7936,1997,13060,2011,6216,1092,0.0,0.0,10,3.0,1,14,3017,147.0,0.5465900301933289,0.3759591281414032
8849817,7266563,4262986,14152,11569,2007,1937,1981,2583,12215,1.0,0.0,15,7.0,10,3,7,2905.0,0.5041525959968567,0.1576164960861206
8849495,7492281,4485319,14152,12101,2009,3253,1984,2051,10899,0.25,0.0,41,3.0,69,8,7,8750.0,0.4667209982872009,0.2858971059322357
8847833,7405702,4154629,14152,11898,2008,1230,1979,2254,12922,1.0,0.0,11,20.0,6,2,70,420.0,0.400704562664032,0.04744356498122215
8847158,7783213,4489425,14152,12654,2010,3274,1984,1498,10878,0.5,0.0,1,15.0,5,2,1498,1722.0,0.7554513812065125,0.28969806432724
8845281,6273674,4317148,14152,9357,2001,2245,1982,4795,11907,1.0,0.0,5,3.0,4,2,175,175.0,0.5356445908546448,0.22576026618480682
8848727,6487605,4160016,14152,9826,2002,1279,1979,4326,12873,0.5,0.0,156,7.0,16,2,70,7.0,0.281307578086853,0.04532596468925476
8854494,7387573,4421346,14159,11856,2008,2910,1983,2303,11249,0.0,0.0,17,2.0,24,1,0,6748.0,0.33148059248924255,0.11966416239738464
8854538,4581710,5097236,14159,3750,1986,5920,1992,10409,8239,0.0,0.0,31,17.0,5,4,0,7.0,0.21251028776168823,0.24646984040737152
8851292,5022216,4114053,14159,5640,1991,985,1978,8519,13174,0.5,0.0,49,8.0,63,1,392,1001.0,0.36073368787765503,0.09923723340034485
8850989,4315197,6006096,14159,2231,1982,8755,1999,11928,5404,0.3333333333333333,0.0,25,39.0,1,8,35,210.0,0.45679742097854614,0.2029218077659607
8852121,5928164,7314582,14159,8608,1999,11688,2008,5551,2471,1.0,0.0,229,1.0,70,6,7,2471.0,0.5868589878082275,0.03822837769985199
8853047,5688713,4135645,14159,7992,1997,1118,1979,6167,13041,1.0,0.0,143,12.0,7,1,49,1015.0,0.6275777220726013,0.12931062281131744
8852189,5792143,8325831,14159,8258,1998,13487,2012,5901,672,1.0,0.0,64,1.0,4,1,0,672.0,0.4155329465866089,0.28712528944015503
8851890,6213773,7240056,14159,9231,2001,11506,2007,4928,2653,1.0,0.0,15,1.0,7,12,70,2653.0,0.5323917269706726,0.12588226795196533
8856777,6457103,4356076,14159,9763,2002,2490,1982,4396,11669,1.0,0.0,62,3.0,6,1,7,7028.0,0.2633831202983856,0.10256151854991913
8855860,6301530,8068522,14159,9413,2001,13116,2011,4746,1043,0.3333333333333333,0.0,13,1.0,3,6,91,1043.0,0.5475472211837769,-0.11608842015266418
8853427,5677297,5214574,14159,7957,1997,6354,1993,6202,7805,0.5,0.0,22,24.0,4,7,7,21.0,0.4816488027572632,0.0871257409453392
8856936,6643832,5113873,14159,10169,2003,5983,1992,3990,8176,0.0,0.0,15,17.0,4,5,105,203.0,0.14399199187755585,0.1623048335313797
8854590,8183698,7431207,14159,13291,2012,11968,2008,868,2191,0.5,0.0,2,6.0,46,4,287,126.0,0.18573498725891113,0.22492533922195435
8852409,5205990,6042439,14159,6326,1993,8853,2000,7833,5306,0.25,0.0,27,6.0,15,4,168,140.0,0.6055330038070679,0.18895980715751648
8856009,7412078,4447753,14159,11912,2008,3050,1984,2247,11109,0.0,0.0,17,13.0,2,5,21,91.0,0.14504507184028625,0.01467711478471756
8860636,7609239,6382420,14166,12353,2009,9623,2002,1813,4543,1.0,0.0,6,21.0,2,8,49,112.0,0.44763344526290894,0.17945976555347443
8858495,6308091,7012650,14166,9427,2001,11030,2006,4739,3136,1.0,0.0,76,13.0,21,20,56,112.0,0.4009701907634735,0.20291690528392792
8863015,7797293,6065072,14166,12675,2010,8902,2000,1491,5264,1.0,0.5,12,27.0,19,11,119,91.0,0.28049436211586,0.35202616453170776
8863064,7470593,4926121,14166,12052,2008,5248,1990,2114,8918,0.0,0.0,26,13.0,4,3,49,126.0,0.48686835169792175,0.21215903759002686
8858620,5907893,7889250,14166,8552,1999,12829,2011,5614,1337,0.5,0.0,312,4.0,17,4,0,448.0,0.4017152786254883,0.23876330256462097
8857506,7040398,4628025,14166,11086,2006,3995,1986,3080,10171,0.3333333333333333,0.0,154,4.0,434,2,0,5810.0,0.4159284830093384,0.008149594068527222
8858432,5957854,8276502,14166,8671,1999,13424,2012,5495,742,0.3333333333333333,0.0,549,3.0,2,7,7,56.0,0.4217519164085388,0.23346079885959625
8862199,5520180,4112978,14166,7453,1996,985,1978,6713,13181,1.0,0.0,51,10.0,27,1,42,1974.0,0.4744780659675598,0.3871292769908905
8858561,6622567,4406252,14166,10127,2003,2826,1983,4039,11340,0.0,0.0,75,7.0,6,1,35,2086.0,0.1504066288471222,0.09428931772708893
8861134,4546398,6003459,14166,3568,1985,8755,1999,10598,5411,1.0,0.0,47,3.0,7,1,455,672.0,0.6328134536743164,0.2122475653886795
8859790,5516738,7354403,14166,7439,1996,11786,2008,6727,2380,0.5,0.0,9,1.0,4,12,63,2380.0,0.6804071068763733,0.23360247910022736
8858561,4959066,4392139,14166,5381,1990,2742,1983,8785,11424,1.0,0.0,104,28.0,6,1,0,252.0,0.6461547613143921,0.17090624570846558
8863631,6696667,4682588,14173,10281,2004,4226,1987,3892,9947,0.0,0.5,73,59.0,11,4,7,91.0,0.4376627504825592,0.2545888423919678
8864784,7052488,6299864,14173,11107,2006,9413,2001,3066,4760,1.0,0.5,77,6.0,42,14,7,91.0,0.46840330958366394,0.13865360617637634
8867955,6795666,4940823,14173,10491,2004,5304,1990,3682,8869,1.0,0.0,46,3.0,41,1,203,819.0,0.49863263964653015,0.19622549414634705
8868172,6128538,6727005,14173,9042,2000,10344,2004,5131,3829,1.0,0.0,243,6.0,6,5,14,49.0,0.6801886558532715,0.08902250975370407
8868455,8265004,6987137,14173,13403,2012,10974,2006,770,3199,1.0,0.0,44,2.0,1,1,35,189.0,0.22154417634010315,0.12142862379550934
8863478,4353123,7927202,14173,2469,1982,12892,2011,11704,1281,0.0,0.0,4,1.0,4,4,2352,1281.0,0.4477804899215698,0.24732688069343567
8868753,6130898,4994234,14173,9049,2000,5528,1991,5124,8645,0.5,0.0,133,9.0,61,1,7,4914.0,0.2873132824897766,0.06567547470331192
8864574,6302793,4382387,14173,9420,2001,2686,1983,4753,11487,0.5,0.0,362,6.0,27,3,7,5509.0,0.5306090116500854,0.20852160453796387
8865458,6165416,6072622,14173,9126,2000,8923,2000,5047,5250,0.3333333333333333,0.0,12,9.0,15,11,588,623.0,0.6417153477668762,0.2754904329776764
8865370,7655331,4175060,14173,12451,2010,1419,1979,1722,12754,1.0,1.0,4,4.0,15,2,105,5866.0,0.7358399629592896,0.13721071183681488
8868212,6876886,5298864,14173,10687,2005,6662,1994,3486,7511,0.25,0.5,12,11.0,3,2,91,385.0,0.1965983808040619,0.2947847545146942
8866197,8089098,4545559,14173,13151,2012,3568,1985,1022,10605,1.0,0.0,43,8.0,241,4,7,2387.0,0.5575972199440002,0.020480656996369362
8865199,6117985,6844613,14173,9021,2000,10610,2005,5152,3563,0.6666666666666666,0.0,45,4.0,7,9,49,1204.0,0.4048563539981842,0.08700059354305267
8864898,7767253,5422991,14173,12633,2010,7096,1995,1540,7077,0.0,0.0,3,12.0,56,13,91,2702.0,0.6032218933105469,0.09807925671339035
8874761,7383339,6820244,14180,11842,2008,10547,2004,2338,3633,0.0,0.0,52,5.0,77,6,0,1071.0,0.4689347743988037,0.16165123879909515
8870812,5588815,4710421,14180,7670,1996,4352,1987,6510,9828,0.0,0.0,69,9.0,14,5,91,5040.0,0.32814574241638184,0.24972368776798248
8870078,7705482,4067173,14180,12535,2010,740,1978,1645,13440,0.0,0.0,10,8.0,18,1,49,931.0,0.45526111125946045,0.3586328327655792
8870415,7049761,8529463,14180,11100,2006,13767,2013,3080,413,0.5,0.0,64,1.0,23,34,0,413.0,0.6701951026916504,0.10929705947637558
8871000,4975182,7698437,14180,5451,1990,12521,2010,8729,1659,0.25,0.0,3,2.0,1,8,3150,1029.0,0.3016242980957031,0.1311141550540924
8869531,5676382,7664573,14180,7957,1997,12465,2010,6223,1715,0.0,0.0,17,2.0,4,11,14,126.0,0.14968840777873993,0.29715079069137573
8871807,6277804,8168428,14180,9364,2001,13270,2012,4816,910,0.25,0.0,16,1.0,1,2,777,910.0,0.5801723003387451,0.16997511684894562
8873586,6144292,4063982,14180,9077,2000,719,1977,5103,13461,1.0,0.0,126,8.0,26,1,0,630.0,0.424712598323822,0.11030781269073486
8870872,5810826,4751465,14180,8300,1998,4548,1988,5880,9632,1.0,0.0,41,4.0,28,7,175,7525.0,0.45950356125831604,0.1878986954689026
8873328,5892705,7069059,14180,8496,1999,11135,2006,5684,3045,1.0,0.0,8,11.0,5,3,1099,574.0,0.5863291621208191,0.3080959618091583
8869916,6290003,4223651,14180,9392,2001,1727,1980,4788,12453,1.0,0.0,22,6.0,7,3,385,7147.0,0.4520805776119232,0.35416683554649353
8870396,5591682,4229432,14180,7677,1997,1755,1980,6503,12425,0.3333333333333333,0.0,25,7.0,4,2,126,7.0,0.4372502565383911,0.06804454326629639
8880851,6647489,5622086,14187,10176,2003,7782,1997,4011,6405,1.0,0.0,17,4.0,6,7,28,1624.0,0.6302947402000427,0.18643225729465485
8879731,7836311,5364413,14187,12738,2010,6893,1994,1449,7294,0.0,0.0,12,3.0,5,6,105,4032.0,0.3920944035053253,0.14433994889259338
8876694,6024704,4998752,14187,8811,2000,5549,1991,5376,8638,1.0,0.0,171,5.0,11,1,7,5061.0,0.2926968038082123,0.02337535284459591
8875337,6272716,4930115,14187,9357,2001,5262,1990,4830,8925,1.0,0.0,9,8.0,6,5,98,2352.0,0.5821760296821594,0.09953880310058594
8878931,7397371,4119563,14187,11877,2008,1013,1978,2310,13174,0.0,0.0,7,11.0,1,2,105,259.0,0.4755418002605438,0.11404074728488922
8877787,5538995,7607007,14187,7509,1996,12346,2009,6678,1841,1.0,0.0,3,3.0,2,15,210,175.0,0.48384541273117065,0.1584187000989914
8880185,6443965,5225507,14187,9742,2002,6396,1993,4445,7791,1.0,0.0,55,4.0,47,5,0,4907.0,0.38460373878479004,0.03750092536211014
8880428,5835914,4643717,14187,8349,1998,4065,1987,5838,10122,1.0,0.0,133,33.0,6,1,63,28.0,0.3564719557762146,0.2753797173500061
8879812,7009699,4936586,14187,11023,2006,5290,1990,3164,8897,0.25,0.0,29,24.0,5,2,7,7.0,0.5768938660621643,0.09008803218603134
8877798,7081471,4310210,14187,11163,2006,2203,1982,3024,11984,0.5,0.0,3,7.0,33,1,126,1190.0,0.719123363494873,0.02086656354367733
8879713,8055617,5588088,14187,13095,2011,7663,1996,1092,6524,0.0,0.0,2,22.0,65,7,469,126.0,0.3045422434806824,0.28331053256988525
8880974,6223309,7801866,14187,9245,2001,12682,2010,4942,1505,0.3333333333333333,0.3333333333333333,42,3.0,15,15,56,91.0,0.5978999137878418,0.28978031873703003
8885794,7277577,4404345,14194,11597,2007,2812,1983,2597,11382,0.0,0.0,17,15.0,29,14,56,1085.0,0.29442036151885986,0.046198733150959015
8883980,5262296,4611216,14194,6529,1993,3904,1986,7665,10290,0.0,0.0,31,5.0,2,2,21,644.0,0.37961825728416443,-0.016013741493225098
8882136,8439393,5665005,14194,13648,2013,7922,1997,546,6272,0.5,0.0,2,2.0,18,5,336,4032.0,0.49473804235458374,0.3226310908794403
8884114,6982367,4583117,14194,10960,2006,3757,1986,3234,10437,1.0,0.0,513,17.0,6,6,0,49.0,0.7740979194641113,0.10409562289714813
8881660,8333448,5622683,14194,13501,2012,7782,1997,693,6412,0.25,0.0,2,7.0,7,7,315,1001.0,0.5119766592979431,0.22074615955352783
8882336,5044819,5519195,14194,5724,1991,7446,1996,8470,6748,0.5,0.0,42,24.0,10,13,287,14.0,0.30957308411598206,0.05221877247095108
8886213,7486201,5675857,14194,12087,2009,7957,1997,2107,6237,0.0,0.0,38,9.0,9,3,112,182.0,0.3171009123325348,0.1766577661037445
8886626,7039599,4156496,14194,11079,2006,1244,1979,3115,12950,1.0,0.0,279,32.0,129,1,0,119.0,0.4615952968597412,0.16076219081878662
8883600,5754826,5436928,14194,8174,1998,7145,1995,6020,7049,1.0,0.0,172,12.0,10,2,7,1890.0,0.17830587923526764,0.3633744716644287
8882766,5354271,4576655,14194,6858,1994,3729,1986,7336,10465,1.0,0.0,273,2.0,15,3,7,7252.0,0.3107474148273468,0.0587136335670948
8891193,6205494,4576406,14201,9210,2001,3729,1986,4991,10472,0.0,0.0,24,11.0,13,2,14,469.0,0.22208599746227264,0.24625808000564575
8889369,4325706,7713644,14201,2301,1982,12549,2010,11900,1652,1.0,0.0,57,2.0,3,10,231,385.0,0.596377968788147,0.27524128556251526
8892214,6847849,6340236,14201,10617,2005,9518,2002,3584,4683,1.0,0.0,154,5.0,21,2,14,1316.0,0.633947491645813,0.19916069507598877
8893044,6401065,6077882,14201,9651,2002,8937,2000,4550,5264,0.0,0.0,23,2.0,10,4,0,224.0,0.2967950701713562,0.22538632154464722
8893046,6671692,7501082,14201,10225,2003,12122,2009,3976,2079,0.5,0.0,50,3.0,43,3,21,1281.0,0.5204393863677979,0.22197069227695465
8888702,5269303,5568539,14201,6557,1993,7600,1996,7644,6601,1.0,0.0,344,14.0,1,5,0,1134.0,0.338444322347641,0.330394983291626
8892407,7460957,3980132,14201,12024,2008,257,1976,2177,13944,0.3333333333333333,0.0,18,9.0,6,1,7,644.0,0.6256977319717407,0.0051986114121973515
8889004,4581141,4131050,14201,3750,1986,1090,1978,10451,13111,0.5,0.0,67,19.0,1,2,14,455.0,0.4702657163143158,0.27650317549705505
8891341,8315128,5909144,14201,13473,2012,8552,1999,728,5649,1.0,0.0,2,24.0,1,9,392,7.0,0.6165301203727722,0.34063637256622314
8887725,5794619,7687277,14201,8265,1998,12507,2010,5936,1694,1.0,0.0,59,3.0,4,18,21,14.0,0.29387393593788147,0.3111843466758728
8896970,6295185,8520092,14208,9399,2001,13753,2013,4809,455,1.0,0.0,18,1.0,2,11,0,455.0,0.6012941002845764,0.23788674175739288
8895743,5922356,6926229,14208,8594,1999,10813,2005,5614,3395,0.0,0.0,34,5.0,7,11,14,833.0,0.345243364572525,0.14927472174167633
8893845,8322800,6150061,14208,13487,2012,9091,2000,721,5117,0.5,0.0,1,2.0,1,14,721,2541.0,0.402665913105011,0.16066448390483856
8899184,5233939,4509543,14215,6431,1993,3386,1985,7784,10829,0.5,0.0,10,10.0,2,6,189,203.0,0.386053204536438,0.05485283210873604
8902278,8292807,4763743,14215,13445,2012,4611,1988,770,9604,0.0,0.0,10,2.0,80,2,7,147.0,0.4580997824668884,0.15998905897140503
8902357,4734713,6172792,14215,4471,1988,9140,2001,9744,5075,0.0,0.0,54,9.0,4,11,0,56.0,0.24380084872245789,0.15788161754608154
8902471,6178008,4878013,14215,9154,2001,5052,1989,5061,9163,0.0,0.0,25,33.0,20,6,210,238.0,0.5370658040046692,0.33987075090408325
8903474,4847783,8523128,14215,4940,1989,13760,2013,9275,455,0.0,0.0,42,1.0,8,26,329,455.0,0.45992428064346313,0.1050427034497261
8901778,8552592,4315387,14215,13795,2013,2238,1982,420,11977,0.3333333333333333,0.0,12,9.0,117,1,35,322.0,0.6109868884086609,0.22930070757865906
8901823,5350977,5248157,14215,6844,1994,6480,1993,7371,7735,0.0,0.0,146,9.0,2,1,7,392.0,0.5797755718231201,0.15742264688014984
8900325,4569352,5001886,14215,3694,1986,5563,1991,10521,8652,0.25,0.0,85,10.0,5,5,35,2583.0,0.41861188411712646,0.19946005940437317
8903606,5744921,5097958,14215,8153,1998,5927,1992,6062,8288,0.0,0.0,61,7.0,119,7,63,77.0,0.34229034185409546,0.11498434841632843
8902357,5805550,5993978,14215,8286,1998,8734,1999,5929,5481,0.0,0.0,62,7.0,5,6,0,539.0,0.2170746624469757,0.06938612461090088
8900253,5449365,4123762,14215,7194,1995,1034,1978,7021,13181,1.0,0.0,154,5.0,45,1,0,6727.0,0.666788637638092,0.265251100063324
8903521,5086390,7414577,14215,5878,1992,11919,2008,8337,2296,0.5,0.0,42,6.0,10,39,14,392.0,0.3933333158493042,0.13459719717502594
8899523,6861156,6256378,14215,10652,2005,9315,2001,3563,4900,0.0,0.0,5,20.0,8,49,119,7.0,0.314758837223053,0.1205768957734108
8900268,6235009,5843391,14215,9273,2001,8370,1998,4942,5845,1.0,0.0,46,2.0,7,1,70,2891.0,0.3271033763885498,0.04894121736288071
8906986,4725665,4334595,14222,4429,1988,2357,1982,9793,11865,0.2,0.0,11,5.0,6,1,119,5831.0,0.3407054543495178,0.18146845698356628
8906081,5683448,6016138,14222,7978,1997,8783,2000,6244,5439,1.0,0.0,105,18.0,50,4,35,497.0,0.6234658360481262,0.27424168586730957
8909667,7790975,7540194,14222,12668,2010,12206,2009,1554,2016,0.0,0.0,4,4.0,13,6,273,189.0,0.3413739502429962,0.1165495216846466
8905855,5592401,4697365,14222,7677,1997,4296,1987,6545,9926,0.0,0.0,177,11.0,9,1,14,28.0,0.5446504354476929,0.12416666001081467
8905650,4914261,6589892,14222,5206,1990,10050,2003,9016,4172,0.5,0.0,10,20.0,9,48,6209,63.0,0.5761186480522156,0.32221224904060364
8905117,6799648,4300990,14222,10505,2004,2147,1981,3717,12075,0.0,0.0,22,36.0,16,4,42,679.0,0.38302376866340637,0.2311566323041916
8904739,5062491,4236190,14222,5787,1991,1790,1980,8435,12432,0.0,0.0,11,32.0,6,2,182,112.0,0.35461029410362244,0.219134122133255
8908069,7443434,6253673,14222,11989,2008,9315,2001,2233,4907,0.1,0.1,33,6.0,13,5,0,462.0,0.6380414962768555,0.18519824743270874
8908051,6965691,7778374,14222,10911,2005,12647,2010,3311,1575,0.1,0.09090909090909091,30,3.0,3,17,7,98.0,0.547177791595459,0.4137825071811676
8906022,6932086,7573089,14222,10827,2005,12276,2009,3395,1946,1.0,0.0,2,3.0,12,4,784,119.0,0.38437116146087646,0.1720656007528305
8909568,7813944,4611810,14222,12703,2010,3911,1986,1519,10311,1.0,0.0,34,22.0,14,7,28,161.0,0.4213714301586151,0.11729373037815094
8905915,5713911,4857603,14222,8069,1998,4975,1989,6153,9247,1.0,0.0,135,8.0,32,4,7,2009.0,0.39266183972358704,0.21379904448986053
8911022,6612648,4348699,14229,10106,2003,2441,1982,4123,11788,0.5,0.0,11,17.0,8,3,245,2821.0,0.3232504427433014,0.2670215368270874
8911471,5366479,7535384,14229,6900,1994,12192,2009,7329,2037,1.0,0.0,427,2.0,50,1,7,707.0,0.501665472984314,0.17188039422035217
8912157,7321828,5260680,14229,11709,2008,6522,1993,2520,7707,0.3333333333333333,0.0,55,5.0,200,3,21,1505.0,0.37915804982185364,0.026626070961356163
8914292,7831429,4165378,14229,12731,2010,1328,1979,1498,12901,1.0,0.0,7,10.0,9,12,35,9478.0,0.6922635436058044,-0.007383713964372873
8913131,8412393,5805239,14229,13606,2013,8286,1998,623,5943,0.16666666666666666,0.3333333333333333,1,2.0,12,1,623,5292.0,0.43324530124664307,0.23327186703681946
8913983,5363425,5847334,14229,6886,1994,8377,1998,7343,5852,1.0,0.0,212,6.0,10,2,21,2002.0,0.2686445116996765,0.147894024848938
8913137,6035214,8254578,14229,8832,2000,13389,2012,5397,840,0.1,0.1,97,1.0,18,7,7,840.0,0.3291565477848053,0.416614294052124
8911416,5690536,7297284,14229,7999,1997,11646,2007,6230,2583,0.5,0.0,13,2.0,11,6,336,14.0,0.620753824710846,0.386093407869339
8911471,8616431,4435633,14229,13879,2013,2987,1984,350,11242,0.5,0.0,7,6.0,1326,4,7,91.0,0.5119316577911377,0.12411528080701828
8914140,6354984,5852221,14229,9567,2002,8391,1998,4662,5838,0.0,0.0,22,2.0,18,3,511,4347.0,0.32619938254356384,0.03554743155837059
8913137,6222452,4401633,14229,9245,2001,2798,1983,4984,11431,0.0,0.0,110,13.0,7,2,7,420.0,0.19431400299072266,0.2485593557357788
8918755,8473450,4286525,14236,13690,2013,2070,1981,546,12166,1.0,0.0,1,9.0,272,2,546,1064.0,0.4774863123893738,0.2280745953321457
8915765,7169011,7602066,14236,11352,2007,12339,2009,2884,1897,1.0,0.0,2,1.0,3,26,1106,1897.0,0.5323956608772278,0.27778616547584534
8915547,6260920,4549756,14236,9329,2001,3589,1985,4907,10647,0.3333333333333333,0.0,18,9.0,11,3,63,1512.0,0.543712854385376,0.31001994013786316
8916281,5587132,5954042,14236,7663,1996,8664,1999,6573,5572,0.5,0.0,15,24.0,6,10,14,112.0,0.34706801176071167,0.2722647190093994
8918729,7065493,6980528,14236,11128,2006,10953,2005,3108,3283,1.0,0.0,117,17.0,8,40,35,56.0,0.20898206532001495,0.30667585134506226
8915853,5524625,4546294,14236,7467,1996,3568,1985,6769,10668,1.0,0.0,31,17.0,5,7,63,56.0,0.2578343451023102,0.16337814927101135
8918812,6055543,5227571,14236,8881,2000,6403,1993,5355,7833,0.5,0.0,213,4.0,17,5,63,196.0,0.3729346990585327,0.25469207763671875
8917474,8605382,5248050,14236,13858,2013,6480,1993,378,7756,1.0,0.0,10,7.0,11,5,7,1890.0,0.6268633604049683,0.23086324334144592
8918727,5694616,8066583,14236,8006,1997,13116,2011,6230,1120,0.0,0.0,210,4.0,12,9,0,154.0,0.32401254773139954,0.02941911108791828
8915864,5281408,8118460,14236,6599,1994,13200,2012,7637,1036,0.5,0.0,155,1.0,19,1,49,1036.0,0.3360186517238617,0.1418323516845703
8924655,7814082,7246632,14243,12703,2010,11527,2007,1540,2716,1.0,0.0,6,3.0,6,5,63,945.0,0.3409685492515564,0.14548130333423615
8918976,7954240,4279779,14243,12941,2011,2028,1981,1302,12215,0.0,0.0,3,8.0,16,5,392,5075.0,0.5123584270477295,0.06617352366447449
8920733,7128880,6392185,14243,11261,2006,9637,2002,2982,4606,1.0,0.0,15,2.0,11,8,70,2268.0,0.5784846544265747,0.07342764735221863
8923548,5057915,6340069,14243,5766,1991,9518,2002,8477,4725,0.0,0.0,389,8.0,29,3,14,84.0,0.07036161422729492,-0.03443453088402748
8919336,5117747,4994626,14243,5997,1992,5528,1991,8246,8715,0.0,0.0,14,8.0,7,1,3374,2730.0,0.5332002639770508,0.18222397565841675
8920463,6569187,6889660,14243,10008,2003,10722,2005,4235,3521,1.0,0.0,155,7.0,27,9,0,392.0,0.3584751486778259,0.26907092332839966
8930902,6519767,4680760,14250,9903,2003,4212,1987,4347,10038,1.0,1.0,102,28.0,12,3,0,1589.0,0.4361293315887451,0.14800341427326202
8928119,5694588,5427870,14250,8006,1997,7117,1995,6244,7133,0.0,0.0,52,31.0,19,3,28,84.0,0.21234442293643951,0.009854826144874096
8927547,7335656,7024348,14250,11744,2008,11051,2006,2506,3199,1.0,0.0,2,15.0,14,9,1099,147.0,0.38384661078453064,0.11135730147361755
8930213,5860918,5674169,14250,8419,1999,7950,1997,5831,6300,0.0,0.0,115,18.0,5,7,14,245.0,0.6286056637763977,0.15423829853534698
8929065,7523528,5431842,14250,12171,2009,7131,1995,2079,7119,0.0,0.0,7,6.0,37,6,77,931.0,0.3925265371799469,0.22591198980808258
8928562,5467107,4014134,14250,7257,1995,453,1977,6993,13797,0.5,0.0,126,15.0,12,1,91,1148.0,0.6007347106933594,0.296925812959671
8928693,7372247,6975693,14250,11821,2008,10939,2005,2429,3311,0.0,0.0,74,4.0,29,31,14,56.0,0.5631699562072754,0.18053212761878967
8926706,4586496,6526367,14250,3778,1986,9917,2003,10472,4333,0.0,0.0,105,3.0,1,4,28,1673.0,0.297976016998291,0.07981105893850327
8932235,5690120,7673396,14257,7999,1997,12486,2010,6258,1771,1.0,0.0,80,5.0,17,35,21,98.0,0.4934356212615967,0.214791938662529
8932214,6916310,7004192,14257,10785,2005,11016,2006,3472,3241,0.5,0.0,89,5.0,16,2,0,644.0,0.548706591129303,0.21512405574321747
8934191,7286317,4480463,14257,11618,2007,3232,1984,2639,11025,1.0,0.0,15,5.0,7,7,7,5026.0,0.6919126510620117,0.12007234245538712
8931682,5554148,5069378,14257,7558,1996,5815,1991,6699,8442,1.0,0.0,34,2.0,16,4,7,7686.0,0.2427712231874466,0.33666789531707764
8932032,6494694,4203203,14257,9847,2002,1601,1980,4410,12656,0.25,0.0,14,22.0,6,3,7,2058.0,0.5240546464920044,0.2509863078594208
8932325,6921401,4402719,14257,10799,2005,2805,1983,3458,11452,1.0,0.0,19,3.0,13,8,49,5775.0,0.2412792444229126,0.2851769030094147
8932953,5632910,5146877,14257,7817,1997,6102,1992,6440,8155,0.0,0.0,34,19.0,6,11,91,231.0,0.4692820608615875,0.19745688140392303
8932514,5726414,4085734,14257,8104,1998,845,1978,6153,13412,0.0,0.0,38,6.0,11,2,35,5061.0,0.17395898699760437,0.21416965126991272
8935512,5964861,6802046,14257,8685,1999,10505,2004,5572,3752,1.0,0.5,5,7.0,13,4,14,1393.0,0.6221643686294556,0.10642734915018082
8936812,5352680,4300973,14264,6851,1994,2147,1981,7413,12117,1.0,0.0,101,5.0,5,1,0,2632.0,0.46975454688072205,0.2978367209434509
8938796,7146529,4752879,14264,11296,2006,4555,1988,2968,9709,1.0,1.0,4,14.0,12,8,287,399.0,0.3564600348472595,0.05036152899265289
8941833,5882774,5744729,14271,8475,1999,8153,1998,5796,6118,0.0,0.5,479,5.0,108,2,14,2072.0,0.21384204924106598,0.3067021071910858
8941416,8212600,4081292,14271,13333,2012,817,1978,938,13454,0.3333333333333333,0.3333333333333333,4,19.0,22,1,189,707.0,0.42819228768348694,0.3753545880317688
8942039,7952930,5774452,14271,12934,2011,8216,1998,1337,6055,1.0,0.0,2,13.0,7,7,854,21.0,0.5877078175544739,0.37408336997032166
8939171,6953058,7485995,14271,10876,2005,12087,2009,3395,2184,0.0,0.0,36,3.0,5,5,126,1183.0,0.5765841007232666,0.13192762434482574
8942854,6172432,5596710,14271,9140,2001,7691,1997,5131,6580,0.0,0.5,78,23.0,65,12,140,413.0,0.3425734341144562,0.4850226044654846
8941096,6632545,5695074,14271,10148,2003,8013,1997,4123,6258,0.25,0.0,3,23.0,7,5,763,49.0,0.562143087387085,-0.06787153333425522
8942779,7431700,4583016,14271,11968,2008,3757,1986,2303,10514,1.0,0.0,17,19.0,9,5,42,1064.0,0.46628621220588684,0.10713159292936325
8940210,5985204,8104737,14271,8720,1999,13179,2012,5551,1092,0.16666666666666666,0.0,22,1.0,7,6,14,1092.0,0.29804229736328125,0.38663503527641296
8942743,6704651,7619624,14271,10295,2004,12374,2009,3976,1897,0.0,0.0,107,3.0,24,13,35,994.0,0.3120846152305603,0.2731030583381653
8947487,6501739,5829189,14278,9861,2002,8342,1998,4417,5936,1.0,0.0,121,7.0,15,3,7,889.0,0.5000998973846436,0.3370383381843567
8948576,8428445,5285149,14278,13627,2013,6613,1994,651,7665,1.0,0.0,1,4.0,27,7,651,3073.0,0.3634175658226013,0.15168547630310059
8948114,8009656,6952933,14278,13025,2011,10876,2005,1253,3402,1.0,0.0,4,2.0,17,10,651,2723.0,1.0,0.27915650606155396
8945125,6953461,6107804,14278,10876,2005,9000,2000,3402,5278,1.0,0.0,233,3.0,110,5,7,560.0,0.7600481510162354,0.35896173119544983
8945029,5158075,6399791,14278,6144,1992,9651,2002,8134,4627,1.0,0.3333333333333333,7,5.0,5,6,175,357.0,0.40268611907958984,0.17498116195201874
8943634,6081957,4354029,14278,8951,2000,2476,1982,5327,11802,0.0,0.0,19,10.0,8,2,35,3465.0,0.49146854877471924,0.12624399363994598
8949986,6981155,4995648,14278,10953,2005,5535,1991,3325,8743,0.25,0.0,35,15.0,15,4,14,259.0,0.656336784362793,0.10960555076599121
8943711,4370818,4027593,14278,2588,1983,523,1977,11690,13755,1.0,0.0,24,8.0,2,2,315,287.0,0.3616304099559784,0.13122838735580444
8948687,7546084,5837426,14278,12213,2009,8356,1998,2065,5922,1.0,0.0,6,13.0,28,1,371,126.0,0.447767436504364,0.3675716519355774
8947531,6104148,5259359,14278,8993,2000,6522,1993,5285,7756,0.0,0.0,40,4.0,7,7,98,2681.0,0.3863426148891449,0.163682222366333
8945380,6409841,4590464,14278,9672,2002,3792,1986,4606,10486,0.0,0.0,47,3.0,6,9,7,1855.0,0.48104873299598694,0.25437483191490173
8944702,5390272,5602053,14278,6984,1995,7712,1997,7294,6566,1.0,0.0,59,7.0,10,16,49,147.0,0.47901633381843567,0.19307519495487213
8949473,7193844,5305491,14278,11401,2007,6690,1994,2877,7588,0.3333333333333333,0.0,13,6.0,17,18,35,539.0,0.505029559135437,0.03673353046178818
8945231,8197549,4166562,14278,13312,2012,1342,1979,966,12936,1.0,0.0,2,7.0,11,3,420,98.0,0.4600449800491333,0.2979313135147095
8951423,6267879,4386919,14285,9343,2001,2714,1983,4942,11571,1.0,0.0,20,14.0,9,1,126,63.0,0.42154526710510254,0.4673949182033539
8951997,4456757,7785661,14285,3099,1984,12661,2010,11186,1624,1.0,0.0,17,2.0,2,84,42,371.0,0.7567234039306641,0.18741080164909363
8950758,5413361,7875496,14285,7068,1995,12808,2011,7217,1477,1.0,0.0,14,2.0,1,4,168,420.0,0.541344940662384,0.2485499083995819
8954331,6070241,5004844,14285,8916,2000,5570,1991,5369,8715,0.0,0.0,68,6.0,9,3,133,1015.0,0.6547312140464783,0.1423216611146927
8952707,6026078,7452842,14285,8811,2000,12010,2008,5474,2275,0.5,0.0,44,3.0,4,27,7,875.0,0.42267611622810364,0.07563042640686035
8953529,8284728,6506578,14285,13431,2012,9875,2003,854,4410,1.0,0.0,3,2.0,27,1,245,4186.0,0.4595720171928406,0.03423803672194481
8950566,4827531,5486456,14285,4870,1989,7327,1996,9415,6958,0.5,0.0,151,11.0,9,1,7,266.0,0.20531216263771057,0.11297623813152313
8950348,5341757,4677346,14285,6816,1994,4198,1987,7469,10087,1.0,0.0,15,11.0,6,3,112,1925.0,0.6404386758804321,0.20522303879261017
8951280,7101396,4184416,14285,11205,2006,1482,1980,3080,12803,1.0,0.0,116,14.0,20,4,56,714.0,0.6104086637496948,0.21796120703220367
8954128,6891317,4861321,14285,10722,2005,4989,1989,3563,9296,0.0,0.0,190,5.0,19,4,42,1407.0,0.3208465278148651,-0.09469646960496902
8952321,4766312,7475660,14285,4618,1988,12066,2009,9667,2219,0.5,0.0,24,2.0,5,6,322,182.0,0.35087472200393677,0.20288293063640594
8950493,4718490,4244333,14285,4394,1988,1839,1981,9891,12446,0.5,0.0,71,11.0,8,3,7,3563.0,0.5235489010810852,0.2544955611228943
8950212,5799502,6902708,14285,8279,1998,10750,2005,6006,3535,1.0,0.0,8,4.0,11,19,91,357.0,0.6195365786552429,0.1769765019416809
8951300,6689125,5347406,14285,10267,2004,6830,1994,4018,7455,1.0,0.0,93,5.0,58,2,70,5565.0,0.6007011532783508,0.10560667514801025
8954512,5974238,5171212,14285,8699,1999,6193,1992,5586,8092,1.0,0.0,505,14.0,3,20,0,63.0,0.6778443455696106,0.23737795650959015
8952062,5594030,7654481,14285,7684,1997,12451,2010,6601,1834,0.5,0.0,22,1.0,2,6,70,1834.0,0.5539511442184448,0.07338901609182358
8952116,6809158,4727394,14285,10526,2004,4436,1988,3759,9849,0.3333333333333333,0.0,27,4.0,22,8,0,3409.0,0.6050190925598145,0.1532074511051178
8958315,6163711,6217555,14292,9119,2000,9238,2001,5173,5054,0.25,0.0,115,28.0,15,20,7,14.0,0.462430477142334,0.17530976235866547
8957078,6235741,4755982,14292,9273,2001,4569,1988,5019,9723,1.0,0.0,19,24.0,2,8,77,2177.0,0.7054221630096436,0.06261971592903137
8957754,5069731,4636177,14292,5815,1991,4030,1987,8477,10262,1.0,0.0,22,9.0,2,2,91,539.0,0.5676260590553284,0.21832889318466187
8959200,7117239,4691725,14292,11233,2006,4268,1987,3059,10024,1.0,0.0,100,28.0,266,1,14,224.0,0.4262878894805908,0.13771165907382965
8958789,4556760,4035070,14292,3624,1985,558,1977,10668,13734,0.5,0.0,71,6.0,2,1,42,1008.0,0.26453205943107605,0.3755309581756592
8956713,6312971,4490900,14292,9441,2001,3288,1985,4851,11004,0.0,0.0,240,58.0,22,7,0,21.0,0.44044893980026245,0.3059605062007904
8955770,5400916,4857016,14292,7026,1995,4975,1989,7266,9317,0.0,0.0,44,13.0,5,3,91,1197.0,0.270730197429657,0.18488413095474243
8962586,6667337,7430070,14299,10218,2003,11961,2008,4081,2338,0.5,0.0,29,1.0,4,4,0,2338.0,0.28229042887687683,0.04020143300294876
8963057,6637642,7705572,14299,10162,2003,12535,2010,4137,1764,0.3333333333333333,0.0,20,2.0,13,4,0,1372.0,0.38571274280548096,0.20173005759716034
8965413,7356635,4179959,14299,11786,2008,1454,1979,2513,12845,0.0,0.0,9,4.0,3,1,168,735.0,0.4120014011859894,0.09673992544412613
8961313,5889672,4289829,14299,8489,1999,2084,1981,5810,12215,0.0,0.0,208,7.0,9,4,35,4564.0,0.5932508111000061,0.1518705040216446
8961550,6635054,5358288,14299,10155,2003,6872,1994,4144,7427,1.0,0.0,149,3.0,86,5,0,679.0,0.1741267591714859,0.14150476455688477
8959837,5339881,5180817,14299,6809,1994,6228,1993,7490,8071,0.5,0.0,30,4.0,1,3,49,5614.0,0.5342819690704346,0.09624101221561432
8966024,7856549,8676976,14299,12773,2010,13956,2014,1526,343,0.5,0.5,57,1.0,1,2,0,343.0,0.5015920996665955,0.39541879296302795
8963687,7062239,4513675,14299,11121,2006,3407,1985,3178,10892,0.3333333333333333,0.0,2,2.0,13,3,917,9912.0,0.5085992217063904,0.1281147003173828
8961560,5480403,4714862,14299,7306,1996,4373,1987,6993,9926,1.0,0.0,303,7.0,46,2,7,2548.0,0.541054368019104,0.20165427029132843
8961458,6950708,5164600,14299,10862,2005,6165,1992,3437,8134,1.0,0.0,333,8.0,61,9,21,21.0,0.34581273794174194,0.28675323724746704
8960322,5443125,4158617,14299,7173,1995,1265,1979,7126,13034,1.0,0.0,26,15.0,5,3,70,5754.0,0.7106553316116333,0.14658576250076294
8969287,8401800,7588444,14306,13592,2013,12311,2009,714,1995,0.4,0.0,2,1.0,70,2,364,1995.0,0.6074082851409912,0.036470621824264526
8971587,8345981,4345055,14306,13515,2013,2420,1982,791,11886,0.5,0.0,8,16.0,2,4,14,1449.0,0.35272759199142456,0.057064417749643326
8970584,7697010,7185883,14306,12521,2010,11387,2007,1785,2919,0.5,0.0,1,10.0,12,11,1785,301.0,0.29957595467567444,0.24271231889724731
8972188,7496447,4461208,14306,12108,2009,3127,1984,2198,11179,0.3333333333333333,0.0,5,6.0,6,2,406,6832.0,0.4721321761608124,0.10604642331600189
8966826,7011349,5449571,14306,11030,2006,7194,1995,3276,7112,0.5,0.0,6,23.0,18,3,616,196.0,0.7575618624687195,0.29471978545188904
8971222,5021777,4383281,14306,5633,1991,2686,1983,8673,11620,1.0,0.0,30,3.0,8,5,63,8925.0,0.4439852833747864,0.15951766073703766
8972834,7237174,7818555,14306,11499,2007,12710,2010,2807,1596,0.5,0.0,11,1.0,3,4,112,1596.0,0.7632085084915161,0.24649617075920105
8969883,5959401,8202334,14306,8671,1999,13319,2012,5635,987,1.0,0.0,60,3.0,3,1,70,98.0,0.4762051999568939,0.21126814186573029
8967588,6860462,4299214,14306,10652,2005,2140,1981,3654,12166,0.5,0.0,3,8.0,3,3,1127,406.0,0.49328187108039856,0.4218498766422272
8972179,5557254,8197480,14306,7565,1996,13312,2012,6741,994,0.0,0.0,266,2.0,30,34,21,161.0,0.41682180762290955,-0.023868907243013382
8966901,7516619,5778722,14306,12157,2009,8230,1998,2149,6076,1.0,0.0,13,9.0,13,5,126,259.0,0.5806090235710144,0.1605716049671173
8976446,7633673,3986923,14313,12402,2009,292,1976,1911,14021,0.5,0.0,7,4.0,77,1,7,455.0,0.21686838567256927,0.13424396514892578
8976471,6373647,7398299,14313,9602,2002,11877,2008,4711,2436,0.5,0.0,8,3.0,2,28,1036,1470.0,0.18001949787139893,0.2619181275367737
8977593,8060714,6542857,14313,13102,2011,9952,2003,1211,4361,1.0,0.0,7,4.0,22,31,28,546.0,0.5238996744155884,0.23499031364917755
8975688,6639272,5215771,14313,10162,2003,6361,1993,4151,7952,1.0,0.0,13,7.0,6,6,14,819.0,0.40349096059799194,0.1268417090177536
8974386,7024236,5328469,14313,11051,2006,6767,1994,3262,7546,1.0,1.0,247,38.0,36,13,14,21.0,0.5821753144264221,0.36902424693107605
8977393,6480761,4187040,14313,9812,2002,1496,1980,4501,12817,0.0,0.0,21,9.0,3,2,210,476.0,0.5540679097175598,0.04485025256872177
8974412,5569188,5346883,14313,7607,1996,6830,1994,6706,7483,1.0,0.0,75,3.0,18,2,70,3031.0,0.5202747583389282,0.19276486337184906
8974317,5348302,4411804,14313,6837,1994,2854,1983,7476,11459,1.0,0.0,25,4.0,11,4,133,2016.0,0.7178171277046204,0.1654948890209198
8975745,6046496,4547458,14313,8860,2000,3575,1985,5453,10738,1.0,0.0,89,11.0,7,6,140,7098.0,0.446858286857605,0.24706369638442993
8974150,5256004,5452965,14313,6508,1993,7208,1995,7805,7105,0.5,0.0,16,11.0,1,8,21,994.0,0.5160347819328308,0.3093869388103485
re45426,6613059,4420051,14320,10106,2003,2903,1983,4214,11417,1.0,0.0,211,22.0,143,4,14,147.0,0.6254962086677551,0.12880435585975647
8983242,7039315,6334544,14320,11079,2006,9497,2002,3241,4823,0.3333333333333333,0.0,8,4.0,11,1,805,434.0,0.4050624966621399,0.14459578692913055
8978820,7351155,4359133,14320,11779,2008,2511,1982,2541,11809,0.0,0.0,2,3.0,8,1,441,154.0,0.42855334281921387,0.3365646004676819
8984500,6253125,7565958,14320,9308,2001,12262,2009,5012,2058,0.0,0.0,5,3.0,2,3,259,1652.0,0.27259597182273865,0.14439520239830017
8978437,4422318,5091505,14320,2917,1983,5899,1992,11403,8421,1.0,0.0,10,2.0,2,9,672,1316.0,0.36898940801620483,0.09725992381572723
8980857,6861514,4385166,14320,10652,2005,2700,1983,3668,11620,0.0,0.0,21,4.0,177,2,0,6419.0,0.31717556715011597,0.09719555824995041
8978903,8556092,7465101,14320,13802,2013,12038,2008,518,2282,0.3333333333333333,0.0,2,2.0,19,2,14,1407.0,0.4729652404785156,0.317600816488266
8978985,7130047,4213511,14320,11261,2006,1664,1980,3059,12656,0.0,0.0,11,2.0,3,3,14,1050.0,0.3561074137687683,0.271976113319397
8981457,5751012,5776391,14320,8167,1998,8223,1998,6153,6097,0.5,0.0,487,8.0,29,8,0,3059.0,0.41037020087242126,0.4519360065460205
8979827,7637410,4101098,14320,12416,2009,929,1978,1904,13391,1.0,0.0,25,3.0,282,1,49,1379.0,0.6985505223274231,0.22273419797420502
8983860,7529836,4568765,14320,12178,2009,3687,1986,2142,10633,0.5,0.0,10,2.0,8,2,21,8386.0,0.38359373807907104,0.13010495901107788
8978954,7926691,7578370,14320,12892,2011,12290,2009,1428,2030,1.0,0.0,28,1.0,58,2,7,2030.0,0.707535982131958,0.36030179262161255
8984096,7512943,5910462,14320,12143,2009,8559,1999,2177,5761,0.5,0.0,8,6.0,5,8,301,1960.0,0.43386703729629517,0.05820198729634285
8980297,7223283,6688710,14320,11471,2007,10267,2004,2849,4053,1.0,0.0,23,4.0,12,11,28,973.0,0.3104208707809448,0.2094978541135788
8979838,7393351,6250054,14320,11870,2008,9308,2001,2450,5012,1.0,0.0,63,8.0,343,3,35,973.0,0.5013501048088074,0.17808036506175995
8978196,5446356,7886359,14320,7180,1995,12822,2011,7140,1498,0.0,0.2,133,16.0,10,58,14,42.0,0.47395753860473633,0.2039874643087387
8983732,5296837,4325269,14320,6655,1994,2301,1982,7665,12019,0.0,0.0,30,5.0,3,1,287,3661.0,0.17577442526817322,0.14525951445102692
8984298,8225083,4360620,14320,13347,2012,2518,1982,973,11802,0.5,0.0,1,9.0,20,2,973,357.0,0.34245508909225464,0.07236006110906601
8988263,8009072,5147228,14327,13025,2011,6102,1992,1302,8225,1.0,0.0,5,17.0,16,4,70,21.0,0.5053378939628601,0.1305541843175888
8984733,5499995,4969007,14327,7383,1996,5423,1990,6944,8904,1.0,0.0,138,5.0,18,13,14,5201.0,0.3523079752922058,0.22865533828735352
8985098,5305743,7201402,14327,6690,1994,11422,2007,7637,2905,1.0,0.0,77,4.0,2,13,245,126.0,0.3101079761981964,0.07252783328294754
8987898,6268656,7780152,14327,9343,2001,12654,2010,4984,1673,1.0,0.0,3,12.0,15,19,3794,70.0,0.5739104747772217,0.17421908676624298
8987713,5898185,7900679,14327,8517,1999,12850,2011,5810,1477,0.5,0.0,75,2.0,1,2,42,784.0,0.45580539107322693,0.13389047980308533
8988810,8194340,4930569,14327,13305,2012,5269,1990,1022,9058,1.0,0.0,33,5.0,28,4,0,441.0,0.5559287071228027,0.21815526485443115
8986387,6893464,7844395,14327,10729,2005,12752,2010,3598,1575,1.0,0.0,81,6.0,9,14,56,413.0,0.5577430129051208,0.13741157948970795
8989715,6795710,8075362,14327,10491,2004,13130,2011,3836,1197,1.0,0.0,80,1.0,5,22,84,1197.0,0.40852853655815125,0.2378976047039032
8986607,6596542,4273422,14327,10064,2003,1993,1981,4263,12334,0.5,0.0,4,24.0,4,3,763,357.0,0.42247599363327026,0.2233583927154541
8987628,6330938,5280313,14327,9483,2001,6592,1994,4844,7735,0.0,0.0,14,17.0,4,7,21,266.0,0.29288914799690247,0.21284858882427216
8986584,6531230,5495356,14327,9931,2003,7362,1996,4396,6965,0.2,0.0,151,19.0,49,4,7,63.0,0.06676210463047028,0.2130071222782135
8987216,5783568,8671062,14327,8237,1998,13949,2014,6090,378,0.25,0.0,12,1.0,9,34,336,378.0,0.4148973524570465,0.12486746162176132
8987771,7352011,4321635,14327,11779,2008,2273,1982,2548,12054,1.0,0.0,69,47.0,5,4,35,49.0,0.43528062105178833,0.2637217938899994
8984915,4646446,8021484,14327,4079,1987,13046,2011,10248,1281,0.0,0.0,15,2.0,3,5,721,56.0,0.3109193444252014,0.2773909270763397
8992806,5527562,4068625,14334,7474,1996,747,1978,6860,13587,0.0,0.0,23,20.0,6,1,133,210.0,0.3727993965148926,0.24656493961811066
8997045,7886285,4310911,14334,12822,2011,2203,1982,1512,12131,1.0,0.0,4,6.0,8,8,133,9940.0,0.5206777453422546,0.0518055260181427
8996364,5719346,6699908,14334,8083,1998,10288,2004,6251,4046,1.0,0.0,21,4.0,5,115,14,21.0,0.39551475644111633,-0.020135190337896347
8991127,5797233,4942511,14334,8272,1998,5311,1990,6062,9023,1.0,0.0,47,27.0,6,5,21,7.0,0.220318004488945,-0.0010805446654558182
8996162,7499768,5539014,14334,12115,2009,7509,1996,2219,6825,0.5,0.0,20,17.0,299,9,273,4046.0,0.40166226029396057,0.14046499133110046
8992099,5617501,4902071,14334,7761,1997,5164,1990,6573,9170,0.3333333333333333,0.0,60,3.0,29,7,7,5586.0,0.3394449055194855,0.14631889760494232
8996175,8380348,3987216,14334,13564,2013,292,1976,770,14042,0.3333333333333333,0.0,6,6.0,8,1,0,8708.0,0.5016236901283264,0.036014754325151443
8996165,6590604,3979460,14334,10050,2003,250,1976,4284,14084,0.0,0.0,141,4.0,8,1,14,7924.0,0.4238851070404053,0.02319966070353985
8996787,6681307,7706194,14334,10246,2004,12535,2010,4088,1799,1.0,0.0,8,1.0,6,4,98,1799.0,0.434461772441864,0.48061898350715637
8992754,6824664,4525933,14334,10561,2004,3470,1985,3773,10864,0.2,0.0,39,14.0,17,1,28,105.0,0.4308636784553528,0.12180107831954956
8998339,8449037,6877146,14341,13662,2013,10687,2005,679,3654,1.0,0.0,2,8.0,262,129,91,273.0,0.5971938967704773,0.1377304345369339
8998898,5160334,4622300,14341,6151,1992,3967,1986,8190,10374,1.0,0.0,209,4.0,4,4,35,3171.0,0.4501180946826935,0.4053729474544525
8999905,5458791,4209610,14341,7229,1995,1636,1980,7112,12705,1.0,0.0,6,23.0,12,1,581,4662.0,0.630115270614624,0.4016573429107666
9002764,5860073,5711649,14341,8412,1999,8062,1998,5929,6279,1.0,0.0,364,5.0,15,12,14,1953.0,0.255759060382843,0.11650951206684113
9003425,8046751,4772938,14341,13081,2011,4646,1988,1260,9695,1.0,0.0,12,15.0,3,11,0,2814.0,0.530743420124054,0.18819335103034973
9001467,6687977,5456323,14341,10267,2004,7222,1995,4074,7119,0.3333333333333333,0.0,24,8.0,6,8,0,371.0,0.4973071217536926,0.19948089122772217
9002277,8249606,4942981,14341,13382,2012,5318,1990,959,9023,1.0,0.0,9,4.0,6,3,63,119.0,0.4564911127090454,0.14736592769622803
9002680,6785579,5387079,14341,10470,2004,6977,1995,3871,7364,0.0,0.0,26,5.0,4,3,56,4046.0,0.45726022124290466,0.2232406884431839
9000127,5223409,6862730,14341,6389,1993,10652,2005,7952,3689,0.0,0.0,1135,11.0,19,24,0,490.0,0.3420686423778534,0.1303648203611374
9003374,5720026,4078896,14341,8083,1998,803,1978,6258,13538,1.0,0.0,117,6.0,7,1,0,3395.0,0.28120526671409607,0.09049250930547714
8997475,6913447,5199988,14341,10778,2005,6305,1993,3563,8036,0.2,0.0,15,6.0,109,8,182,1141.0,0.45101791620254517,0.4726520776748657
9002754,8794566,4164236,14341,14096,2014,1321,1979,245,13020,0.0,0.0,3,4.0,7,1,7,5572.0,0.18840740621089935,0.2043996900320053
8997660,6761398,5225561,14341,10421,2004,6396,1993,3920,7945,0.3333333333333333,0.0,10,39.0,24,26,462,259.0,0.5583400726318359,0.15504953265190125
9002680,7057551,4620797,14341,11114,2006,3960,1986,3227,10381,0.0,0.0,47,9.0,35,4,7,7042.0,0.37347662448883057,0.19130216538906097
9009072,6505093,5204621,14348,9868,2003,6319,1993,4480,8029,1.0,0.0,95,31.0,18,4,56,224.0,0.4180790185928345,0.22858741879463196
9005551,5795547,7692095,14348,8265,1998,12514,2010,6083,1834,0.5,0.0,95,3.0,13,6,14,133.0,0.4078808128833771,0.38121694326400757
9003567,5687424,8424673,14348,7992,1997,13627,2013,6356,721,0.5,0.0,13,1.0,17,3,154,721.0,0.6666529774665833,0.224373459815979
9005614,5057313,7308839,14348,5766,1991,11674,2007,8582,2674,0.6666666666666666,0.0,123,5.0,2,12,21,413.0,0.5243026614189148,0.09434383362531662
9006563,6459032,7119771,14348,9770,2002,11240,2006,4578,3108,1.0,0.0,53,3.0,33,19,14,1015.0,0.7089550495147705,0.2742001712322235
9009358,6415349,4857963,14348,9679,2002,4975,1989,4669,9373,1.0,0.0,59,11.0,5,7,7,2499.0,0.40420615673065186,0.26846417784690857
9006222,7485666,4173387,14348,12087,2009,1405,1979,2261,12943,1.0,0.0,18,34.0,54,3,21,266.0,0.24351485073566437,0.053969986736774445
9008006,6628946,5032566,14348,10134,2003,5675,1991,4214,8673,1.0,0.0,89,2.0,13,1,49,3325.0,0.3942171335220337,0.23081037402153015
9005015,7029395,8243560,14348,11065,2006,13375,2012,3283,973,0.0,0.0,217,2.0,42,3,0,504.0,0.38943737745285034,0.1818654090166092
9007879,8760822,4638618,14348,14054,2014,4044,1987,294,10304,1.0,0.0,18,22.0,97,3,0,287.0,0.3611564040184021,0.31552326679229736
9004131,7297374,6289291,14348,11646,2007,9385,2001,2702,4963,0.1111111111111111,0.0,5,2.0,20,3,98,3703.0,0.30124345421791077,-0.01230089645832777
9005230,7090673,6543220,14348,11184,2006,9959,2003,3164,4389,0.5,0.0,337,16.0,253,11,0,7.0,0.6281653642654419,0.2587851881980896
9012794,7811160,4006256,14355,12703,2010,397,1977,1652,13958,0.0,0.0,2,17.0,9,1,1309,3493.0,0.3418905436992645,0.10822010785341263
9010458,8172006,5437128,14355,13277,2012,7152,1995,1078,7203,0.25,0.0,2,5.0,27,6,266,2009.0,0.4323371648788452,0.21959596872329712
9011332,6648821,6822774,14355,10183,2003,10554,2004,4172,3801,0.5,0.0,555,2.0,19,8,0,602.0,0.45220237970352173,0.36342689394950867
9012477,7063859,4666450,14355,11128,2006,4156,1987,3227,10199,1.0,1.0,8,9.0,41,2,70,392.0,0.43152037262916565,0.13431227207183838
9011248,5746602,6975279,14355,8160,1998,10939,2005,6195,3416,0.3333333333333333,0.0,174,4.0,3,17,56,833.0,0.4489802420139313,0.1452208310365677
9011032,7594293,5901169,14355,12325,2009,8524,1999,2030,5831,0.3333333333333333,0.0,5,14.0,93,8,182,1596.0,0.38427382707595825,0.14951467514038086
9015264,7383250,4384315,14355,11842,2008,2693,1983,2513,11662,0.5,0.0,26,4.0,2,2,0,6069.0,0.3198886215686798,0.26588067412376404
9015742,6542620,4550880,14355,9952,2003,3596,1985,4403,10759,0.5,0.0,110,6.0,333,6,231,2275.0,0.42440152168273926,0.3675795793533325
9011044,6371696,5611455,14355,9602,2002,7747,1997,4753,6608,0.5,0.0,4,6.0,5,4,203,2443.0,0.2827257513999939,0.27080944180488586
9020591,5993414,6139578,14362,8734,1999,9070,2000,5628,5292,1.0,1.0,63,11.0,5,51,7,21.0,0.15011171996593475,0.10598158091306686
9020573,5282950,4313221,14362,6606,1994,2217,1982,7756,12145,0.0,0.0,343,6.0,2,3,0,4480.0,0.4712922275066376,0.1301475316286087
9017791,6156289,4998383,14362,9105,2000,5549,1991,5257,8813,0.3333333333333333,0.0,5,2.0,2,2,1050,3178.0,0.2778632342815399,0.08982513844966888
9015876,8347906,4800309,14362,13522,2013,4772,1989,840,9590,0.0,0.0,5,28.0,16,4,0,1743.0,0.38811028003692627,0.27180391550064087
9020888,6581108,6376857,14362,10029,2003,9609,2002,4333,4753,1.0,0.0,30,26.0,8,7,91,175.0,0.3935728669166565,0.15941689908504486
9017623,6717136,7668262,14362,10323,2004,12472,2010,4039,1890,0.5,0.0,71,11.0,22,14,7,28.0,0.43156078457832336,0.04442081227898598
9021015,7386542,7288017,14362,11849,2008,11625,2007,2513,2737,0.5,0.0,42,4.0,26,3,14,1099.0,0.2833559215068817,0.29730844497680664
9017854,5714089,4348964,14362,8069,1998,2448,1982,6293,11914,0.0,0.0,37,5.0,26,2,14,5285.0,0.09081846475601196,0.2439679652452469
9019143,7545338,4660855,14362,12213,2009,4135,1987,2149,10227,0.5,0.0,2,11.0,9,2,1099,322.0,0.2623482644557953,0.260788232088089
9018445,6094198,5293707,14362,8972,2000,6648,1994,5390,7714,0.0,0.0,30,11.0,5,7,7,14.0,0.1688244789838791,0.08723282814025879
9017399,7967857,7308956,14362,12962,2011,11674,2007,1400,2688,1.0,0.0,4,1.0,346,2,28,2688.0,0.6775104403495789,0.26429516077041626
9026199,5879313,5534111,14369,8468,1999,7495,1996,5901,6874,1.0,0.0,27,11.0,11,4,28,49.0,0.31209033727645874,0.13870978355407715
9026232,6349883,4172250,14369,9553,2002,1391,1979,4816,12978,0.2,0.25,126,8.0,5,1,0,5173.0,0.4763079285621643,0.06995664536952972
9023619,8158756,5090539,14369,13256,2012,5899,1992,1113,8470,0.5,0.0,1,11.0,16,6,1113,1022.0,0.3669889271259308,0.1386967897415161
9023714,6403485,4781655,14369,9658,2002,4688,1988,4711,9681,1.0,0.0,22,11.0,11,2,154,2884.0,0.3588537871837616,0.04968677833676338
9024906,7292229,7046550,14369,11632,2007,11093,2006,2737,3276,1.0,0.0,72,11.0,21,5,7,42.0,0.3517395853996277,0.13083340227603912
9023016,6314311,4254784,14369,9441,2001,1895,1981,4928,12474,1.0,0.0,23,8.0,11,4,231,2604.0,0.5203360319137573,0.34106630086898804
9024884,6323846,5796460,14369,9462,2001,8265,1998,4907,6104,0.3333333333333333,0.0,965,8.0,22,1,7,2268.0,0.5012797713279724,0.21885153651237488
9023136,5613841,5387254,14369,7754,1997,6977,1995,6615,7392,0.0,0.25,66,3.0,6,2,0,2968.0,0.2812143862247467,0.4329756796360016
9031880,6766952,6865839,14376,10435,2004,10666,2005,3941,3710,1.0,0.0,78,5.0,27,12,7,903.0,0.3511728048324585,0.2607549726963043
9031581,6912230,4307971,14376,10771,2005,2189,1981,3605,12187,1.0,0.0,70,21.0,40,1,56,6377.0,0.46241307258605957,0.06888935714960098
9028453,6796967,4090626,14376,10498,2004,873,1978,3878,13503,1.0,0.0,31,26.0,27,1,0,602.0,0.5873990058898926,0.39750921726226807
9029418,6479079,4945326,14376,9812,2002,5325,1990,4564,9051,1.0,0.0,35,5.0,24,3,77,2660.0,0.6064605116844177,0.06349213421344757
9030913,6434084,4690383,14376,9721,2002,4261,1987,4655,10115,0.0,0.0,18,18.0,17,2,336,98.0,0.5133477449417114,0.2161921262741089
9028632,4888231,5127707,14376,5101,1989,6032,1992,9275,8344,1.0,0.0,341,8.0,11,6,14,1939.0,0.3618173599243164,0.29103726148605347
9031741,7287507,8193296,14376,11625,2007,13305,2012,2751,1071,0.3333333333333333,0.0,2,3.0,2,17,147,49.0,0.4451085329055786,-0.011049331165850163
9034659,7618680,5871421,14383,12374,2009,8447,1999,2009,5936,0.0,0.0,2,20.0,2,22,1729,357.0,0.2283741980791092,0.06753667443990707
9035772,6300903,4198167,14383,9413,2001,1566,1980,4970,12817,0.0,0.0,183,3.0,37,1,7,2618.0,0.3470558524131775,0.08989645540714264
9035141,6972353,7342220,14383,10932,2005,11758,2008,3451,2625,0.25,0.0,576,2.0,5,2,0,1218.0,0.7665736675262451,0.18311229348182678
9037285,6497342,7931773,14383,9854,2002,12899,2011,4529,1484,0.25,0.0,54,2.0,21,28,63,301.0,0.5413828492164612,0.25056758522987366
9033225,8656458,6029801,14383,13928,2014,8825,2000,455,5558,0.5,0.0,1,10.0,4,2,455,231.0,0.7919566631317139,0.1122475415468216
9037942,8225167,4307516,14383,13347,2012,2189,1981,1036,12194,1.0,0.0,2,14.0,7,1,119,196.0,0.6404489874839783,0.12126225978136063
9036499,6400681,5611105,14383,9651,2002,7747,1997,4732,6636,1.0,0.0,231,9.0,74,5,28,217.0,0.49348217248916626,0.0378100723028183
9037903,5889935,5505439,14383,8489,1999,7404,1996,5894,6979,1.0,0.0,153,10.0,97,5,21,1442.0,0.4151804447174072,0.42463409900665283
9034489,5204219,6035806,14383,6319,1993,8839,2000,8064,5544,0.0,0.0,56,16.0,26,16,84,245.0,0.5027981996536255,0.3209279775619507
9037736,7349371,4258803,14383,11772,2008,1916,1981,2611,12467,0.5,0.0,51,14.0,15,1,0,350.0,0.3067454993724823,0.1719895750284195
9041391,7054085,5030988,14390,11107,2006,5668,1991,3283,8722,0.0,0.0,4,20.0,5,2,1253,2184.0,0.20737908780574799,0.0987057238817215
9042702,5790741,4777070,14390,8251,1998,4667,1988,6139,9723,1.0,0.0,65,6.0,8,5,0,5502.0,0.498090922832489,0.13890548050403595
9039997,7368163,7739909,14390,11814,2008,12591,2010,2576,1799,0.0,0.5,61,5.0,58,5,70,70.0,0.2915187478065491,0.280081182718277
9038507,6584875,4630604,14390,10043,2003,4009,1986,4347,10381,1.0,0.0,10,41.0,6,1,35,14.0,0.6081154346466064,0.11608036607503891
9040598,8334327,4229255,14390,13501,2012,1755,1980,889,12635,0.25,0.0,5,4.0,111,2,70,7735.0,0.39013049006462097,0.18067248165607452
9039681,4883400,4972597,14390,5080,1989,5444,1990,9310,8946,0.0,0.0,78,12.0,3,8,35,3087.0,0.35513636469841003,0.25353261828422546
9039556,6176803,4679338,14390,9154,2001,4212,1987,5236,10178,0.3333333333333333,0.0,220,4.0,10,1,56,238.0,0.4979870915412903,0.33325904607772827
9042174,7209392,5661574,14390,11436,2007,7908,1997,2954,6482,0.5,0.0,14,4.0,6,8,98,455.0,0.7386506795883179,0.2862769067287445
9038693,6924730,5937961,14390,10806,2005,8629,1999,3584,5761,0.0,0.0,2,10.0,19,7,3178,14.0,0.48619407415390015,0.22217068076133728
9042684,7426321,4495190,14390,11947,2008,3309,1985,2443,11081,1.0,0.0,1,31.0,4,3,2443,1232.0,0.6876350045204163,0.11126299947500229
9042052,7211339,4304552,14390,11443,2007,2168,1981,2947,12222,1.0,0.0,29,6.0,7,1,0,5299.0,0.39625459909439087,0.21624742448329926
9040865,5300751,4488762,14390,6669,1994,3274,1984,7721,11116,0.3333333333333333,0.0,4,2.0,2,4,4389,1876.0,0.4363003075122833,0.08467307686805725
9043113,4873638,6050155,14390,5031,1989,8874,2000,9359,5516,0.3333333333333333,0.0,20,5.0,24,2,203,469.0,0.6772873401641846,0.37286072969436646
9049697,7305250,8027941,14397,11660,2007,13053,2011,2737,1344,1.0,0.0,5,6.0,7,11,196,42.0,0.5218517184257507,0.2121197134256363
9045243,7131645,7900265,14397,11268,2006,12843,2011,3129,1554,0.5,0.0,3,4.0,13,4,266,315.0,0.38916024565696716,0.22501429915428162
9044667,4222561,6880692,14397,1720,1980,10701,2005,12677,3696,1.0,0.0,27,18.0,1,223,49,49.0,0.5329903960227966,0.19895979762077332
9044161,8936551,4466732,14397,14264,2015,3155,1984,133,11242,1.0,0.0,1,10.0,31,3,133,5124.0,1.0,0.29241037368774414
9047542,5340628,6305307,14397,6809,1994,9427,2001,7588,4970,0.0,0.0,17,27.0,5,4,182,112.0,0.28604090213775635,0.13409872353076935
9044317,4764423,6553321,14397,4611,1988,9973,2003,9786,4424,0.0,0.0,13,8.0,4,10,63,301.0,0.015574553050100803,0.03357824683189392
9044083,7109431,8691952,14397,11219,2006,13977,2014,3178,420,0.0,0.0,11,2.0,4,56,42,105.0,0.25926172733306885,0.11222238093614578
9045538,5859205,7756294,14397,8412,1999,12612,2010,5985,1785,0.3333333333333333,0.0,326,1.0,1,1,7,1785.0,0.4750109314918518,0.0488915778696537
9047512,6570386,8691935,14397,10008,2003,13977,2014,4389,420,0.0,0.0,34,1.0,10,3,21,420.0,0.29547619819641113,0.18907982110977173
9053640,5159452,6210356,14404,6144,1992,9224,2001,8260,5180,0.0,0.0,153,27.0,7,63,287,7.0,0.08710335195064545,0.1409711390733719
9052217,6886401,4466502,14404,10715,2005,3155,1984,3689,11249,1.0,0.0,19,13.0,5,1,56,63.0,0.3357999920845032,0.31083816289901733
9051835,6372993,7534463,14404,9602,2002,12192,2009,4802,2212,0.0,0.0,22,1.0,13,12,133,2212.0,0.5315285325050354,0.04389750584959984
9055332,7321384,4059138,14404,11709,2008,691,1977,2695,13713,1.0,0.0,27,4.0,2,1,14,973.0,0.27387869358062744,0.1586160808801651
9050411,6620120,4056766,14404,10120,2003,670,1977,4284,13734,0.3333333333333333,0.0,24,6.0,7,1,14,1253.0,0.42994388937950134,0.2631334364414215
9050078,6368326,8671985,14404,9595,2002,13956,2014,4809,448,1.0,0.0,142,1.0,35,212,7,448.0,0.4177228808403015,0.17836923897266388
9050090,6319272,6151230,14404,9455,2001,9091,2000,4949,5313,1.0,0.0,48,5.0,168,10,42,2401.0,0.4225137531757355,0.2972220778465271
9055943,8186587,5163425,14411,13298,2012,6165,1992,1113,8246,0.0,1.0,7,23.0,14,9,28,406.0,0.22906313836574554,0.30947360396385193
9057773,7515088,5017431,14411,12150,2009,5619,1991,2261,8792,1.0,0.0,22,2.0,41,1,49,917.0,0.678605318069458,0.23797035217285156
9059032,7486543,4982110,14411,12087,2009,5479,1991,2324,8932,1.0,0.3333333333333333,3,29.0,2,6,336,1631.0,0.6771581768989563,0.4012225866317749
9056155,6011125,4052251,14411,8769,2000,642,1977,5642,13769,0.5,0.0,138,9.0,10,1,35,2352.0,0.22148092091083527,0.21081005036830902
9055933,5860990,4657040,14411,8419,1999,4121,1987,5992,10290,1.0,0.0,183,9.0,9,2,14,602.0,0.6243909001350403,0.3280651569366455
9058909,4961214,6928161,14411,5388,1990,10813,2005,9023,3598,0.0,0.0,18,9.0,1,3,77,742.0,0.40161433815956116,0.04489915072917938
9059891,5822434,5373910,14411,8321,1998,6928,1994,6090,7483,0.5,0.0,95,16.0,7,18,14,140.0,0.3333079218864441,0.1162024512887001
9056193,6042552,4062961,14411,8853,2000,712,1977,5558,13699,1.0,1.0,26,2.0,8,1,7,12502.0,0.6092302799224854,0.05912836641073227
9061102,8192698,6164711,14418,13305,2012,9126,2000,1113,5292,0.0,0.0,4,11.0,48,2,21,1239.0,0.18301451206207275,0.18814139068126678
9063623,5917165,4101617,14418,8580,1999,929,1978,5838,13489,0.3333333333333333,0.0,90,12.0,9,1,21,1176.0,0.5149567723274231,0.08800865709781647
9061867,6439407,6814504,14418,9735,2002,10540,2004,4683,3878,1.0,0.0,9,4.0,15,11,455,630.0,0.5606182217597961,0.12615573406219482
9060594,5341088,5024680,14418,6809,1994,5647,1991,7609,8771,0.2,0.0,36,21.0,2,4,7,63.0,0.4140332043170929,0.1989724338054657
9063349,5521765,6837891,14418,7453,1996,10596,2005,6965,3822,0.25,0.5,52,15.0,8,65,63,42.0,0.36639097332954407,0.11646199971437454
9065731,6687632,7680080,14418,10260,2004,12493,2010,4158,1925,0.5,0.5,17,2.0,21,10,28,476.0,0.4299783408641815,0.30046263337135315
9060770,5580067,4442700,14418,7642,1996,3029,1984,6776,11389,1.0,0.0,348,5.0,7,1,7,3934.0,0.7109386920928955,0.16653795540332794
9061580,8580064,5631151,14418,13830,2013,7810,1997,588,6608,0.0,0.0,2,3.0,3,1,434,462.0,0.49136626720428467,0.07471069693565369
9066092,8438601,5661090,14418,13641,2013,7908,1997,777,6510,0.25,0.0,8,7.0,344,9,21,3157.0,0.5563387870788574,0.16954202950000763
9062183,6388049,6125889,14418,9630,2002,9042,2000,4788,5376,0.5,0.0,12,6.0,4,6,70,266.0,0.37287721037864685,0.19783535599708557
9064858,7405484,4027773,14418,11898,2008,523,1977,2520,13895,1.0,0.0,50,9.0,8,1,14,763.0,0.2415800541639328,0.15715104341506958
9067383,6455615,7414488,14425,9763,2002,11919,2008,4662,2506,0.0,0.0,9,4.0,4,4,259,294.0,0.5515272617340088,0.1074313297867775
9066697,4469110,6323906,14425,3169,1984,9462,2001,11256,4963,1.0,0.0,459,5.0,2,5,0,1932.0,0.19141682982444763,0.3675997853279114
9068360,8544234,5720208,14425,13788,2013,8090,1998,637,6335,0.5,0.0,10,1.0,117,1,21,6335.0,0.8249115943908691,0.22971898317337036
9066650,8634942,4318986,14425,13900,2014,2259,1982,525,12166,0.4,0.0,1,9.0,5,4,525,3815.0,0.4347784221172333,0.13960281014442444
9066747,5411481,5181658,14425,7061,1995,6235,1993,7364,8190,1.0,0.0,198,7.0,12,6,7,1848.0,0.36193495988845825,0.29735642671585083
9066697,6750311,5260133,14425,10393,2004,6522,1993,4032,7903,0.0,0.0,116,2.0,41,7,0,5936.0,0.48926424980163574,0.08820836246013641
9070935,6627346,4528987,14425,10134,2003,3484,1985,4291,10941,1.0,0.0,12,32.0,6,9,84,175.0,0.3600679934024811,0.3425576686859131
9069519,8362696,6222713,14425,13543,2013,9245,2001,882,5180,0.2,0.3333333333333333,6,3.0,3,7,28,280.0,0.5813779234886169,0.20419232547283173
9068171,6490824,5793283,14425,9840,2002,8258,1998,4585,6167,0.0,0.0,1,6.0,7,7,4585,56.0,0.6159548163414001,0.15613031387329102
9072133,7161311,4154536,14425,11331,2007,1230,1979,3094,13195,0.3333333333333333,0.0,153,12.0,335,2,7,952.0,0.5646424293518066,0.08863964676856995
9066550,7246384,6422360,14425,11527,2007,9700,2002,2898,4725,0.5,0.0,7,3.0,34,2,238,1939.0,0.3962849974632263,0.12980957329273224
9072191,7821792,6175724,14425,12717,2010,9147,2001,1708,5278,0.5,0.0,8,2.0,15,13,399,4396.0,0.3402038812637329,0.1883450746536255
9068207,8932835,7117139,14425,14257,2015,11233,2006,168,3192,1.0,0.0,1,5.0,5,4,168,1484.0,0.6244983077049255,0.1346542239189148
9076601,7688076,6787211,14432,12507,2010,10477,2004,1925,3955,0.5,0.0,3,5.0,4,5,994,1232.0,0.47266367077827454,0.32977455854415894
9073236,5381602,6170166,14432,6956,1995,9140,2001,7476,5292,0.2,0.0,16,4.0,3,23,35,875.0,0.5328486561775208,0.11229364573955536
9077694,5204961,8120215,14432,6319,1993,13200,2012,8113,1232,0.5,0.0,247,3.0,5,39,49,329.0,0.40920111536979675,0.18020448088645935
9078116,7187952,5530361,14432,11387,2007,7481,1996,3045,6951,1.0,0.0,9,3.0,7,8,112,3171.0,0.3058660626411438,0.1977330446243286
9073741,7036895,4883030,14432,11079,2006,5080,1989,3353,9352,0.0,0.0,3,8.0,3,8,1190,182.0,0.18205441534519196,0.07595750689506531
9072623,5824040,5965262,14432,8328,1998,8685,1999,6104,5747,1.0,0.0,372,16.0,45,14,21,105.0,0.31654515862464905,0.2649863362312317
9076825,7064346,5422568,14432,11128,2006,7096,1995,3304,7336,1.0,0.0,1113,12.0,7,2,0,140.0,0.41438567638397217,0.2160460501909256
9075413,8204670,7524485,14432,13319,2012,12171,2009,1113,2261,0.0,0.0,8,1.0,16,6,308,2261.0,0.3773268163204193,0.0012374540092423558
9072515,5680983,4317862,14432,7971,1997,2252,1982,6461,12180,1.0,0.0,225,3.0,77,6,14,3542.0,0.42620036005973816,0.15898655354976654
9076523,8117508,8640441,14432,13193,2012,13914,2014,1239,518,0.0,0.0,4,1.0,11,2,161,518.0,0.3196296691894531,-0.04431770369410515
9073236,6748987,5445002,14432,10393,2004,7180,1995,4039,7252,0.2,0.0,13,15.0,7,9,35,203.0,0.39761823415756226,0.21819299459457397
9082829,6288454,5608189,14439,9385,2001,7733,1997,5054,6706,0.5,0.0,152,5.0,18,7,7,2604.0,0.40429165959358215,0.1997496634721756
9079905,7687469,7337206,14439,12507,2010,11744,2008,1932,2695,1.0,0.0,19,5.0,15,5,70,182.0,0.5145615339279175,0.049532126635313034
9078792,6258308,5907409,14439,9322,2001,8545,1999,5117,5894,0.0,0.0,63,2.0,217,5,0,4018.0,0.3242622911930084,0.203444704413414
9083743,7991910,6648033,14439,12997,2011,10183,2003,1442,4256,0.5,0.0,70,6.0,70,8,0,476.0,0.8267208337783813,0.06107109412550926
9079004,7862546,4051127,14439,12787,2011,635,1977,1652,13804,1.0,0.0,75,3.0,145,1,0,6503.0,0.4650103747844696,0.13183657824993134
9083829,5978838,6889435,14439,8706,1999,10722,2005,5733,3717,0.16666666666666666,0.0,164,5.0,13,11,21,1323.0,0.2996673285961151,0.15515530109405518
9083788,6597669,6278514,14439,10064,2003,9364,2001,4375,5075,1.0,0.0,13,25.0,4,11,616,553.0,0.48304465413093567,0.11267729848623276
9082892,7211832,4494156,14439,11443,2007,3302,1985,2996,11137,1.0,0.0,27,28.0,1,4,112,56.0,0.5000889897346497,0.19081246852874756
9080894,5298854,4376563,14439,6662,1994,2630,1983,7777,11809,0.3333333333333333,0.0,33,13.0,8,2,189,1162.0,0.16439056396484375,0.07967054098844528
9082257,6089978,7277665,14439,8965,2000,11597,2007,5474,2842,0.0,0.0,677,6.0,1,24,35,287.0,0.5351248979568481,0.16636405885219574
9078607,4899839,8548812,14439,5157,1990,13788,2013,9282,651,0.0,0.0,224,1.0,8,6,7,651.0,0.5228095054626465,0.3817104399204254
9082303,5126941,6378453,14439,6025,1992,9616,2002,8414,4823,0.0,0.0,130,9.0,11,6,14,1442.0,0.44096457958221436,0.267110139131546
9087733,7482229,5531290,14446,12080,2009,7488,1996,2366,6958,1.0,0.0,19,14.0,43,11,42,91.0,0.538718581199646,0.08028363436460495
9087180,6041362,8008344,14446,8846,2000,13025,2011,5600,1421,0.5,0.0,36,2.0,13,3,35,364.0,0.3153834640979767,0.100691057741642
9087429,7479063,5845531,14446,12073,2009,8377,1998,2373,6069,0.3333333333333333,0.0,35,4.0,39,16,35,826.0,0.35640278458595276,0.13850948214530945
9084683,7780731,4593522,14446,12654,2010,3813,1986,1792,10633,1.0,0.0,2,5.0,17,1,315,4109.0,0.6492606401443481,0.17997319996356964
9087882,7893524,5481764,14446,12836,2011,7313,1996,1610,7133,1.0,0.0,4,6.0,1,2,315,1197.0,0.33623963594436646,0.1941877007484436
9086802,7712053,8385218,14446,12542,2010,13571,2013,1904,875,0.25,0.0,57,2.0,149,2,0,588.0,0.23580721020698547,0.3029296100139618
9084671,5639441,6909111,14446,7838,1997,10764,2005,6608,3682,0.3333333333333333,0.0,118,25.0,25,4,14,119.0,0.1790059506893158,0.21745839715003967
9086564,5474865,7309797,14446,7285,1995,11674,2007,7161,2772,0.0,0.0,142,8.0,7,7,77,497.0,0.23654091358184814,0.12806475162506104
9086160,4966197,4600444,14446,5416,1990,3848,1986,9030,10598,1.0,0.0,11,21.0,2,5,217,28.0,0.6995639204978943,0.23469480872154236
9085131,6629496,6753048,14446,10141,2003,10400,2004,4305,4046,0.5,0.0,9,2.0,7,3,196,658.0,0.5092079043388367,0.4541420340538025
9084872,6565521,7578813,14446,10001,2003,12290,2009,4445,2156,1.0,1.0,12,2.0,6,11,84,1400.0,0.3921569287776947,0.3576493561267853
9084849,6743635,5280313,14446,10379,2004,6592,1994,4067,7854,0.0,1.0,378,17.0,54,7,7,385.0,0.2813095450401306,0.269925057888031
9084601,5242457,4531434,14446,6459,1993,3498,1985,7987,10948,1.0,0.0,474,11.0,7,2,0,861.0,0.3878360986709595,0.35530799627304077
9092930,6786824,4436455,14453,10477,2004,2994,1984,3976,11459,0.0,0.0,226,5.0,93,2,7,546.0,0.666170060634613,0.19680988788604736
9092130,7148499,4672334,14453,11303,2006,4177,1987,3150,10276,1.0,0.0,6,15.0,40,4,448,196.0,0.5168217420578003,0.3002673089504242
9091064,4900193,7889250,14453,5157,1990,12829,2011,9296,1624,0.0,0.0,8,5.0,5,4,42,280.0,0.5092985033988953,0.31220942735671997
9094805,8028073,4992064,14453,13053,2011,5521,1991,1400,8932,0.5,0.0,5,16.0,21,4,182,273.0,0.3582269847393036,0.10807918757200241
9091184,8079338,4695808,14453,13137,2011,4282,1987,1316,10171,1.0,0.0,3,14.0,4,1,329,1218.0,0.462870717048645,0.19237540662288666
9094406,8175651,5269339,14453,13277,2012,6557,1993,1176,7896,0.3333333333333333,0.0,4,4.0,7,16,98,637.0,0.36574023962020874,0.25725987553596497
9091516,4478150,4746347,14453,3218,1984,4527,1988,11235,9926,1.0,0.0,19,16.0,1,3,133,49.0,0.5099157691001892,0.1975919008255005
9095312,8333874,4443373,14460,13501,2012,3029,1984,959,11431,0.0,0.0,4,18.0,35,2,28,161.0,0.45996180176734924,0.23090031743049622
9098611,7624166,7256652,14460,12381,2009,11548,2007,2079,2912,0.5,0.0,24,4.0,4,6,7,1477.0,0.37349873781204224,0.17141295969486237
9098685,5841970,4288808,14460,8363,1998,2077,1981,6097,12383,1.0,0.0,117,13.0,4,1,203,3325.0,0.6070132255554199,0.07957642525434494
9095265,6076015,4010432,14460,8930,2000,425,1977,5530,14035,1.0,0.0,344,44.0,38,1,21,112.0,0.43520939350128174,0.03779925778508186
9098681,6662231,8687353,14460,10204,2003,13970,2014,4256,490,0.3333333333333333,0.4,292,2.0,13,9,7,140.0,0.4572879672050476,0.1398485153913498
9097891,8533485,5874783,14460,13767,2013,8454,1999,693,6006,0.0,0.0,5,8.0,11,10,0,2310.0,0.31458890438079834,0.30430832505226135
9098334,8180922,6058276,14460,13284,2012,8888,2000,1176,5572,1.0,0.0,9,4.0,18,5,35,4123.0,0.4881710410118103,0.2826904058456421
9099134,6449767,8398782,14460,9749,2002,13592,2013,4711,868,0.0,0.0,81,2.0,3,8,0,140.0,0.31192392110824585,0.2972029745578766
9100893,7373148,4542990,14460,11821,2008,3554,1985,2639,10906,1.0,0.0,27,6.0,8,1,35,3654.0,0.48747387528419495,0.01728222891688347
9095326,5526822,7076165,14460,7474,1996,11149,2006,6986,3311,1.0,0.0,491,2.0,44,4,0,2408.0,0.5632930994033813,0.17533938586711884
9099825,6733336,7405396,14460,10358,2004,11898,2008,4102,2562,1.0,1.0,115,5.0,33,37,14,392.0,0.3631249666213989,0.03182351589202881
9095347,6517539,4620301,14460,9903,2003,3953,1986,4557,10507,1.0,0.0,141,16.0,104,7,28,2289.0,0.3129989802837372,0.24446292221546173
9101978,6662886,4323081,14467,10211,2003,2287,1982,4256,12180,0.0,0.0,28,11.0,23,2,14,2254.0,0.17580555379390717,0.07090289890766144
9107030,4888796,6785713,14467,5101,1989,10470,2004,9366,3997,1.0,0.0,215,8.0,10,91,14,126.0,0.2916260361671448,0.4279872477054596
9103862,4864315,4995094,14467,4996,1989,5528,1991,9471,8939,0.3333333333333333,0.0,19,8.0,1,13,126,2037.0,0.4525415599346161,0.1270207017660141
9101353,5672176,4652826,14467,7943,1997,4100,1987,6524,10367,1.0,0.0,454,15.0,2,4,7,2366.0,0.29347914457321167,0.20447422564029694
9101808,7559850,4303572,14467,12248,2009,2161,1981,2219,12306,1.0,0.0,13,12.0,24,2,14,994.0,0.5747170448303223,0.22236838936805725
9106563,7733891,7972652,14467,12577,2010,12969,2011,1890,1498,1.0,0.0,12,1.0,23,7,7,1498.0,0.5958402156829834,0.08412985503673553
9102722,5580859,5265186,14467,7642,1996,6536,1993,6825,7931,0.25,0.0,580,10.0,7,8,0,1085.0,0.3563787043094635,0.04908797889947891
9106316,8755454,7708967,14467,14047,2014,12542,2010,420,1925,1.0,0.0,7,2.0,437,2,14,840.0,0.25330081582069397,-0.03344007954001427
9106473,8125931,6131671,14467,13207,2012,9056,2000,1260,5411,0.3333333333333333,0.0,7,9.0,213,12,126,161.0,0.8415759801864624,0.1995878368616104
9101404,7559942,4247536,14467,12248,2009,1853,1981,2219,12614,1.0,0.0,38,3.0,11,1,56,10192.0,0.3837308883666992,0.050590693950653076
9111422,6672959,4634010,14474,10232,2004,4023,1987,4242,10451,1.0,0.0,107,20.0,8,3,7,322.0,0.6863270998001099,0.21644476056098938
9108090,6299546,7342220,14474,9413,2001,11758,2008,5061,2716,1.0,0.0,12,2.0,8,2,7,1309.0,0.6239466071128845,0.1910007894039154
9112717,7146632,3978357,14474,11296,2006,243,1976,3178,14231,1.0,0.0,62,11.0,25,2,7,4501.0,0.3513898551464081,0.0883045345544815
9111908,8143663,4792965,14474,13235,2012,4737,1988,1239,9737,1.0,0.0,4,11.0,3,2,21,84.0,0.5333776473999023,0.24519695341587067
9110470,6728635,4534235,14474,10344,2004,3512,1985,4130,10962,0.25,0.0,73,4.0,3,5,14,1351.0,0.28379160165786743,0.1989130675792694
9108515,6687593,5223366,14474,10260,2004,6389,1993,4214,8085,0.0,0.0,26,2.0,8,7,56,364.0,0.6585549116134644,0.06562065333127975
9108790,5201414,4172063,14474,6312,1993,1391,1979,8162,13083,0.5,0.0,46,23.0,9,2,7,455.0,0.32941490411758423,0.21993927657604218
9108484,5342023,4576652,14474,6816,1994,3729,1986,7658,10745,1.0,0.0,16,16.0,7,6,21,7763.0,0.5638008117675781,-0.00045702047646045685
9108430,6091909,5921345,14474,8965,2000,8594,1999,5509,5880,0.14285714285714285,0.0,80,2.0,5,2,7,3878.0,0.7138124704360962,0.22184209525585175
9108922,4971957,7571240,14474,5437,1990,12269,2009,9037,2205,0.3333333333333333,0.0,21,1.0,1,3,497,2205.0,0.4982004165649414,0.04806661233305931
9107766,5836948,4878333,14474,8356,1998,5059,1989,6118,9415,1.0,0.0,590,7.0,32,5,0,1281.0,0.268867164850235,0.4025348424911499
9109261,6458540,5971226,14474,9770,2002,8699,1999,4704,5775,1.0,0.0,9,6.0,22,6,763,1309.0,0.4567314088344574,0.07150457799434662
9107574,6270477,4100150,14474,9350,2001,922,1978,5124,13552,0.3333333333333333,0.3333333333333333,134,4.0,55,1,7,1862.0,0.3512144982814789,0.08863623440265656
9108206,5375768,5573456,14474,6935,1994,7621,1996,7539,6853,1.0,0.0,47,4.0,6,5,35,952.0,0.6989802122116089,0.19865310192108154
9111604,4264782,6811140,14474,1944,1981,10533,2004,12530,3941,0.3333333333333333,0.0,147,9.0,3,9,231,98.0,0.3449653685092926,0.1230432540178299
9116513,6431344,5697900,14481,9721,2002,8020,1997,4760,6461,0.0,0.0,3,4.0,3,2,77,4333.0,0.4850185513496399,0.20551328361034393
9113847,5476206,6653912,14481,7292,1995,10190,2003,7189,4291,1.0,0.0,300,12.0,20,33,7,175.0,0.33599695563316345,0.12287178635597229
9114812,6973880,4417663,14481,10939,2005,2889,1983,3542,11592,1.0,0.0,52,11.0,40,1,77,749.0,0.38252556324005127,0.28303173184394836
9117246,6331825,4156551,14481,9483,2001,1244,1979,4998,13237,0.0,0.0,184,7.0,47,1,35,3822.0,0.2846106290817261,0.23275761306285858
9118958,5722041,4111493,14481,8090,1998,978,1978,6391,13503,0.5,0.0,187,23.0,3,1,0,49.0,0.3865588903427124,0.22592324018478394
9113961,4621627,4065080,14481,3967,1986,726,1977,10514,13755,1.0,0.0,89,10.0,5,1,42,1491.0,0.4380964934825897,0.22417518496513367
9116344,7729037,3987870,14481,12570,2010,299,1976,1911,14182,0.5,0.0,5,5.0,49,1,35,322.0,0.4360404312610626,0.23587411642074585
9118148,5211471,4216495,14481,6347,1993,1678,1980,8134,12803,0.5,0.0,19,3.0,7,3,133,8540.0,0.37600183486938477,0.07980768382549286
9114730,7644978,5729016,14481,12430,2010,8111,1998,2051,6370,0.5,0.0,11,28.0,7,13,112,84.0,0.5553368926048279,0.2486467957496643
9117602,6690362,5049681,14481,10267,2004,5738,1991,4214,8743,0.0,0.0,27,23.0,10,3,0,469.0,0.48091140389442444,0.08782480657100677
9118427,6609097,5352555,14481,10092,2003,6851,1994,4389,7630,1.0,0.0,26,5.0,17,3,462,413.0,0.503241777420044,0.11990111321210861
9117050,6884712,4689449,14481,10708,2005,4254,1987,3773,10227,0.5,0.5,148,27.0,4,2,42,350.0,0.5938119888305664,0.1748819649219513
9116447,6791766,8353946,14481,10484,2004,13529,2013,3997,952,0.6666666666666666,0.0,6,1.0,14,257,1267,952.0,0.4634120762348175,0.18381166458129883
9113905,5389104,6348385,14481,6984,1995,9546,2002,7497,4935,1.0,0.0,269,5.0,8,7,0,21.0,0.47747698426246643,0.3088100850582123
9120990,4828581,4501858,14488,4877,1989,3344,1985,9611,11144,0.3333333333333333,0.0,15,11.0,1,2,0,2534.0,0.4961818754673004,0.2571439743041992
9122706,8494271,4101527,14488,13718,2013,929,1978,770,13559,1.0,0.0,1,12.0,78,2,770,4263.0,0.42993485927581787,-0.012669762596487999
9120990,5326919,4026614,14488,6760,1994,516,1977,7728,13972,0.0,0.0,33,6.0,2,1,0,8477.0,0.35382258892059326,0.19635678827762604
9121039,6106888,4096521,14488,9000,2000,901,1978,5488,13587,0.0,0.0,49,4.0,10,2,63,5208.0,0.30811935663223267,0.21931152045726776
9122968,6786748,4694028,14488,10477,2004,4275,1987,4011,10213,0.0,0.0,5,11.0,9,11,1043,896.0,0.23266291618347168,0.3110065460205078
9120697,6635592,7319998,14488,10155,2003,11702,2008,4333,2786,0.5,0.0,12,5.0,8,23,224,273.0,0.4904423952102661,0.08988891541957855
9125078,6813252,4002925,14488,10533,2004,376,1977,3955,14112,1.0,0.0,35,8.0,6,1,84,392.0,0.2709510326385498,0.25812408328056335
9125057,6018724,7709408,14488,8790,2000,12542,2010,5698,1946,0.0,0.0,278,2.0,4,7,14,147.0,0.6315606236457825,0.07213956862688065
9127629,7124966,4201587,14495,11254,2006,1587,1980,3241,12908,1.0,0.0,3,11.0,5,1,637,8148.0,0.5405211448669434,0.10918132215738297
9126372,6191189,5713712,14495,9182,2001,8069,1998,5313,6426,0.0,0.0,29,18.0,7,13,63,105.0,0.42734813690185547,0.3365209996700287
9128062,7239739,4097507,14495,11506,2007,908,1978,2989,13587,0.0,0.0,9,4.0,15,1,357,56.0,0.7742966413497925,0.1469566375017166
9127515,6167970,8338182,14495,9133,2001,13508,2012,5362,987,0.2,0.0,112,1.0,3,10,21,987.0,0.19008047878742218,0.2475319653749466
9128601,7480870,8259285,14495,12073,2009,13396,2012,2422,1099,0.5,0.0,80,1.0,8,19,21,1099.0,0.44626739621162415,0.2741539180278778
9127523,7730945,7707801,14495,12577,2010,12542,2010,1918,1953,1.0,0.0,93,3.0,653,68,56,21.0,0.5229929089546204,0.19779230654239655
9129728,4794226,4505707,14495,4744,1988,3365,1985,9751,11130,0.2,0.0,165,14.0,11,3,0,126.0,0.2372766137123108,0.237884059548378
9127853,7845576,6118094,14495,12759,2010,9021,2000,1736,5474,0.2,0.0,38,3.0,42,5,7,14.0,0.4131130278110504,0.05050130933523178
9125911,4822605,4891249,14495,4856,1989,5115,1990,9639,9380,0.5,0.0,41,15.0,7,6,238,49.0,0.5997596979141235,0.18169108033180237
9129092,6633918,4071305,14495,10148,2003,761,1978,4347,13734,0.5,0.0,32,5.0,10,2,21,1512.0,0.35979074239730835,0.08442043513059616
9131187,8742344,7441199,14495,14033,2014,11982,2008,462,2513,0.0,0.5,1,4.0,2,2,462,175.0,0.6366903185844421,0.29558613896369934
9131872,5385148,7458544,14502,6970,1995,12024,2008,7532,2478,1.0,0.0,575,1.0,26,13,14,2478.0,0.33895498514175415,0.1549060195684433
9134782,7119522,4402646,14502,11240,2006,2805,1983,3262,11697,0.0,0.0,16,4.0,2,2,329,462.0,0.4087914526462555,0.14393532276153564
9134398,5280295,5491509,14502,6592,1994,7348,1996,7910,7154,0.5,0.5,45,11.0,9,2,70,728.0,0.6086225509643555,0.13900110125541687
9132006,5085635,8672709,14502,5878,1992,13956,2014,8624,546,1.0,0.0,260,2.0,5,13,14,252.0,0.4214884042739868,0.1648981124162674
9131956,5305742,8560018,14502,6690,1994,13802,2013,7812,700,1.0,0.0,42,1.0,12,11,28,700.0,0.45141640305519104,0.29634347558021545
9142662,5914500,6504609,14509,8573,1999,9868,2003,5936,4641,1.0,0.0,61,4.0,8,10,28,889.0,0.5060145854949951,0.26817795634269714
9138182,8036728,4153890,14509,13067,2011,1223,1979,1442,13286,1.0,0.0,89,12.0,345,1,0,3626.0,0.5164348483085632,0.23992791771888733
9143636,6918542,5275432,14509,10792,2005,6578,1994,3717,7931,0.16666666666666666,0.0,90,32.0,3,6,0,231.0,0.32160484790802,0.13951779901981354
9138075,6409027,6796122,14509,9672,2002,10498,2004,4837,4011,0.5,0.0,53,2.0,10,7,35,3521.0,0.4781506061553955,0.18235993385314941
9140098,4346761,7330534,14509,2434,1982,11730,2008,12075,2779,1.0,0.0,29,1.0,2,7,252,2779.0,0.30794933438301086,0.08667980134487152
9141992,4386416,6752347,14509,2707,1983,10400,2004,11802,4109,0.25,0.0,298,5.0,1,4,28,1680.0,0.5424971580505371,-0.002257352927699685
9140844,6548834,4099074,14509,9966,2003,915,1978,4543,13594,0.5,0.0,17,6.0,7,2,189,3073.0,0.4671236276626587,0.17969581484794617
9138046,5791801,4783773,14509,8258,1998,4695,1988,6251,9814,0.0,0.0,67,21.0,21,6,63,1778.0,0.40260207653045654,0.1886976808309555
9142075,5909503,5672163,14509,8552,1999,7943,1997,5957,6566,0.5,0.0,154,12.0,79,1,0,1239.0,0.6336552500724792,0.0860578641295433
9142117,5456252,7993905,14509,7222,1995,13004,2011,7287,1505,0.3333333333333333,0.0,254,2.0,42,60,0,294.0,0.388910710811615,0.16679425537586212
9144401,5741634,4439598,14516,8146,1998,3008,1984,6370,11508,0.0,0.0,289,6.0,4,4,63,4508.0,0.05516170710325241,0.01820223405957222
9147254,7408725,4672956,14516,11905,2008,4184,1987,2611,10332,0.3333333333333333,0.0,37,28.0,1,7,7,875.0,0.21742355823516846,-0.007976435124874115
9145634,7409738,7588644,14516,11912,2008,12311,2009,2604,2205,1.0,0.0,3,3.0,29,24,350,126.0,0.2763845920562744,0.37988507747650146
9147492,7940572,7615833,14516,12913,2011,12367,2009,1603,2149,0.5,0.5,10,6.0,78,176,49,91.0,0.4624008238315582,0.3320015072822571
9154966,7311605,4490037,14523,11681,2007,3281,1984,2842,11242,0.0,0.0,124,15.0,45,3,35,2835.0,0.23961013555526733,0.2583068907260895
9149281,6423088,5191610,14523,9700,2002,6270,1993,4823,8253,1.0,0.0,104,9.0,33,14,0,301.0,0.380703330039978,0.1412731111049652
9149374,6010530,4970141,14523,8769,2000,5430,1990,5754,9093,0.2,0.0,351,7.0,63,3,42,4536.0,0.5023253560066223,0.18166477978229523
9154942,8776112,5645769,14523,14068,2014,7859,1997,455,6664,0.5,0.0,2,9.0,1,5,154,28.0,0.42194098234176636,0.14480233192443848
9149381,6221098,6338218,14523,9245,2001,9511,2002,5278,5012,1.0,0.0,115,49.0,110,16,0,203.0,0.534981369972229,0.21563512086868286
9149331,6575969,6506853,14523,10022,2003,9875,2003,4501,4648,1.0,0.0,491,9.0,45,13,0,98.0,0.4713568687438965,0.20643490552902222
9153233,6907397,7913783,14523,10757,2005,12871,2011,3766,1652,1.0,0.0,27,3.0,7,7,77,392.0,0.6397420167922974,0.10718931257724762
9149149,8495949,6439838,14523,13725,2013,9735,2002,798,4788,0.3333333333333333,0.0,4,18.0,11,4,238,266.0,0.5700024962425232,0.18658390641212463
9150985,6874543,4574151,14523,10687,2005,3715,1986,3836,10808,0.5,0.0,21,2.0,57,2,14,9604.0,0.6799875497817993,0.05414401367306709
9150226,5549397,4755601,14523,7544,1996,4569,1988,6979,9954,0.3333333333333333,0.0,20,2.0,8,3,791,9548.0,0.3673658072948456,0.06444151699542999
9149357,5997573,4855679,14523,8741,1999,4968,1989,5782,9555,1.0,0.0,158,8.0,28,4,14,4235.0,0.48623114824295044,0.11334337294101715
9154366,6393480,6678486,14523,9637,2002,10239,2004,4886,4284,0.5,0.0,43,4.0,3,4,35,315.0,0.23456859588623047,0.0881342738866806
9154123,7301208,4894823,14523,11653,2007,5129,1990,2870,9394,0.0,0.0,60,21.0,1,9,42,84.0,0.2645675837993622,0.2924882173538208
9149533,4160020,6785406,14523,1279,1979,10470,2004,13244,4053,1.0,0.5,218,17.0,1,13,0,7.0,0.3388778865337372,0.12564432621002197
9155605,7146709,4562506,14530,11303,2006,3652,1985,3227,10878,0.0,0.0,5,27.0,21,9,154,308.0,0.2841436266899109,0.04041621461510658
9156477,7164975,4500917,14530,11338,2007,3337,1985,3192,11193,0.5,0.0,30,4.0,24,5,126,6216.0,0.28129124641418457,0.16803453862667084
9155557,7182752,6292403,14530,11380,2007,9392,2001,3150,5138,1.0,0.0,15,14.0,29,29,105,707.0,0.35683026909828186,0.22471709549427032
9159101,4205780,4523935,14530,1615,1980,3456,1985,12915,11074,1.0,0.0,411,20.0,4,4,0,952.0,0.44384828209877014,0.1306053102016449
9158158,5532851,5530190,14530,7488,1996,7481,1996,7042,7049,1.0,0.0,10,12.0,2,3,1890,63.0,0.31811338663101196,0.1822204440832138
9155440,4926515,6149228,14530,5255,1990,9091,2000,9275,5439,1.0,0.0,17,4.0,2,20,322,189.0,0.3998728096485138,0.24327270686626434
9155586,5419339,6607087,14530,7089,1995,10092,2003,7441,4438,1.0,0.0,30,8.0,17,3,182,56.0,0.3448045253753662,0.30434489250183105
9158797,6272650,7646630,14530,9350,2001,12430,2010,5180,2100,0.0,0.0,36,5.0,10,21,168,112.0,0.4196198582649231,0.10278873890638351
9167109,5572635,4379362,14537,7614,1996,2658,1983,6923,11879,0.16666666666666666,0.0,110,17.0,2,2,14,959.0,0.2702425718307495,0.1453022062778473
9161992,7214658,6488439,14537,11450,2007,9833,2002,3087,4704,0.5,0.0,29,11.0,14,9,14,728.0,0.291165292263031,0.1137651801109314
9164213,8778486,6867994,14537,14075,2014,10666,2005,462,3871,0.5,0.0,1,10.0,3,4,462,105.0,0.2819756269454956,0.1475326418876648
9161799,7637915,5529663,14537,12416,2009,7481,1996,2121,7056,1.0,0.0,7,20.0,237,2,147,231.0,0.6698042750358582,0.35367265343666077
9165436,8545307,4967176,14537,13788,2013,5416,1990,749,9121,0.0,0.0,2,12.0,100,8,224,217.0,0.634378969669342,0.21561872959136963
9167109,6115137,5345067,14537,9014,2000,6823,1994,5523,7714,0.16666666666666666,0.0,161,17.0,8,6,7,714.0,0.7085996270179749,0.1857607513666153
9166222,6171723,5253156,14537,9140,2001,6494,1993,5397,8043,0.5,0.0,20,27.0,42,15,7,378.0,0.4222792387008667,0.07764369249343872
9161795,4903691,4015094,14537,5171,1990,453,1977,9366,14084,1.0,0.0,91,16.0,14,1,21,1785.0,0.6272440552711487,0.3397420644760132
9161987,4876126,4093141,14537,5045,1989,887,1978,9492,13650,0.5,0.0,123,6.0,7,1,70,5999.0,0.2774465084075928,0.15879298746585846
9172533,5355413,7635892,14544,6858,1994,12409,2009,7686,2135,0.5,0.0,69,5.0,8,4,7,546.0,0.520576536655426,0.27465665340423584
9168089,6238387,5389391,14544,9280,2001,6984,1995,5264,7560,1.0,0.0,177,13.0,23,7,14,763.0,0.611431360244751,0.057726286351680756
9171419,5848398,5067240,14544,8377,1998,5808,1991,6167,8736,0.5,0.0,167,10.0,7,2,0,357.0,0.3837593197822571,0.27549684047698975
9168435,6074309,6109593,14544,8930,2000,9007,2000,5614,5537,1.0,0.0,24,6.0,7,11,7,1057.0,0.5273213982582092,0.2773473858833313
9171560,8289646,4555524,14544,13438,2012,3617,1985,1106,10927,1.0,0.0,24,17.0,49,2,7,4669.0,0.5457708239555359,0.2155027538537979
9168947,6435300,5865766,14544,9728,2002,8433,1999,4816,6111,1.0,0.0,3,11.0,5,9,1932,21.0,0.4088221788406372,0.1858500987291336
9168071,6086590,6512357,14544,8958,2000,9889,2003,5586,4655,1.0,0.0,94,5.0,1,9,28,28.0,0.3726729154586792,0.23041902482509613
9172476,4891646,5275432,14544,5115,1990,6578,1994,9429,7966,0.5,0.0,7,32.0,10,6,3031,266.0,0.4608682096004486,0.18756161630153656
9175083,5231178,4155179,14551,6417,1993,1237,1979,8134,13314,0.3333333333333333,0.0,80,19.0,3,1,21,161.0,0.2775733470916748,0.10471390187740326
9173672,6971994,5064992,14551,10932,2005,5794,1991,3619,8757,1.0,0.0,41,7.0,13,16,28,2310.0,0.3808864653110504,0.22199061512947083
9175231,5348755,7181054,14551,6837,1994,11373,2007,7714,3178,0.0,0.0,45,14.0,7,25,7,371.0,0.4396878480911255,0.13524334132671356
9173658,5626591,7954410,14551,7796,1997,12941,2011,6755,1610,1.0,0.0,37,1.0,4,2,63,1610.0,0.6257634162902832,0.13788984715938568
9179319,6590881,6771462,14551,10050,2003,10442,2004,4501,4109,1.0,0.0,110,8.0,8,44,0,595.0,0.3341916501522064,0.04937199503183365
9173645,6056773,5876208,14551,8888,2000,8461,1999,5663,6090,1.0,1.0,102,12.0,25,20,21,7.0,0.624879777431488,0.09464892745018005
9175087,4450254,4226790,14551,3064,1984,1741,1980,11487,12810,0.0,0.3333333333333333,64,6.0,4,5,14,4270.0,0.13142435252666473,0.006470201071351767
9177305,4532418,4178916,14551,3498,1985,1447,1979,11053,13104,0.14285714285714285,0.0,119,41.0,9,2,7,91.0,0.5990203619003296,0.36539649963378906
9177426,5280425,7920241,14551,6592,1994,12878,2011,7959,1673,0.3333333333333333,0.0,68,2.0,5,5,245,525.0,0.3214656710624695,0.2455950677394867
9178981,6735765,5285630,14551,10358,2004,6620,1994,4193,7931,0.5,0.0,9,4.0,31,3,1652,3395.0,0.33434635400772095,0.22224628925323486
9177638,7912991,5920780,14551,12864,2011,8587,1999,1687,5964,0.5,0.0,47,9.0,21,6,0,812.0,0.5139656066894531,0.230824813246727
9179431,6707809,6844850,14551,10302,2004,10610,2005,4249,3941,0.5,0.0,62,3.0,17,4,35,385.0,0.6869444251060486,0.31295540928840637
9173751,7255710,7463399,14551,11548,2007,12031,2008,3003,2520,1.0,0.0,15,10.0,13,3,28,91.0,0.457612544298172,0.12170860171318054
9174835,6121139,4457824,14551,9028,2000,3106,1984,5523,11445,0.0,0.0,12,23.0,7,5,1869,189.0,0.2567995488643646,0.19368425011634827
9180232,5699834,8333592,14558,8027,1997,13501,2012,6531,1057,0.0,0.0,22,2.0,2,5,924,322.0,0.3125699758529663,0.1074914038181305
9181380,5777024,4669828,14558,8223,1998,4170,1987,6335,10388,0.5,0.0,42,16.0,14,2,112,357.0,0.5393521189689636,0.1606781929731369
9180277,5300045,5589952,14558,6669,1994,7670,1996,7889,6888,1.0,0.0,160,15.0,14,4,7,1603.0,0.5160584449768066,0.24243231117725372
9182563,5613030,6711671,14558,7747,1997,10309,2004,6811,4249,1.0,0.0,103,6.0,20,10,14,553.0,0.3308485746383667,0.18244032561779022
9183940,8687430,5276594,14558,13970,2014,6578,1994,588,7980,1.0,0.0,1,16.0,6,2,588,399.0,0.49447038769721985,0.15093111991882324
9181758,5092402,5339494,14558,5906,1992,6809,1994,8652,7749,0.5,0.0,9,28.0,1,6,1239,357.0,0.3393374979496002,0.3732210099697113
9180982,5578034,4217863,14558,7635,1996,1692,1980,6923,12866,0.0,0.0,261,10.0,8,7,0,8526.0,0.4309738874435425,0.2849689722061157
9182587,6296383,5086821,14558,9406,2001,5885,1992,5152,8673,0.0,0.0,49,10.0,11,14,7,224.0,0.33281487226486206,0.07941815257072449
9184843,8036308,5716230,14558,13067,2011,8076,1998,1491,6482,0.5,0.0,20,11.0,39,6,7,609.0,0.4103718101978302,0.2921886444091797
9182045,5732729,4786758,14558,8125,1998,4709,1988,6433,9849,0.0,0.0,8,17.0,1,5,133,308.0,0.5060905814170837,0.2644771933555603
9185019,6546425,6332812,14558,9959,2003,9490,2001,4599,5068,0.0,0.0,321,10.0,71,1,0,322.0,0.37670275568962097,0.18267107009887695
9180021,6371989,5462063,14558,9602,2002,7243,1995,4956,7315,1.0,1.0,160,12.0,52,9,14,161.0,0.47684767842292786,0.16995640099048615
9186143,6331181,7304444,14565,9483,2001,11660,2007,5082,2905,1.0,0.0,402,4.0,48,7,7,1806.0,0.3233303129673004,0.11761531233787537
9191529,7193734,6335129,14565,11401,2007,9497,2002,3164,5068,0.16666666666666666,0.0,76,4.0,27,4,7,504.0,0.3876885771751404,0.1483963280916214
9186216,6564806,5716633,14565,10001,2003,8076,1998,4564,6489,0.5,0.5,104,15.0,70,11,0,84.0,0.2703320384025574,0.09552007168531418
9191610,7155735,7087525,14565,11317,2006,11177,2006,3248,3388,0.5,0.0,93,2.0,10,14,14,2751.0,0.5186536908149719,0.2325628101825714
9187601,5449729,4878791,14565,7194,1995,5059,1989,7371,9506,0.5,0.0,103,23.0,12,5,7,14.0,0.4901464581489563,0.16733399033546448
9186211,5702386,4073863,14565,8034,1997,775,1978,6531,13790,1.0,0.0,189,15.0,8,1,0,504.0,0.39198487997055054,0.19917073845863342
9191776,7599795,4479646,14565,12332,2009,3225,1984,2233,11340,0.3333333333333333,0.0,75,19.0,29,2,7,1631.0,0.5418949127197266,0.1874082237482071
9186765,4802095,4463288,14565,4779,1989,3134,1984,9786,11431,0.0,0.0,8,10.0,3,1,791,4298.0,0.4946386516094208,0.20567035675048828
9189334,5974503,4570153,14565,8699,1999,3694,1986,5866,10871,0.5,0.0,174,8.0,60,3,21,735.0,0.5355656743049622,0.2350137084722519
9186136,5340360,6703464,14565,6809,1994,10295,2004,7756,4270,1.0,0.0,149,7.0,8,13,14,609.0,0.6507988572120667,0.1892019510269165
9191730,6374126,6662131,14565,9602,2002,10204,2003,4963,4361,1.0,0.0,51,3.0,5,5,98,3850.0,0.4865420460700989,0.18959984183311462
9185974,5321579,8175320,14565,6739,1994,13277,2012,7826,1288,0.0,0.0,80,3.0,3,11,112,105.0,0.2675962746143341,0.23922942578792572
9192675,5868774,8805732,14572,8440,1999,14103,2014,6132,469,1.0,0.0,6,1.0,17,87,1015,469.0,0.33728039264678955,0.012655754573643208
9193827,5200395,5512537,14572,6305,1993,7425,1996,8267,7147,0.3333333333333333,0.0,5,5.0,1,4,14,1267.0,0.335229754447937,0.03655456379055977
9195248,7327125,7554673,14572,11723,2008,12234,2009,2849,2338,1.0,0.0,4,4.0,6,39,392,35.0,0.5221242308616638,0.12603135406970978
9197749,6169911,7426116,14572,9133,2001,11947,2008,5439,2625,1.0,0.0,210,4.0,23,3,7,931.0,0.6195657849311829,0.21804876625537872
9193873,6599627,8829567,14572,10071,2003,14131,2014,4501,441,0.0,0.0,20,1.0,7,8,42,441.0,0.5211782455444336,0.08081739395856857
9192831,6120384,5301268,14572,9028,2000,6669,1994,5544,7903,0.5,0.5,42,58.0,11,1,7,7.0,0.5790106058120728,0.07940269261598587
9195889,5564546,5397901,14572,7593,1996,7012,1995,6979,7560,0.5,0.0,298,8.0,27,8,7,210.0,0.5031751990318298,0.22894509136676788
9195395,7620433,5283962,14572,12374,2009,6613,1994,2198,7959,0.0,0.0,16,10.0,4,3,7,518.0,0.2698093056678772,0.22038927674293518
9198076,8103285,8900508,14572,13172,2012,14215,2014,1400,357,1.0,0.0,32,1.0,13,5,0,357.0,0.5435616374015808,0.12018607556819916
9192384,7239449,5092734,14572,11506,2007,5906,1992,3066,8666,0.0,0.0,36,5.0,1,2,105,882.0,0.18222282826900482,0.2577810287475586
9197002,5473109,5428364,14572,7278,1995,7117,1995,7294,7455,0.0,0.5,14,32.0,8,6,1260,231.0,0.39716222882270813,0.3890744149684906
9192264,4174073,4758665,14572,1412,1979,4583,1988,13160,9989,0.0,0.0,4,2.0,1,3,11025,4725.0,0.5637894868850708,0.06714633852243423
9195004,6312971,4158284,14572,9441,2001,1265,1979,5131,13307,0.0,0.0,267,7.0,22,3,14,5509.0,0.5136552453041077,0.21395951509475708
9195584,7433993,5493518,14572,11968,2008,7355,1996,2604,7217,0.5,0.0,19,17.0,53,20,392,812.0,0.5122610330581665,0.18381169438362122
9202812,8084309,8360858,14579,13144,2011,13543,2013,1435,1036,1.0,0.0,9,6.0,3,106,105,70.0,0.4726506769657135,0.12156912684440613
9198670,5630840,4129431,14579,7810,1997,1076,1978,6769,13503,1.0,0.0,211,9.0,32,1,7,1442.0,0.413527250289917,0.09840650856494904
9203794,6463464,7307586,14579,9777,2002,11667,2007,4802,2912,0.5,0.0,252,6.0,130,9,0,665.0,0.4226595461368561,0.2892700731754303
9202355,6342880,5903888,14579,9525,2002,8531,1999,5054,6048,0.0,0.0,55,17.0,94,7,7,525.0,0.5016213059425354,0.3664744198322296
9198801,7731702,6491486,14579,12577,2010,9840,2002,2002,4739,1.0,0.0,8,1.0,149,5,448,4739.0,0.530744194984436,0.34050053358078003
9198736,4819619,6241659,14579,4849,1989,9287,2001,9730,5292,1.0,1.0,87,41.0,13,16,21,119.0,0.35180798172950745,0.3193630576133728
9200147,5599858,6247412,14579,7705,1997,9301,2001,6874,5278,1.0,0.0,109,2.0,24,2,28,868.0,0.5707524418830872,0.20167717337608337
9203154,4835538,4889950,14579,4898,1989,5108,1989,9681,9471,1.0,0.0,48,7.0,3,3,7,3423.0,0.43609192967414856,0.08540326356887817
9202207,7376587,5493918,14579,11828,2008,7362,1996,2751,7217,1.0,0.0,52,7.0,52,3,42,2590.0,0.6952311396598816,0.1485724300146103
9198720,6616658,7757385,14579,10113,2003,12619,2010,4466,1960,1.0,0.0,177,25.0,12,104,0,56.0,0.6200684905052185,0.27299314737319946
9198784,5112305,5188929,14579,5976,1992,6263,1993,8603,8316,1.0,0.0,181,11.0,9,4,7,1519.0,0.3193047344684601,0.21280230581760406
9200253,5962325,4608891,14579,8678,1999,3897,1986,5901,10682,0.3333333333333333,0.0,98,16.0,6,2,0,420.0,0.47860056161880493,0.16861525177955627
9198695,4836196,8315011,14579,4905,1989,13473,2012,9674,1106,1.0,0.0,155,4.0,4,15,35,350.0,0.5111286640167236,0.3562850058078766
9201120,5365453,5044639,14579,6893,1994,5724,1991,7686,8855,0.0,0.0,155,3.0,3,1,77,364.0,0.4748076796531677,0.2317749261856079
9200778,6227685,8255872,14579,9259,2001,13389,2012,5320,1190,0.3333333333333333,0.0,49,3.0,7,8,0,273.0,0.5449973344802856,0.007973146624863148
9198391,7132594,7568345,14579,11268,2006,12269,2009,3311,2310,1.0,0.0,2,3.0,1,2,1414,154.0,0.6789124608039856,0.047586020082235336
9207019,5039227,4183393,14586,5703,1991,1475,1980,8883,13111,0.0,0.0,36,29.0,7,4,133,336.0,0.4953177869319916,0.3003188371658325
9206158,8999996,8504938,14586,14341,2015,13732,2013,245,854,1.0,0.0,2,1.0,3,20,147,854.0,0.9999999403953552,0.1526346504688263
9204880,7749204,7728099,14586,12605,2010,12570,2010,1981,2016,1.0,0.0,27,2.0,40,4,0,182.0,0.2991550862789154,0.08768125623464584
9209956,7627051,5460242,14586,12388,2009,7236,1995,2198,7350,1.0,0.0,42,10.0,4,3,28,49.0,0.41381552815437317,0.1844223141670227
9207052,6530328,4262986,14586,9931,2003,1937,1981,4655,12649,0.5,0.0,18,7.0,15,3,21,3339.0,0.5770034790039062,0.3500506579875946
9204962,4685921,5600343,14586,4240,1987,7705,1997,10346,6881,0.3333333333333333,0.0,69,6.0,5,3,21,994.0,0.5203045010566711,0.21015140414237976
9210279,6401198,4074955,14586,9651,2002,782,1978,4935,13804,0.5,0.0,41,11.0,5,4,98,7119.0,0.3210015892982483,0.2956376075744629
9209427,4446357,5024634,14586,3043,1984,5647,1991,11543,8939,0.3333333333333333,0.0,19,11.0,1,9,280,2142.0,0.2346646934747696,0.06298134475946426
9208160,7194454,6420332,14586,11401,2007,9693,2002,3185,4893,1.0,0.0,116,10.0,6,13,56,84.0,0.18741987645626068,0.09874845296144485
9207018,6282915,3992041,14586,9378,2001,320,1976,5208,14266,1.0,0.0,7,11.0,10,1,2660,847.0,0.633385956287384,0.17866192758083344
9207882,8218538,5443607,14586,13340,2012,7173,1995,1246,7413,0.0,0.0,21,19.0,3,1,7,168.0,0.48295557498931885,0.22118498384952545
9204806,5897493,7301340,14586,8517,1999,11653,2007,6069,2933,0.6666666666666666,0.3333333333333333,631,2.0,4,9,21,1610.0,0.3566274642944336,0.21857433021068573
9208666,7403116,4254795,14586,11891,2008,1895,1981,2695,12691,0.3333333333333333,0.0,12,3.0,4,1,0,5509.0,0.49834954738616943,0.05197932571172714
9208004,7600097,4162449,14586,12332,2009,1300,1979,2254,13286,1.0,0.0,23,27.0,7,1,0,147.0,0.3640589118003845,0.35875457525253296
9208914,4914306,5269269,14586,5206,1990,6557,1993,9380,8029,1.0,0.0,16,21.0,7,3,252,644.0,0.5463338494300842,0.2882966995239258
9215393,6047319,7905227,14593,8860,2000,12857,2011,5733,1736,0.5,0.0,68,10.0,33,34,28,77.0,0.24839547276496887,0.23895490169525146
9211775,6260835,7153678,14593,9329,2001,11317,2006,5264,3276,0.5,0.0,17,3.0,10,2,224,2184.0,0.41832584142684937,0.04950118809938431
9213972,8429005,7682082,14593,13627,2013,12500,2010,966,2093,0.5,0.0,2,2.0,77,8,441,196.0,0.24693532288074493,0.22313028573989868
9215765,6369461,4638618,14593,9595,2002,4044,1987,4998,10549,0.5,0.0,81,22.0,4,3,63,532.0,0.32246217131614685,0.16337642073631287
9211698,7222952,6711671,14593,11471,2007,10309,2004,3122,4284,0.0,0.0,3,6.0,5,10,707,588.0,0.3637218177318573,0.083694688975811
9213788,8531451,6967578,14593,13767,2013,10918,2005,826,3675,1.0,0.0,4,4.0,99,8,42,399.0,0.36263054609298706,0.20187287032604218
9218128,6301573,5456443,14600,9413,2001,7222,1995,5187,7378,0.3333333333333333,0.0,136,16.0,21,4,28,42.0,0.514987587928772,0.0886007770895958
9218720,5508731,6629517,14600,7411,1996,10141,2003,7189,4459,0.0,0.0,305,4.0,60,10,14,1834.0,0.4390164315700531,0.06219363585114479
9217568,6260359,7382350,14600,9329,2001,11842,2008,5271,2758,0.5,0.0,22,3.0,3,5,371,252.0,0.557630717754364,0.10232792794704437
9215957,5910700,8906445,14600,8559,1999,14222,2014,6041,378,0.0,0.0,110,1.0,12,2,56,378.0,0.29818421602249146,0.19307821989059448
9216294,6493587,5063186,14600,9840,2002,5787,1991,4760,8813,1.0,0.0,21,8.0,22,6,14,189.0,0.40571433305740356,0.00689601618796587
9216791,7494146,6145271,14600,12108,2009,9084,2000,2492,5516,1.0,0.0,10,12.0,3,6,210,70.0,0.7081990242004395,0.49958500266075134
9219546,7349634,4915490,14600,11772,2008,5213,1990,2828,9387,1.0,0.0,3,8.0,4,2,1190,21.0,0.5346370935440063,0.2658277451992035
9216056,7623899,8135543,14600,12381,2009,13221,2012,2219,1379,1.0,0.0,10,1.0,21,61,161,1379.0,0.6815844774246216,0.25158318877220154
9216145,7210870,4681592,14600,11443,2007,4219,1987,3157,10381,0.0,0.0,11,20.0,5,4,42,126.0,0.1792135089635849,0.31059905886650085
9224129,5204969,4723445,14607,6319,1993,4422,1988,8288,10185,1.0,0.0,92,35.0,9,18,49,35.0,0.3770691454410553,0.2815798819065094
9223050,6837422,6988864,14607,10596,2005,10981,2006,4011,3626,0.0,0.0,69,2.0,18,21,0,1911.0,0.34477609395980835,-0.0030857683159410954
9223050,7336769,4112756,14607,11744,2008,985,1978,2863,13622,0.0,1.0,24,18.0,11,2,0,1204.0,0.5180599093437195,0.0734594315290451
9220737,5166072,5769190,14607,6172,1992,8209,1998,8435,6398,0.5,0.0,22,5.0,5,11,217,511.0,0.33563750982284546,-0.008948830887675285
9220660,8100865,4754428,14607,13172,2012,4562,1988,1435,10045,1.0,0.0,4,10.0,30,10,49,63.0,0.36354488134384155,0.34665337204933167
9220515,6695845,5213975,14607,10281,2004,6354,1993,4326,8253,1.0,0.0,103,4.0,23,3,7,6650.0,0.2823590934276581,0.024843400344252586
9221533,8714487,4231362,14607,14005,2014,1769,1980,602,12838,1.0,0.0,1,5.0,5,1,602,4151.0,0.3317453861236572,0.3761453628540039
9224973,7071613,7660750,14607,11142,2006,12458,2010,3465,2149,0.0,0.0,5,2.0,11,16,819,1778.0,0.6319226026535034,0.4154079556465149
9221900,6872554,4209864,14607,10680,2005,1643,1980,3927,12964,0.0,0.0,22,17.0,7,2,56,1141.0,0.5360904932022095,0.08477401733398438
9222992,5041780,4806036,14607,5710,1991,4800,1989,8897,9807,1.0,0.0,100,7.0,13,6,42,3472.0,0.6775753498077393,0.11961878836154938
9223102,6493491,4123398,14607,9840,2002,1034,1978,4767,13573,0.5,0.0,107,5.0,26,1,28,1792.0,0.3913980722427368,0.15074671804904938
9223890,6977743,5339399,14607,10946,2005,6802,1994,3661,7805,0.3333333333333333,0.5,5,8.0,3,3,154,987.0,0.4347553551197052,0.2785605490207672
9228564,7648339,4130853,14614,12437,2010,1083,1978,2177,13531,0.0,0.0,3,12.0,3,1,238,2212.0,0.4893307685852051,0.23965629935264587
9232055,6687668,6107804,14614,10260,2004,9000,2000,4354,5614,0.0,0.0,14,3.0,2,5,665,896.0,0.15182533860206604,0.24916014075279236
9230682,8987896,6498347,14614,14327,2015,9854,2002,287,4760,0.0,0.0,1,9.0,9,4,287,623.0,0.4216964840888977,0.31125280261039734
9230283,8127986,4661016,14614,13214,2012,4135,1987,1400,10479,1.0,0.0,22,15.0,64,7,91,77.0,0.9999999403953552,0.1434900313615799
9230797,4954379,4779079,14614,5360,1990,4674,1988,9254,9940,0.5,0.0,55,5.0,9,4,2499,1092.0,0.2932812571525574,0.22811180353164673
9230381,7865432,4380704,14614,12787,2011,2665,1983,1827,11949,0.0,0.0,22,7.0,282,3,0,1400.0,0.5058701634407043,0.1149277538061142
9226751,8231043,5051745,14614,13361,2012,5745,1991,1253,8869,1.0,0.0,100,13.0,105,3,7,21.0,0.5617890954017639,0.15663664042949677
9231886,6735188,6846367,14614,10358,2004,10617,2005,4256,3997,0.5,0.0,76,1.0,99,4,7,3997.0,0.28109073638916016,0.15384650230407715
9229328,6573030,4365694,14614,10015,2003,2553,1982,4599,12061,1.0,0.0,347,2.0,61,1,28,119.0,0.5651171803474426,0.20430952310562134
9226775,5902303,5981973,14614,8531,1999,8713,1999,6083,5901,1.0,0.0,118,14.0,4,11,7,1218.0,0.40909385681152344,0.206920325756073
9233659,7113867,7630476,14621,11226,2006,12395,2009,3395,2226,0.3333333333333333,0.0,55,2.0,11,6,35,455.0,0.435416579246521,0.15959084033966064
9234125,8932996,4759864,14621,14257,2015,4590,1988,364,10031,0.3333333333333333,0.5,2,9.0,159,4,70,140.0,0.3933708667755127,0.6026818752288818
9236768,5629571,4195849,14621,7803,1997,1552,1980,6818,13069,0.0,0.0,9,8.0,11,1,476,252.0,0.30045217275619507,-0.020504437386989594
9234125,8097567,4690078,14621,13165,2012,4261,1987,1456,10360,0.5,0.0,10,5.0,16,4,70,1113.0,0.42610597610473633,0.09807004779577255
9235567,6917936,7250757,14621,10785,2005,11534,2007,3836,3087,1.0,0.0,13,5.0,2,2,224,294.0,0.2282041609287262,0.19705715775489807
9233012,6582394,6498991,14621,10036,2003,9854,2002,4585,4767,1.0,0.0,176,16.0,131,7,42,280.0,0.6625882387161255,0.14252117276191711
9236466,7645665,5561676,14621,12430,2010,7579,1996,2191,7042,1.0,1.0,66,14.0,1,1,7,1827.0,0.31629467010498047,0.22413596510887146
9239109,5214974,5286061,14628,6361,1993,6620,1994,8267,8008,1.0,0.0,6,44.0,3,19,497,140.0,0.5035001635551453,0.0598231703042984
9239313,6485944,4319453,14628,9826,2002,2266,1982,4802,12362,0.5,0.0,177,16.0,36,1,7,539.0,0.17133860290050507,0.21879923343658447
9237891,8353437,4234837,14628,13529,2013,1783,1980,1099,12845,0.5,0.0,85,4.0,532,5,7,4256.0,0.4849792420864105,0.30545589327812195
9239428,5475784,4293080,14628,7285,1995,2105,1981,7343,12523,0.2,0.2,32,45.0,25,2,805,378.0,0.36249595880508423,0.18744774162769318
9238151,5951481,5275094,14628,8657,1999,6578,1994,5971,8050,1.0,0.0,33,20.0,9,7,0,511.0,0.2880792021751404,0.23394617438316345
9237891,6050990,4192451,14628,8874,2000,1531,1980,5754,13097,0.5,0.0,234,6.0,33,1,7,854.0,0.1668945699930191,0.15160849690437317
9247582,6377804,4078875,14635,9609,2002,803,1978,5026,13832,1.0,0.0,53,33.0,14,2,98,784.0,0.59630286693573,0.06715724617242813
9242171,7003134,4348964,14635,11009,2006,2448,1982,3626,12187,0.5,0.0,261,5.0,10,2,21,5558.0,0.5687400102615356,0.02532779984176159
9241649,8077042,4891668,14635,13130,2011,5115,1990,1505,9520,0.5,0.0,6,3.0,8,5,49,6482.0,0.19433653354644775,0.2697014808654785
9241733,4686982,4162637,14635,4247,1987,1307,1979,10388,13328,1.0,0.0,155,3.0,3,1,28,4396.0,0.3546738624572754,0.051842741668224335
9244200,6923978,4423355,14635,10806,2005,2917,1983,3829,11718,0.0,0.0,10,9.0,11,2,7,42.0,0.5235811471939087,0.05783894285559654
9246704,5598532,7270647,14635,7698,1997,11583,2007,6937,3052,0.0,0.0,192,6.0,9,2,7,252.0,0.5975452065467834,0.09896327555179596
9246966,6449658,7658998,14635,9749,2002,12458,2010,4886,2177,0.5,0.0,196,5.0,12,16,14,280.0,0.5632709860801697,0.20245328545570374
9243214,5948741,4108204,14635,8650,1999,964,1978,5985,13671,1.0,0.0,31,6.0,26,1,77,252.0,0.5649977326393127,0.20029087364673615
9246223,5982099,4398934,14635,8713,1999,2784,1983,5922,11851,0.0,0.0,36,12.0,12,1,21,812.0,0.35714954137802124,0.4039173424243927
9242751,re37829,6076163,14635,9742,2002,8930,2000,4893,5705,0.0,0.0,107,2.0,20,10,140,203.0,0.5350261330604553,0.17279879748821259
9251647,6264561,7448439,14642,9336,2001,12003,2008,5306,2639,0.0,0.0,224,3.0,8,12,28,910.0,0.39896202087402344,0.19056399166584015
9251856,7330323,4995880,14642,11730,2008,5535,1991,2912,9107,1.0,0.0,86,32.0,23,4,0,63.0,0.39531850814819336,0.11361050605773926
9250778,5270806,4231313,14642,6557,1993,1769,1980,8085,12873,0.0,0.0,44,13.0,15,1,238,938.0,0.4904920756816864,0.283164381980896
9254167,4832048,5465395,14649,4891,1989,7250,1995,9758,7399,1.0,0.0,286,19.0,6,3,0,119.0,0.3604941964149475,0.12870308756828308
9257778,re39380,4381349,14649,11268,2006,2672,1983,3381,11977,1.0,0.0,20,14.0,15,2,252,217.0,0.6634297966957092,0.06419294327497482
9254709,7691470,4212225,14649,12514,2010,1657,1980,2135,12992,0.16666666666666666,0.0,4,7.0,76,2,126,7959.0,0.5727722644805908,0.28003567457199097
9255859,5606516,7577569,14649,7726,1997,12283,2009,6923,2366,0.5,0.0,35,4.0,74,9,161,245.0,0.40100812911987305,0.25754666328430176
9257143,6470420,6666102,14649,9791,2002,10218,2003,4858,4431,0.0,0.0,93,2.0,5,3,7,637.0,0.46570828557014465,0.03983002528548241
9257775,7445479,4383297,14649,11996,2008,2686,1983,2653,11963,0.5,0.0,8,13.0,8,1,231,1673.0,0.5426743030548096,0.21836940944194794
9262635,7519990,4718090,14656,12157,2009,4387,1988,2499,10269,1.0,1.0,61,3.0,20,5,14,161.0,0.28829169273376465,0.2710966169834137
9261869,6816820,5159803,14656,10540,2004,6151,1992,4116,8505,0.5,0.0,29,10.0,37,7,273,973.0,0.5104776620864868,0.17407456040382385
9259529,6404098,4279391,14656,9658,2002,2028,1981,4998,12628,0.0,0.0,167,3.0,6,1,7,133.0,0.22102297842502594,0.1608891487121582
9265172,5717810,4296011,14656,8076,1998,2119,1981,6580,12537,0.25,0.0,232,16.0,8,3,0,70.0,0.540683925151825,0.05441669002175331
9261323,4498448,4518762,14656,3330,1985,3428,1985,11326,11228,1.0,0.0,7,3.0,2,1,280,5621.0,0.6658190488815308,0.0803823322057724
9259305,6511496,5815273,14656,9889,2003,8307,1998,4767,6349,1.0,0.0,244,2.0,93,7,49,1386.0,0.24033865332603455,0.2494630366563797
9259102,5183166,7818868,14656,6242,1993,12717,2010,8414,1939,1.0,0.0,50,5.0,4,17,28,42.0,0.46005013585090637,0.25640663504600525
9260308,5672554,4577467,14656,7943,1997,3736,1986,6713,10920,0.0,0.0,20,3.0,6,6,21,3059.0,0.178514301776886,0.07940294593572617
9259149,7845798,5902324,14656,12759,2010,8531,1999,1897,6125,1.0,1.0,14,11.0,2,2,112,35.0,0.40229061245918274,0.22485004365444183
9259629,6929563,4609263,14656,10820,2005,3897,1986,3836,10759,1.0,0.0,32,3.0,11,2,217,4914.0,0.6486021876335144,0.14203889667987823
9267182,4636222,5076670,14663,4030,1987,5843,1991,10633,8820,1.0,0.0,9,21.0,2,9,70,1029.0,0.5108507871627808,0.17273849248886108
9267633,6206331,4712797,14663,9217,2001,4366,1987,5446,10297,0.0,0.0,18,5.0,15,1,0,49.0,0.3782370388507843,0.2544383406639099
9269400,6683785,5784184,14663,10253,2004,8237,1998,4410,6426,0.0,0.0,14,25.0,7,4,273,98.0,0.3880676031112671,0.06975121796131134
9265443,5752513,5012325,14663,8174,1998,5598,1991,6489,9065,1.0,0.0,309,16.0,10,17,0,196.0,0.27070340514183044,0.08337803184986115
9265267,8337603,7234442,14663,13508,2012,11499,2007,1155,3164,0.5,0.0,4,9.0,29,13,350,595.0,0.505685567855835,0.30332741141319275
9269332,6727997,4183639,14663,10344,2004,1475,1980,4319,13188,0.5,0.0,2,12.0,8,3,2758,5586.0,0.4547915756702423,0.13716447353363037
9266637,7244083,6095212,14663,11520,2007,8979,2000,3143,5684,0.25,0.0,2,2.0,14,2,2128,1498.0,0.3559032678604126,0.31457021832466125
9268429,6222528,6903373,14663,9245,2001,10750,2005,5418,3913,0.3333333333333333,0.0,157,4.0,53,15,7,707.0,0.4495351314544678,0.2517717182636261
9266454,6782759,5311554,14663,10470,2004,6704,1994,4193,7959,0.0,0.0,28,18.0,46,7,84,819.0,0.19776621460914612,0.2187735140323639
9270033,6084188,5589515,14663,8951,2000,7670,1996,5712,6993,0.5,0.0,7,13.0,7,2,581,70.0,0.3953707814216614,0.11889010667800903
9271794,7925328,7821374,14670,12885,2011,12717,2010,1785,1953,0.5,0.0,11,8.0,520,42,7,119.0,0.35584425926208496,0.1667805165052414
9272285,re39688,6315338,14670,11485,2007,9448,2001,3185,5222,0.5,0.0,4,10.0,12,22,1428,56.0,0.29989731311798096,0.19685059785842896
9274007,7248527,5587467,14670,11527,2007,7663,1996,3143,7007,0.3333333333333333,0.0,20,8.0,9,1,98,2030.0,0.5481964945793152,0.09922152012586594
9273757,8365623,7944285,14670,13550,2013,12920,2011,1120,1750,0.5,0.0,1,3.0,10,15,1120,546.0,0.717166006565094,0.22718225419521332
9276705,5565926,4553464,14670,7593,1996,3610,1985,7077,11060,1.0,0.0,50,6.0,14,1,28,1792.0,0.5325941443443298,0.2599036693572998
9272169,5985362,8751529,14670,8720,1999,14040,2014,5950,630,0.0,0.0,11,4.0,6,1,623,35.0,0.45544520020484924,0.2027776688337326
9271907,6475514,4217722,14670,9805,2002,1692,1980,4865,12978,0.5,0.0,10,19.0,89,3,147,56.0,0.3492734432220459,0.13098010420799255
9273249,4395269,8439987,14670,2763,1983,13648,2013,11907,1022,0.0,0.3333333333333333,71,1.0,5,1,28,1022.0,0.36150527000427246,0.24769186973571777
9272194,6319148,5550350,14670,9455,2001,7544,1996,5215,7126,1.0,0.0,60,20.0,29,19,126,385.0,0.578047513961792,0.04850929602980614
9272095,6684683,6095883,14670,10260,2004,8979,2000,4410,5691,0.0,0.0,11,1.0,9,6,532,5691.0,0.28482410311698914,0.31898564100265503
9274333,6424329,4493268,14670,9700,2002,3302,1985,4970,11368,0.25,0.0,51,15.0,11,8,14,567.0,0.35589098930358887,0.2952116131782532
9274418,4731155,8474777,14670,4457,1988,13697,2013,10213,973,0.0,0.0,170,4.0,2,5,63,196.0,0.5311688780784607,0.24375611543655396
9272155,5304209,8171481,14670,6683,1994,13270,2012,7987,1400,1.0,0.0,36,4.0,6,3,35,98.0,0.3123306632041931,0.12307783961296082
9275252,6253203,4615631,14670,9308,2001,3932,1986,5362,10738,1.0,0.0,396,22.0,6,11,21,6209.0,0.5928658843040466,0.4655911326408386
9280765,6980670,5136405,14677,10953,2005,6060,1992,3724,8617,0.3333333333333333,0.0,64,14.0,50,15,0,4046.0,0.5672375559806824,0.14373932778835297
9282359,6550011,6517712,14677,9966,2003,9903,2003,4711,4774,1.0,0.0,348,7.0,6,27,7,1351.0,0.37025177478790283,0.19050747156143188
9278138,7585495,4389702,14677,12304,2009,2728,1983,2373,11949,0.16666666666666666,0.0,4,10.0,23,4,7,2751.0,0.4751942753791809,-0.06628771871328354
9277976,7262251,5993049,14677,11562,2007,8734,1999,3115,5943,0.0,0.0,25,3.0,11,12,14,2324.0,0.23294109106063843,0.09226991981267929
9282524,6671512,6098448,14677,10225,2003,8986,2000,4452,5691,1.0,0.0,76,14.0,7,6,35,1379.0,0.45447075366973877,0.1248486191034317
9279471,8840062,6976715,14677,14145,2014,10946,2005,532,3731,0.3333333333333333,0.0,1,4.0,7,5,532,21.0,0.6591569781303406,0.18609899282455444
9278836,5988710,4367023,14677,8727,1999,2560,1983,5950,12117,0.0,0.0,7,9.0,13,1,378,6678.0,0.20887325704097748,0.13999833166599274
9281770,8381829,8787099,14677,13571,2013,14082,2014,1106,595,0.0,0.0,4,1.0,7,15,14,595.0,0.2930263876914978,0.11788823455572128
9287788,4953068,5744866,14684,5353,1990,8153,1998,9331,6531,1.0,0.0,95,2.0,9,1,56,4291.0,0.4320680499076843,0.12783344089984894
9282849,7836820,4346335,14684,12745,2010,2427,1982,1939,12257,0.5,0.0,4,29.0,19,3,686,1176.0,0.5292451977729797,0.11598728597164154
9285897,4641255,5990137,14684,4051,1987,8727,1999,10633,5957,1.0,0.0,70,4.0,9,4,266,266.0,0.4209582507610321,0.07206792384386063
9283054,7954682,4468683,14684,12941,2011,3162,1984,1743,11522,0.3333333333333333,0.0,179,6.0,356,2,0,7609.0,0.5970289707183838,0.225163996219635
9283127,4363322,5550350,14684,2539,1982,7544,1996,12145,7140,1.0,0.0,43,20.0,3,19,56,399.0,0.44200628995895386,0.025810357183218002
9286352,6507834,5037336,14684,9875,2003,5696,1991,4809,8988,1.0,0.0,73,26.0,8,5,28,644.0,0.4544200301170349,0.07518347352743149
9287494,7729086,4340057,14684,12570,2010,2392,1982,2114,12292,0.0,0.0,91,50.0,40,1,0,28.0,0.3564257025718689,0.24208182096481323
9282966,8002785,7915808,14684,13018,2011,12871,2011,1666,1813,1.0,0.0,50,10.0,5,55,0,84.0,0.5283344388008118,0.1914421170949936
9286919,8223458,4004115,14684,13347,2012,383,1977,1337,14301,1.0,0.0,15,7.0,5,2,49,5894.0,0.4217173159122467,0.15155600011348724
9283555,7786336,4737633,14684,12661,2010,4485,1988,2023,10199,0.6666666666666666,0.0,2,7.0,1,2,511,2100.0,0.47302618622779846,0.15241388976573944
9282829,6085370,5122879,14684,8958,2000,6011,1992,5726,8673,0.0,0.0,5,14.0,4,4,259,2296.0,0.4333857297897339,0.17933642864227295
9285630,5448386,5232467,14684,7187,1995,6424,1993,7497,8260,0.5,0.0,10,25.0,3,5,1624,378.0,0.5764196515083313,0.19064588844776154
9283410,8057389,4658727,14684,13102,2011,4128,1987,1582,10556,0.5,0.0,45,16.0,67,11,0,322.0,0.47424864768981934,0.09639512002468109
9283193,7032593,5242560,14684,11072,2006,6459,1993,3612,8225,1.0,0.0,14,10.0,58,16,49,238.0,0.1576535850763321,0.3305235505104065
9294166,8121079,5899697,14691,13200,2012,8524,1999,1491,6167,1.0,0.0,7,14.0,2,43,357,238.0,0.5133968591690063,0.1049756407737732
9294558,6654772,6665453,14691,10190,2003,10211,2003,4501,4480,0.5,0.5,42,9.0,18,5,21,112.0,0.27017074823379517,0.1623503714799881
9291441,4077129,5769814,14691,796,1978,8209,1998,13895,6482,1.0,0.0,13,7.0,1,14,133,595.0,0.33620548248291016,0.11580995470285416
9289154,6128522,5656251,14691,9042,2000,7894,1997,5649,6797,0.5,0.0,146,4.0,46,2,21,35.0,0.431924968957901,0.0073339021764695644
9293547,7868376,3999204,14691,12794,2011,355,1976,1897,14336,1.0,1.0,9,3.0,2,1,14,777.0,0.4593597948551178,0.3481205701828003
9292068,7146514,8451775,14691,11296,2006,13662,2013,3395,1029,1.0,0.0,23,1.0,19,1,70,1029.0,0.5530791282653809,0.07923498749732971
9293568,9153442,7628666,14691,14523,2015,12395,2009,168,2296,1.0,1.0,4,15.0,469,166,7,336.0,0.17660917341709137,0.2049126923084259
9291359,4842510,4415421,14691,4926,1989,2875,1983,9765,11816,0.0,0.0,60,26.0,8,2,28,196.0,0.3024122714996338,0.21456779539585114
9289200,5814026,6968558,14691,8307,1998,10918,2005,6384,3773,1.0,0.0,117,3.0,46,7,0,784.0,0.5736218094825745,0.1942315548658371
9290690,5048608,5003643,14691,5738,1991,5570,1991,8953,9121,0.3333333333333333,0.0,9,26.0,7,4,301,707.0,0.3935664892196655,0.13938435912132263
9290423,4686317,6167299,14691,4240,1987,9126,2000,10451,5565,0.5,0.0,12,27.0,3,3,112,469.0,0.5088568329811096,0.01234100665897131
9290812,5869262,4507080,14691,8440,1999,3372,1985,6251,11319,0.3333333333333333,0.0,31,12.0,1,3,364,63.0,0.2958010733127594,0.12165582180023193
9290757,5486602,6970653,14691,7327,1996,10925,2005,7364,3766,0.3333333333333333,0.0,17,4.0,1,8,749,434.0,0.5174764394760132,0.009076379239559174
9289329,4619357,3994638,14691,3953,1986,334,1976,10738,14357,0.0,0.0,38,6.0,1,1,7,28.0,0.26539143919944763,0.3095664381980896
9291109,7527035,re44080,14691,12178,2009,13592,2013,2513,1099,1.0,0.0,4,1.0,20,25,658,1099.0,0.5558909773826599,0.21052880585193634
9288992,5433881,7864721,14691,7138,1995,12787,2011,7553,1904,0.0,0.0,9,4.0,2,2,42,686.0,0.40102633833885193,0.07685471326112747
9294262,6509773,4631190,14691,9882,2003,4009,1986,4809,10682,0.0,0.0,77,9.0,11,16,7,126.0,0.536456823348999,0.202351912856102
9295904,5897417,6012264,14698,8517,1999,8776,2000,6181,5922,0.5,0.0,88,17.0,11,23,35,567.0,0.35226064920425415,0.08805117011070251
9300127,5513060,4963830,14698,7425,1996,5402,1990,7273,9296,1.0,0.0,9,13.0,1,13,210,588.0,0.5095104575157166,0.19189994037151337
9296516,4982844,6957445,14698,5486,1991,10883,2005,9212,3815,0.5,0.0,33,2.0,9,32,42,574.0,0.6890479326248169,0.11452994495630264
9296011,6231600,4166949,14698,9266,2001,1342,1979,5432,13356,0.5,0.0,397,8.0,123,3,14,182.0,0.48610955476760864,0.31967079639434814
9299419,8193792,7322491,14698,13305,2012,11716,2008,1393,2982,0.0,0.0,3,14.0,9,27,616,14.0,0.5270099639892578,0.2800230383872986
9295965,5942609,4276329,14698,8636,1999,2007,1981,6062,12691,0.0,0.0,41,18.0,5,2,14,280.0,0.5985504388809204,0.20855866372585297
9296904,5648407,6763449,14698,7866,1997,10421,2004,6832,4277,0.5,0.0,78,6.0,22,5,7,651.0,0.46873146295547485,0.1405988335609436
9303622,4452568,4169217,14705,3078,1984,1363,1979,11627,13342,1.0,0.0,14,18.0,6,1,980,21.0,0.5509951710700989,0.16003361344337463
9301834,5746709,8657431,14705,8160,1998,13935,2014,6545,770,1.0,0.0,168,1.0,16,32,7,770.0,0.37909623980522156,0.11027170717716217
9307341,7120608,5847631,14705,11240,2006,8377,1998,3465,6328,0.6666666666666666,0.0,78,7.0,7,9,7,952.0,0.2879880964756012,0.20819734036922455
9305532,7052305,7929569,14705,11107,2006,12892,2011,3598,1813,0.0,0.0,6,2.0,10,52,1323,742.0,0.39909490942955017,0.27920931577682495
9301826,5354292,7871221,14705,6858,1994,12801,2011,7847,1904,1.0,0.0,231,3.0,19,15,7,1330.0,0.5461905598640442,0.3704637885093689
9306410,7932798,4023570,14705,12899,2011,502,1977,1806,14203,0.0,0.0,38,33.0,10,1,21,259.0,0.36635902523994446,0.23320259153842926
9301712,5744953,5823641,14705,8153,1998,8328,1998,6552,6377,0.5,0.0,184,5.0,1,5,35,1148.0,0.5440729260444641,0.08555459976196289
9302849,5114280,4489634,14705,5983,1992,3281,1984,8722,11424,1.0,0.0,13,8.0,1,1,175,2408.0,0.46516042947769165,0.21171465516090393
9304516,5079711,7506363,14705,5850,1992,12129,2009,8855,2576,0.5,0.0,29,1.0,7,1,714,2576.0,0.34659579396247864,0.15121866762638092
9312500,8084146,4089064,14712,13144,2011,866,1978,1568,13846,0.5,0.0,20,29.0,1,1,28,399.0,0.6613121628761292,0.09919003397226334
9309468,4717467,4476008,14712,4387,1988,3204,1984,10325,11508,0.5,0.0,27,17.0,10,6,735,4221.0,0.5218775868415833,0.183656245470047
9310103,7334406,4939194,14712,11744,2008,5297,1990,2968,9415,0.25,0.0,4,13.0,2,4,224,665.0,0.5152896642684937,0.12230406701564789
9308335,5701886,8555786,14712,8034,1997,13802,2013,6678,910,1.0,0.0,35,1.0,15,8,21,910.0,0.6325116157531738,0.13704293966293335
9307986,6554861,4649235,14712,9980,2003,4086,1987,4732,10626,1.0,0.0,140,4.0,10,5,0,3773.0,0.19995233416557312,0.24434736371040344
9311867,8405425,4405308,14712,13599,2013,2819,1983,1113,11893,0.0,0.0,1,22.0,23,1,1113,4767.0,0.3875150680541992,0.1791202276945114
9308035,6575973,4529958,14712,10022,2003,3484,1985,4690,11228,1.0,0.0,52,18.0,13,10,56,525.0,0.6513856053352356,0.2955015301704407
9311720,5896464,5310984,14712,8510,1999,6704,1994,6202,8008,1.0,0.0,17,4.0,6,3,140,4109.0,0.272477924823761,0.2888646423816681
9311472,7243239,6344204,14712,11513,2007,9532,2002,3199,5180,0.0,0.0,27,3.0,6,3,14,945.0,0.4947236180305481,0.1646149754524231
9314267,4112932,4093334,14719,985,1978,887,1978,13734,13832,1.0,0.0,210,6.0,1,1,0,7161.0,0.30189910531044006,0.2706928551197052
9314289,5569241,7681449,14719,7607,1996,12500,2010,7112,2219,1.0,0.0,448,2.0,17,10,7,476.0,0.345097154378891,0.20358537137508392
9314274,6183472,6859187,14719,9168,2001,10645,2005,5551,4074,1.0,0.0,278,5.0,1,6,7,532.0,0.4388335347175598,0.15597954392433167
9318413,8304863,8087940,14719,13459,2012,13151,2012,1260,1568,1.0,1.0,6,2.0,68,1,196,784.0,0.6739039421081543,0.30169355869293213
9314630,5338662,7647873,14719,6802,1994,12437,2010,7917,2282,0.0,0.0,133,4.0,13,35,7,539.0,0.40271949768066406,0.1285925954580307
9319212,7738608,4934784,14719,12584,2010,5283,1990,2135,9436,0.3333333333333333,0.2,42,12.0,148,18,14,2849.0,0.48673924803733826,0.20378655195236206
9318689,8632723,5128424,14719,13900,2014,6032,1992,819,8687,0.2,0.0,2,13.0,4,7,7,2156.0,0.5863527655601501,0.10802260786294937
9315150,5629669,5516762,14719,7803,1997,7439,1996,6916,7280,1.0,0.0,38,6.0,5,2,210,2947.0,0.4061158299446106,0.12773074209690094
9318223,8315106,4375360,14719,13473,2012,2616,1983,1246,12103,0.5,0.0,2,14.0,7,2,84,224.0,0.6748697757720947,0.08136246353387833
9317180,7822631,7908675,14719,12717,2010,12864,2011,2002,1855,0.5,0.0,57,9.0,10,9,7,77.0,0.41661983728408813,0.21790215373039246
9320135,6013358,5639973,14719,8776,2000,7838,1997,5943,6881,0.0,0.0,38,7.0,28,19,112,1113.0,0.4348967969417572,0.21473726630210876
9320205,5760706,4344003,14726,8188,1998,2413,1982,6538,12313,0.0,0.0,33,15.0,10,2,91,1680.0,0.4239237904548645,0.2717262804508209
9323902,6668068,4114150,14726,10218,2003,985,1978,4508,13741,0.5,0.0,71,5.0,7,1,42,5173.0,0.4120791554450989,0.18987539410591125
9322026,7183061,6241659,14726,11380,2007,9287,2001,3346,5439,0.0,0.0,21,42.0,4,16,84,77.0,0.5163402557373047,0.12344381958246231
9321614,6135301,4292946,14726,9063,2000,2105,1981,5663,12621,1.0,0.0,11,2.0,7,1,168,11018.0,0.49285411834716797,0.26430514454841614
9323092,6137427,5992034,14726,9063,2000,8734,1999,5663,5992,0.0,0.0,125,3.0,2,5,63,665.0,0.6906512379646301,0.44019126892089844
9325314,7885125,4185849,14726,12822,2011,1489,1980,1904,13237,0.5,0.0,2,44.0,1,1,322,21.0,0.5725600719451904,0.3394681215286255
9322027,6303344,6705640,14726,9420,2001,10302,2004,5306,4424,1.0,0.0,58,5.0,53,11,56,56.0,0.3982711434364319,0.06385231018066406
9323020,5515472,6538343,14726,7432,1996,9945,2003,7294,4781,1.0,0.0,67,9.0,24,5,98,70.0,0.5652957558631897,0.17968890070915222
9322495,6773773,4101518,14726,10449,2004,929,1978,4277,13797,0.0,0.0,5,8.0,3,2,161,10556.0,0.43811723589897156,0.20391564071178436
9326788,8491578,7847869,14733,13718,2013,12759,2010,1015,1974,1.0,0.0,20,2.0,155,4,49,126.0,0.28621262311935425,0.263698011636734
9329941,6931558,8740947,14733,10820,2005,14033,2014,3913,700,1.0,0.0,45,1.0,11,36,84,700.0,0.5398514866828918,0.1972184032201767
9327089,8272380,5437502,14733,13417,2012,7152,1995,1316,7581,1.0,0.0,87,13.0,194,15,28,560.0,0.39952224493026733,0.24237486720085144
9328353,5466785,4234449,14733,7257,1995,1783,1980,7476,12950,0.5,0.0,75,22.0,2,3,28,35.0,0.577235758304596,0.10684911906719208
9326795,4696290,5866518,14733,4289,1987,8433,1999,10444,6300,1.0,0.0,403,26.0,2,6,154,49.0,0.5434086322784424,0.004513469059020281
9327297,5758827,4187040,14733,8188,1998,1496,1980,6545,13237,1.0,0.0,27,9.0,21,2,14,896.0,0.4146791696548462,0.33186498284339905
9327166,4839116,4502909,14733,4912,1989,3351,1985,9821,11382,0.0,0.0,53,10.0,10,1,28,476.0,0.7173699140548706,0.1380668729543686
9330598,7262753,4962291,14733,11562,2007,5395,1990,3171,9338,0.5,0.0,50,13.0,10,5,7,70.0,0.510671854019165,0.2361539900302887
9327142,7888709,5346883,14733,12829,2011,6830,1994,1904,7903,0.0,0.0,16,3.0,27,2,42,3451.0,0.4752991795539856,0.2234962284564972
9330825,7874856,6985548,14733,12808,2011,10967,2006,1925,3766,1.0,0.0,46,7.0,14,7,7,616.0,0.3178906738758087,0.019704552367329597
9329689,5467104,6338155,14733,7257,1995,9504,2002,7476,5229,0.0,0.0,270,11.0,9,4,49,1204.0,0.4635525345802307,0.33329540491104126
9336231,5596755,5214574,14740,7691,1997,6354,1993,7049,8386,1.0,0.0,41,24.0,18,7,252,259.0,0.18542975187301636,0.3926715552806854
9335892,5442744,5587672,14740,7166,1995,7663,1996,7574,7077,0.5,0.0,108,26.0,8,9,14,91.0,0.4980138838291168,0.15032561123371124
9333447,5238003,6206178,14740,6445,1993,9217,2001,8295,5523,0.0,0.0,27,4.0,8,2,189,4018.0,0.5082144141197205,0.4945995509624481
9333334,5144952,4230360,14740,6095,1992,1762,1980,8645,12978,1.0,0.0,13,15.0,6,1,14,266.0,0.43534496426582336,0.17358359694480896
9337114,8988883,5327390,14740,14327,2015,6760,1994,413,7980,0.2,0.0,1,49.0,32,10,413,28.0,0.34244871139526367,0.19484244287014008
9336240,6919910,4278861,14740,10792,2005,2021,1981,3948,12719,0.0,0.0,27,4.0,8,4,0,3591.0,0.4333871901035309,0.1429796814918518
9333909,7517099,6795451,14740,12157,2009,10491,2004,2583,4249,0.3333333333333333,0.0,28,10.0,9,9,21,105.0,0.5508183836936951,0.2515352666378021
9335026,7862197,6692745,14740,12787,2011,10274,2004,1953,4466,0.5,0.0,3,10.0,20,4,455,616.0,0.48046964406967163,0.06414774060249329
9332976,5236435,5072526,14740,6438,1993,5829,1991,8302,8911,0.5,0.0,89,10.0,9,8,14,1078.0,0.348888635635376,0.19720697402954102
9335501,5905231,5849156,14740,8538,1999,8384,1998,6202,6356,0.0,0.0,20,2.0,11,5,7,4907.0,0.5231152176856995,0.16987618803977966
9332974,8308046,5608262,14740,13466,2012,7733,1997,1274,7007,1.0,0.0,155,6.0,105,1,7,7.0,0.3145453631877899,0.24064752459526062
9332973,6726651,8273045,14740,10344,2004,13417,2012,4396,1323,1.0,1.0,57,1.0,75,33,7,1323.0,0.387490838766098,0.2772507965564728
9339930,5710870,5298710,14747,8055,1998,6662,1994,6692,8085,0.0,0.0,67,17.0,17,33,7,462.0,0.41130709648132324,0.2891670763492584
9339380,8506620,8312223,14747,13739,2013,13466,2012,1008,1281,1.0,0.0,7,2.0,267,2,0,483.0,0.6243146061897278,0.094925157725811
9339050,6379724,6576994,14747,9616,2002,10022,2003,5131,4725,1.0,0.0,8,4.0,7,5,112,518.0,0.5597495436668396,0.23218876123428345
9342835,7072847,7478077,14747,11142,2006,12066,2009,3605,2681,1.0,1.0,24,7.0,14,10,21,42.0,0.43219712376594543,0.2797982692718506
9343923,6629923,6567117,14747,10141,2003,10001,2003,4606,4746,0.3333333333333333,0.0,6,20.0,42,15,350,1036.0,0.4705091416835785,0.1342540681362152
9339510,4569940,5306607,14747,3694,1986,6690,1994,11053,8057,1.0,0.0,16,4.0,1,12,98,4284.0,0.4431866705417633,0.19999916851520538
9342802,6353390,5058396,14747,9560,2002,5773,1991,5187,8974,0.0,0.0,118,7.0,4,6,21,1134.0,0.4590680003166199,0.1960110366344452
9342588,6732090,4265556,14747,10351,2004,1951,1981,4396,12796,1.0,0.0,188,15.0,11,3,49,2100.0,0.2866881191730499,0.17239922285079956
9339993,7334853,4583117,14747,11744,2008,3757,1986,3003,10990,0.0,0.0,3,17.0,8,6,707,14.0,0.20357882976531982,0.22303208708763123
9344412,8166180,4290585,14747,13263,2012,2091,1981,1484,12656,0.0,0.0,1,17.0,3,1,1484,1239.0,0.4700390100479126,0.1615149825811386
9341012,7617633,6539297,14747,12374,2009,9945,2003,2373,4802,0.3333333333333333,0.25,4,4.0,11,1,224,105.0,0.34321358799934387,0.1774217188358307
9341000,9074391,4402221,14747,14432,2015,2805,1983,315,11942,1.0,0.0,1,8.0,22,1,315,4753.0,0.8750868439674377,0.010860004462301731
9339612,6730494,6991871,14747,10351,2004,10988,2006,4396,3759,0.0,0.0,97,2.0,7,3,28,1624.0,0.18316766619682312,0.11680455505847931
9345036,7756519,4983955,14747,12612,2010,5486,1991,2135,9261,0.5,0.0,47,4.0,2,10,0,1414.0,0.2175346463918686,0.3468223214149475
9343086,7916425,5488979,14747,12871,2011,7341,1996,1876,7406,1.0,0.0,14,5.0,5,15,42,1239.0,0.5145552754402161,0.21006692945957184
9345836,5348544,8373474,14754,6837,1994,13557,2013,7917,1197,0.5,0.0,195,1.0,17,4,63,1197.0,0.29668480157852173,0.10835395753383636
9347890,7126699,6237807,14754,11254,2006,9280,2001,3500,5474,0.5,0.0,19,5.0,5,2,56,1022.0,0.4057631492614746,0.18327593803405762
9345671,6130214,7093816,14754,9049,2000,11191,2006,5705,3563,0.5,0.0,11,3.0,2,5,952,49.0,0.4876084625720978,0.1599457561969757
9347099,6174670,6549896,14754,9147,2001,9966,2003,5607,4788,1.0,0.0,236,5.0,49,4,0,14.0,0.5459606647491455,0.1530212163925171
9350309,7519189,6020013,14754,12157,2009,8797,2000,2597,5957,0.5,0.0,10,16.0,17,9,0,882.0,0.6464993357658386,0.2083136886358261
9349820,8309961,6604320,14754,13466,2012,10085,2003,1288,4669,1.0,0.0,44,7.0,23,5,0,1351.0,0.6908847689628601,0.1607895791530609
9350680,7787480,5110164,14754,12661,2010,5969,1992,2093,8785,1.0,0.0,44,7.0,4,4,0,3052.0,0.2833038568496704,0.22412052750587463
9348392,5315502,5373423,14754,6718,1994,6921,1994,8036,7833,0.3333333333333333,0.0,28,12.0,8,2,70,1778.0,0.36982253193855286,0.1947072595357895
9345541,5353783,7231381,14754,6858,1994,11485,2007,7896,3269,1.0,0.0,130,20.0,7,53,14,84.0,0.31814780831336975,0.04336549714207649
re46007,4633304,4699012,14754,4016,1986,4303,1987,10738,10451,0.0,0.0,110,21.0,5,4,105,903.0,0.46387070417404175,0.23349706828594208
9345482,7335212,6927769,14754,11744,2008,10813,2005,3010,3941,1.0,0.0,53,14.0,39,2,105,7.0,0.6380011439323425,0.2159736007452011
9347664,6796789,8989701,14754,10498,2004,14327,2015,4256,427,0.5,0.0,23,2.0,3,4,21,217.0,0.5235511660575867,0.14318889379501343
9351193,6047268,6309160,14754,8860,2000,9434,2001,5894,5320,0.5,0.0,545,2.0,5,11,14,2513.0,0.21679870784282684,0.10591732710599899
9351726,5466020,4898794,14761,7257,1995,5150,1990,7504,9611,0.0,0.0,180,5.0,8,3,7,5432.0,0.49323025345802307,0.10716330260038376
9352341,7614379,5088329,14761,12367,2009,5892,1992,2394,8869,0.0,0.0,2,36.0,2,2,651,357.0,0.2894706726074219,0.10003942251205444
9354641,6885185,7791513,14761,10708,2005,12668,2010,4053,2093,0.0,0.0,21,3.0,48,93,35,77.0,0.36371150612831116,0.27009013295173645
9356392,9028265,5181597,14761,14376,2015,6235,1993,385,8526,1.0,0.0,1,12.0,1,3,385,1197.0,0.6828649044036865,0.16422906517982483
9352257,6635175,5018529,14761,10155,2003,5626,1991,4606,9135,1.0,0.0,25,13.0,12,7,42,119.0,0.44332170486450195,0.2087448239326477
9351792,5860968,4518205,14761,8419,1999,3428,1985,6342,11333,1.0,0.0,19,13.0,9,4,1253,399.0,0.2675366699695587,0.25326138734817505
9353218,5167960,5310191,14761,6179,1992,6704,1994,8582,8057,0.5,0.0,76,2.0,13,1,28,7483.0,0.3444845974445343,0.08457943052053452
9355421,8495163,8394571,14761,13718,2013,13585,2013,1043,1176,0.5,0.0,4,2.0,116,3,203,28.0,0.4929512143135071,0.07815460115671158
9360372,6072572,4585258,14768,8923,2000,3771,1986,5845,10997,1.0,0.0,10,5.0,9,1,602,3647.0,0.4332868754863739,0.2813743054866791
9358015,7905890,4676575,14768,12857,2011,4198,1987,1911,10570,1.0,0.0,22,29.0,390,3,0,28.0,0.8879774212837219,0.4393690526485443
9358029,5290313,6987894,14768,6634,1994,10974,2006,8134,3794,1.0,0.0,135,8.0,16,3,0,35.0,0.4511708617210388,0.27922627329826355
9362743,4652770,4509498,14768,4100,1987,3386,1985,10668,11382,1.0,0.0,51,2.0,1,4,14,9177.0,0.316287636756897,0.11370163410902023
9360222,6158511,4413281,14768,9112,2000,2861,1983,5656,11907,0.0,0.0,23,33.0,19,1,525,42.0,0.4758867919445038,0.18427300453186035
9358868,5453930,5634024,14768,7208,1995,7817,1997,7560,6951,1.0,0.0,49,14.0,9,3,105,175.0,0.36416903138160706,0.31389859318733215
9360300,6437227,4830040,14768,9728,2002,4884,1989,5040,9884,0.0,0.0,126,6.0,13,2,0,3815.0,0.23493912816047668,0.148476704955101
9361144,5551013,5739392,14768,7544,1996,8139,1998,7224,6629,1.0,0.0,274,3.0,13,3,0,217.0,0.3725683093070984,0.10259878635406494
9358182,5957898,4426510,14768,8671,1999,2938,1984,6097,11830,1.0,0.0,162,11.0,330,4,7,21.0,0.5196592211723328,0.19332656264305115
9362617,6452549,4147396,14768,9756,2002,1188,1979,5012,13580,1.0,0.0,76,8.0,18,1,35,3437.0,0.5602114796638489,0.24498401582241058
9357991,6355066,4508970,14768,9567,2002,3379,1985,5201,11389,1.0,0.0,136,25.0,9,2,49,287.0,0.4515256881713867,0.1472436636686325
9358005,8875971,9038907,14768,14187,2014,14390,2015,581,378,1.0,0.0,59,1.0,559,1,0,378.0,0.34398153424263,0.18720026314258575
9357922,4780556,6284962,14768,4681,1988,9378,2001,10087,5390,0.0,0.0,17,2.0,2,11,14,2499.0,0.20145417749881744,0.3061198890209198
9359236,4663044,5795821,14768,4142,1987,8265,1998,10626,6503,1.0,0.0,47,3.0,7,9,560,2156.0,0.5861384868621826,0.13366059958934784
9364284,5251634,5828799,14775,6494,1993,8335,1998,8281,6440,0.5,0.0,303,5.0,5,2,0,3325.0,0.2534172832965851,0.07225559651851654
9368225,5968198,6339069,14775,8692,1999,9511,2002,6083,5264,0.0,0.0,130,9.0,5,3,21,140.0,0.12171636521816254,0.05889354646205902
9365467,6014018,7122640,14775,8776,2000,11247,2006,5999,3528,0.0,0.3333333333333333,9,6.0,4,19,49,336.0,0.12071195244789124,0.26718753576278687
9366461,6028263,4696271,14775,8818,2000,4289,1987,5957,10486,0.0,0.0,29,14.0,9,3,63,6804.0,0.5402679443359375,0.28010472655296326
9368947,5322971,7762145,14775,6746,1994,12626,2010,8029,2149,0.0,0.0,5,2.0,14,2,126,588.0,0.5895320177078247,0.019319633021950722
9364233,6083242,7935242,14775,8951,2000,12906,2011,5824,1869,1.0,0.0,422,3.0,2,20,0,434.0,0.533909022808075,0.12623795866966248
9367965,5201316,5471383,14775,6312,1993,7271,1995,8463,7504,0.0,1.0,64,4.0,5,8,7,21.0,0.2148895114660263,0.2948198616504669
9367283,4995778,4722470,14775,5535,1991,4415,1988,9240,10360,0.0,0.0,4,20.0,3,1,7,126.0,0.10731267184019089,0.2267186939716339
9369493,8484694,7406577,14775,13704,2013,11898,2008,1071,2877,0.5,0.5,7,2.0,2,1,28,1890.0,0.43601951003074646,0.2605527341365814
9368924,6540554,5462681,14775,9952,2003,7243,1995,4823,7532,1.0,0.0,13,19.0,14,34,259,1694.0,0.7119385004043579,0.17004334926605225
9366225,5435259,5476224,14775,7145,1995,7292,1995,7630,7483,0.0,0.0,21,4.0,6,3,14,777.0,0.5520109534263611,0.27203255891799927
9372208,8344503,8154194,14782,13515,2013,13249,2012,1267,1533,0.5,0.3333333333333333,4,1.0,15,6,126,1533.0,0.21229839324951172,0.1568462997674942
9370246,7641276,7662590,14782,12423,2010,12465,2010,2359,2317,1.0,0.0,4,11.0,3,12,140,434.0,0.6641987562179565,-0.02997882477939129
9370856,4355489,6963601,14782,2490,1982,10904,2005,12292,3878,0.3333333333333333,0.0,58,2.0,2,9,154,3514.0,0.4729430675506592,0.16524966061115265
9371697,6112810,7318094,14782,9014,2000,11695,2008,5768,3087,0.5,0.0,31,7.0,16,179,14,21.0,0.3151053786277771,0.33594515919685364
9370353,5799661,7905227,14782,8279,1998,12857,2011,6503,1925,1.0,0.0,386,11.0,82,34,77,49.0,0.3905365765094757,0.2733631432056427
9370350,7736364,4174416,14782,12584,2010,1412,1979,2198,13370,1.0,0.0,18,8.0,40,1,14,1211.0,0.36189794540405273,0.39303284883499146
9372056,5941784,3980225,14782,8636,1999,257,1976,6146,14525,1.0,0.0,38,13.0,29,1,35,91.0,0.6306462287902832,-0.023694515228271484
9370350,5393302,5668480,14782,6998,1995,7929,1997,7784,6853,1.0,0.0,193,5.0,6,1,14,1386.0,0.42816102504730225,0.12470674514770508
9376061,6407847,5461497,14789,9665,2002,7236,1995,5124,7553,0.0,0.0,178,9.0,17,3,14,3122.0,0.27453890442848206,0.20365309715270996
9379769,5541954,4582449,14789,7516,1996,3757,1986,7273,11032,1.0,0.0,85,14.0,2,4,28,567.0,0.5018987059593201,0.06429006904363632
9380347,5418622,4154381,14789,7082,1995,1230,1979,7707,13559,1.0,0.0,73,6.0,8,1,14,952.0,0.28136685490608215,0.1882917881011963
9376919,5419681,7219972,14789,7089,1995,11464,2007,7700,3325,0.5,0.0,51,3.0,14,9,63,469.0,0.5552356243133545,0.2754611670970917
9379311,6661619,5637716,14789,10204,2003,7831,1997,4585,6958,0.3333333333333333,0.0,31,3.0,15,3,469,924.0,0.4441705048084259,0.12555073201656342
9375420,6632457,4126780,14789,10148,2003,1055,1978,4641,13734,1.0,0.0,129,4.0,59,2,7,9877.0,0.4953392446041107,0.1756087839603424
9379683,7657910,4621732,14789,12451,2010,3967,1986,2338,10822,0.0,0.0,137,14.0,112,2,7,133.0,0.41083717346191406,0.19034308195114136
9375237,5306309,6908960,14789,6690,1994,10764,2005,8099,4025,1.0,0.0,731,20.0,24,1,21,133.0,0.4183729588985443,0.22752098739147186
9379414,4130694,4948795,14789,1083,1978,5339,1990,13706,9450,1.0,0.0,17,2.0,3,2,3794,7518.0,0.4283151626586914,-0.0044994354248046875
9385810,7200305,4801520,14796,11415,2007,4779,1989,3381,10017,0.0,0.0,35,10.0,5,6,21,6797.0,0.1410670280456543,0.14920108020305634
9381316,5233978,6813451,14796,6431,1993,10533,2004,8365,4263,0.5,0.0,140,14.0,10,13,7,42.0,0.6639176607131958,0.1551624834537506
9381451,5680889,7466543,14796,7971,1997,12038,2008,6825,2758,0.5,0.0,21,3.0,12,3,7,1099.0,0.31284019351005554,0.07305386662483215
9381424,6580415,5723900,14796,10029,2003,8097,1998,4767,6699,0.0,0.0,38,4.0,4,2,245,616.0,0.4093570411205292,0.1563478261232376
9382938,6552905,4236234,14796,9973,2003,1790,1980,4823,13006,0.0,0.0,12,14.0,3,2,1659,476.0,0.38924017548561096,0.18295085430145264
9381024,5078919,4592975,14796,5850,1992,3806,1986,8946,10990,0.0,0.0,25,10.0,8,8,126,5635.0,0.1819545328617096,0.13064523041248322
9381194,6274597,6489239,14796,9357,2001,9833,2002,5439,4963,1.0,0.0,22,5.0,9,7,133,1232.0,0.26238834857940674,0.05808413773775101
9386165,6829696,4192062,14796,10568,2004,1531,1980,4228,13265,0.5,0.0,122,11.0,2,3,0,707.0,0.28712230920791626,0.09610550105571747
9380814,5159719,7430070,14796,6151,1992,11961,2008,8645,2835,1.0,0.0,22,7.0,3,4,525,14.0,0.5216971635818481,-0.026059802621603012
9382154,5338573,6983758,14796,6802,1994,10967,2006,7994,3829,0.3333333333333333,0.0,3,5.0,7,6,4319,749.0,0.5628783106803894,0.2478146106004715
9384339,7369508,8145142,14796,11814,2008,13235,2012,2982,1561,0.5,0.5,64,4.0,5,2,56,672.0,0.21940724551677704,0.014823672361671925
9386944,4895156,6727213,14803,5136,1990,10344,2004,9667,4459,1.0,0.0,172,8.0,9,3,14,847.0,0.4252813756465912,0.21576425433158875
9387371,7186190,8413966,14803,11387,2007,13613,2013,3416,1190,1.0,0.0,115,2.0,65,8,7,231.0,0.6790674924850464,0.09517143666744232
9388418,6005087,8096229,14803,8755,1999,13165,2012,6048,1638,0.0,0.0,93,1.0,17,24,7,1638.0,0.39943861961364746,-0.06596100330352783
9387648,6995891,5176981,14803,10995,2006,6214,1993,3808,8589,0.25,0.0,15,2.0,2,4,56,7854.0,0.4633956849575043,0.23919472098350525
9389729,7027974,5323008,14803,11058,2006,6746,1994,3745,8057,0.0,0.0,205,49.0,62,8,28,84.0,0.25063785910606384,0.35887062549591064
9387253,5780052,7559116,14803,8230,1998,12248,2009,6573,2555,0.5,0.0,35,2.0,2,4,175,693.0,0.23412147164344788,0.06252557039260864
9387544,6032390,6301869,14803,8832,2000,9420,2001,5971,5383,0.0,0.0,23,4.0,19,13,84,763.0,0.2850651741027832,0.353106290102005
9387001,6458145,5088555,14803,9770,2002,5892,1992,5033,8911,1.0,0.0,111,8.0,11,3,35,658.0,0.18815863132476807,0.1763499528169632
9387122,4954960,6735575,14803,5360,1990,10358,2004,9443,4445,0.0,0.0,54,19.0,10,5,0,147.0,0.2380293905735016,0.2026667445898056
9388325,7166235,7404597,14803,11345,2007,11898,2008,3458,2905,0.0,0.0,16,5.0,41,10,49,903.0,0.42029595375061035,0.03083590790629387
9394106,7240885,4082756,14810,11513,2007,824,1978,3297,13986,0.0,0.0,15,4.0,6,1,0,1974.0,0.38519763946533203,0.032853852957487106
9396607,5935002,6039948,14810,8622,1999,8846,2000,6188,5964,0.3333333333333333,0.0,486,3.0,6,9,7,616.0,0.3980376720428467,0.15463922917842865
9398211,7450839,4791381,14810,12003,2008,4730,1988,2807,10080,0.5,0.0,6,7.0,1,2,140,5383.0,0.5208092331886292,0.13992641866207123
9395055,7857457,4198649,14810,12780,2010,1566,1980,2030,13244,0.25,0.0,27,12.0,60,2,70,4200.0,0.5038202404975891,0.09262240678071976
9397346,8153318,7349702,14810,13249,2012,11772,2008,1561,3038,1.0,0.0,9,4.0,19,4,42,7.0,0.761234700679779,0.22443649172782898
9393375,6772761,5124064,14810,10449,2004,6018,1992,4361,8792,1.0,0.0,7,5.0,16,11,427,4543.0,0.3785557746887207,0.13198192417621613
9396752,6812456,7545488,14810,10533,2004,12213,2009,4277,2597,0.0,0.0,60,2.0,18,5,777,1666.0,0.2715699374675751,0.22114498913288116
9397562,7639059,4564276,14810,12416,2009,3666,1986,2394,11144,0.0,0.0,10,8.0,4,1,294,4228.0,0.5490972399711609,0.27784037590026855
9394179,5692525,5739263,14810,8006,1997,8139,1998,6804,6671,0.5,0.0,93,4.0,70,5,7,1288.0,0.4817611873149872,0.18051379919052124
9395589,7075610,6495059,14810,11149,2006,9847,2002,3661,4963,1.0,0.0,15,4.0,9,2,364,1379.0,0.6759437322616577,0.240709125995636
9398751,9084401,5964619,14817,14446,2015,8685,1999,371,6132,1.0,0.0,1,2.0,12,39,371,2156.0,0.9504802823066711,0.16550244390964508
9401599,4488136,4698140,14817,3267,1984,4296,1987,11550,10521,0.5,0.0,60,3.0,1,4,35,8267.0,0.3431002199649811,0.029786696657538414
9399752,6407051,8207836,14817,9665,2002,13326,2012,5152,1491,1.0,0.0,26,2.0,17,6,119,1015.0,0.6021153926849365,0.1482633799314499
9399230,4905775,4386771,14817,5178,1990,2714,1983,9639,12103,0.0,0.0,16,12.0,14,1,35,462.0,0.5150787234306335,0.2410821169614792
9401854,8761029,4253976,14817,14054,2014,1888,1981,763,12929,1.0,0.0,1,9.0,3,1,763,5012.0,0.3751838803291321,0.06810958683490753
9401678,8718582,8454086,14817,14005,2014,13669,2013,812,1148,0.3333333333333333,0.0,52,1.0,16,5,7,1148.0,0.3838541507720947,0.28182700276374817
9398932,6997925,7786621,14817,11002,2006,12661,2010,3815,2156,1.0,0.0,81,2.0,195,4,7,1085.0,0.4885573387145996,0.17248961329460144
9398911,5628446,6624543,14817,7803,1997,10127,2003,7014,4690,1.0,0.0,478,7.0,44,7,7,1351.0,0.5512897372245789,0.3001154959201813
9407410,6674817,6024379,14824,10232,2004,8811,2000,4592,6013,0.3333333333333333,0.0,27,5.0,4,19,154,2982.0,0.450274795293808,-0.016324052587151527
9402625,6152937,6062697,14824,9098,2000,8902,2000,5726,5922,1.0,0.0,294,18.0,31,13,7,35.0,0.4668867886066437,0.22855962812900543
9407897,8150238,4182809,14824,13242,2012,1468,1980,1582,13356,0.5,0.0,4,5.0,22,2,70,8701.0,0.47533366084098816,0.21338064968585968
9402506,6062130,7009201,14824,8902,2000,11023,2006,5922,3801,0.5,0.0,13,3.0,9,2,14,1043.0,0.7121703028678894,0.04732474312186241
9403013,5002053,8805732,14824,5563,1991,14103,2014,9261,721,1.0,0.0,139,1.0,4,87,14,721.0,0.464665949344635,0.12117793411016464
9407867,7362776,5487762,14824,11800,2008,7334,1996,3024,7490,1.0,0.0,45,3.0,7,8,14,1687.0,0.3210626244544983,0.10087628662586212
9402935,6306144,4400983,14824,9427,2001,2798,1983,5397,12026,1.0,0.0,112,2.0,30,1,42,3885.0,0.1254488080739975,0.05637078732252121
9406202,5820460,8878843,14824,8321,1998,14187,2014,6503,637,0.5,0.0,172,1.0,14,1,0,637.0,0.40580302476882935,0.10212009400129318
9402555,6690963,4705849,14824,10267,2004,4331,1987,4557,10493,1.0,0.5,427,15.0,53,3,7,3766.0,0.4140830636024475,0.07656947523355484
9402470,8295044,6450688,14824,13445,2012,9756,2002,1379,5068,0.3333333333333333,0.0,4,14.0,7,12,490,301.0,0.40360596776008606,0.14092355966567993
9407796,6498863,4790442,14824,9854,2002,4730,1988,4970,10094,0.0,0.0,49,26.0,21,11,7,70.0,0.3086264431476593,0.2717427909374237
9402626,5413268,4871035,14824,7068,1995,5024,1989,7756,9800,1.0,0.0,418,10.0,61,1,7,3752.0,0.4210425317287445,0.22981101274490356
9402550,7079977,7588283,14824,11156,2006,12311,2009,3668,2513,0.5,0.0,90,2.0,65,5,98,2009.0,0.6168534159660339,0.031832505017519
9405773,6763148,4187762,14824,10421,2004,1503,1980,4403,13321,1.0,0.0,72,8.0,56,3,147,1449.0,0.4159449338912964,0.24888698756694794
9410344,8833117,4198304,14831,14138,2014,1566,1980,693,13265,1.0,0.0,3,7.0,8,1,112,7581.0,0.4169037938117981,0.11369332671165466
9412143,8782726,4262301,14831,14075,2014,1930,1981,756,12901,0.3333333333333333,0.3333333333333333,5,45.0,297,10,217,28.0,0.30107975006103516,0.38736671209335327
9411390,6775776,8048022,14831,10449,2004,13088,2011,4382,1743,0.0,0.0,65,1.0,5,77,21,1743.0,0.44949859380722046,0.2563415467739105
9409425,5536092,5566918,14831,7502,1996,7600,1996,7329,7231,1.0,0.0,41,13.0,7,6,7,1421.0,0.7409750819206238,0.3887115716934204
9411748,5774700,7517082,14831,8216,1998,12157,2009,6615,2674,0.5,0.0,34,4.0,4,1,7,329.0,0.21505852043628693,0.11265088617801666
9414016,8363908,4406252,14831,13543,2013,2826,1983,1288,12005,0.5,0.0,2,7.0,90,1,350,2751.0,0.40619632601737976,0.04993835836648941
9411498,6037937,5709176,14831,8839,2000,8055,1998,5992,6776,1.0,0.0,149,4.0,15,1,56,2688.0,0.3788266181945801,0.213735431432724
9413891,6681239,6100906,14831,10246,2004,8986,2000,4585,5845,0.3333333333333333,0.3333333333333333,50,38.0,8,1,91,175.0,0.2240738570690155,0.24338218569755554
9419295,6383251,6211890,14838,9623,2002,9224,2001,5215,5614,0.125,0.0,16,21.0,2,2,70,21.0,0.3582596182823181,0.055776603519916534
9414870,6193723,4790026,14838,9189,2001,4723,1988,5649,10115,1.0,0.0,34,26.0,16,8,7,3514.0,0.12530206143856049,0.10055472701787949
9417190,5928907,7240007,14838,8608,1999,11506,2007,6230,3332,0.5,0.0,159,13.0,13,16,7,56.0,0.3821406364440918,0.22269868850708008
9417110,5792603,4091208,14838,8258,1998,873,1978,6580,13965,0.0,0.0,79,3.0,17,1,7,3787.0,0.48224779963493347,0.12130430340766907
9414752,5053008,5409536,14838,5752,1991,7054,1995,9086,7784,1.0,0.0,649,3.0,5,3,14,2191.0,0.5182758569717407,0.2717911899089813
9414777,6106486,4555725,14838,9000,2000,3617,1985,5838,11221,1.0,0.0,41,8.0,9,5,196,84.0,0.24212919175624847,0.11038234084844589
9415439,4474225,6159689,14838,3197,1984,9112,2000,11641,5726,1.0,0.0,11,7.0,1,5,406,483.0,0.7927536368370056,0.1270645260810852
9417005,5611211,5566009,14838,7747,1997,7593,1996,7091,7245,1.0,0.0,13,42.0,7,8,1029,350.0,0.4852324426174164,0.3369247019290924
9415013,7419686,4230360,14838,11933,2008,1762,1980,2905,13076,1.0,0.0,55,15.0,175,1,14,364.0,0.4110531508922577,0.06629162281751633
9414935,5676699,4296576,14838,7957,1997,2126,1981,6881,12712,1.0,0.0,92,15.0,13,2,14,2093.0,0.34513765573501587,0.39346081018447876
9414822,6517498,6444073,14838,9903,2003,9742,2002,4935,5096,1.0,0.0,167,14.0,91,5,14,70.0,0.45712125301361084,0.2224547266960144
9415355,6568660,6233468,14838,10008,2003,9266,2001,4830,5572,0.5,0.0,24,4.0,2,2,119,70.0,0.40581265091896057,0.28612151741981506
9416245,8210769,5609721,14838,13333,2012,7740,1997,1505,7098,0.5,0.0,1,26.0,42,7,1505,126.0,0.5531960725784302,0.07935938239097595
9418381,6230970,6866960,14838,9266,2001,10666,2005,5572,4172,1.0,0.0,62,6.0,18,5,126,798.0,0.41816437244415283,0.16821672022342682
9419810,6072463,4907989,14838,8923,2000,5185,1990,5915,9653,0.5,0.0,53,7.0,14,2,273,1372.0,0.5906100869178772,0.1751198172569275
9418361,7660397,4345892,14838,12458,2010,2427,1982,2380,12411,0.5,0.0,23,27.0,12,2,14,1141.0,0.2721898853778839,0.22965103387832642
9419013,8928149,8605531,14838,14250,2015,13858,2013,588,980,1.0,0.0,2,9.0,4,5,91,28.0,0.44778016209602356,0.2786419689655304
9421029,5617858,4584648,14845,7768,1997,3764,1986,7077,11081,1.0,0.0,97,17.0,11,9,63,2485.0,0.15006603300571442,0.02650858834385872
9423089,7364332,4173747,14845,11807,2008,1405,1979,3038,13440,0.5,0.0,4,3.0,17,1,1050,252.0,0.599402129650116,0.21594876050949097
9423127,4509499,4165536,14845,3386,1985,1328,1979,11459,13517,0.5,0.0,6,2.0,2,3,343,12572.0,0.4513627886772156,0.21042993664741516
9424473,6393054,7040507,14845,9637,2002,11086,2006,5208,3759,0.0,0.0,53,2.0,8,6,56,161.0,0.5416135787963867,0.12450344115495682
9421062,7643378,4197323,14845,12423,2010,1559,1980,2422,13286,0.0,0.0,21,6.0,21,8,49,875.0,0.31597182154655457,0.24552452564239502
9422732,8051868,5485553,14845,13095,2011,7320,1996,1750,7525,1.0,0.0,3,15.0,8,8,455,105.0,0.29356470704078674,0.08038172125816345
9421261,6887260,6438719,14845,10715,2005,9728,2002,4130,5117,0.5,0.0,82,5.0,63,15,0,700.0,0.590027391910553,0.14858761429786682
9425616,4935645,4899138,14845,5283,1990,5150,1990,9562,9695,0.0,0.0,63,38.0,3,14,2205,14.0,0.3171350657939911,0.17823655903339386
9421002,5282477,4330749,14845,6606,1994,2329,1982,8239,12516,0.5,0.5,66,22.0,3,2,91,1232.0,0.6426045894622803,0.23881328105926514
9425306,5808340,6172556,14845,8293,1998,9140,2001,6552,5705,1.0,0.0,20,16.0,10,2,1176,133.0,0.6354752779006958,0.4186847507953644
9423192,7372697,5969052,14845,11821,2008,8692,1999,3024,6153,0.25,0.0,7,17.0,11,13,1393,21.0,0.6396222114562988,0.2035910189151764
9425058,5918116,5931959,14845,8580,1999,8615,1999,6265,6230,1.0,0.0,63,15.0,25,2,7,413.0,0.37385180592536926,0.1465124785900116
9431020,5951235,6881217,14852,8657,1999,10701,2005,6195,4151,0.0,0.0,19,2.0,7,6,49,1015.0,0.19375459849834442,0.05882366746664047
9427248,5595328,5040195,14852,7691,1997,5703,1991,7161,9149,0.0,0.0,26,6.0,2,9,371,2478.0,0.5086142420768738,0.08381863683462143
9427281,7261711,6917442,14852,11562,2007,10785,2005,3290,4067,1.0,0.0,77,2.0,27,10,56,1183.0,0.5339961051940918,0.14711597561836243
9429853,4480910,6194586,14852,3232,1984,9189,2001,11620,5663,1.0,0.0,748,2.0,2,4,0,56.0,0.6016340851783752,0.2111915647983551
9427981,5771803,6827060,14852,8216,1998,10568,2004,6636,4284,0.0,0.0,45,9.0,4,12,7,196.0,0.6475714445114136,0.1727624535560608
9427315,7160322,6473408,14852,11331,2007,9798,2002,3521,5054,1.0,0.0,85,28.0,20,17,7,308.0,0.44754868745803833,0.17361049354076385
9431368,6004865,6550109,14852,8755,1999,9973,2003,6097,4879,1.0,0.0,27,2.0,29,2,21,1078.0,0.5129271149635315,0.2085227221250534
9427142,5135001,4608148,14852,6060,1992,3890,1986,8792,10962,1.0,0.0,115,11.0,17,7,42,651.0,0.35351553559303284,0.20291928946971893
9431068,7487474,4583117,14852,12087,2009,3757,1986,2765,11095,0.0,0.0,79,17.0,8,6,7,42.0,0.21476195752620697,0.16276296973228455
9431311,7187074,7511580,14852,11387,2007,12143,2009,3465,2709,1.0,0.0,7,2.0,1,15,658,2212.0,0.5026534199714661,0.40050870180130005
9432025,6812753,4445981,14852,10533,2004,3043,1984,4319,11809,1.0,0.0,19,3.0,19,1,91,4627.0,0.5317683219909668,0.23938077688217163
9434150,9358775,8488838,14859,14768,2016,13711,2013,91,1148,1.0,0.0,1,4.0,54,15,91,28.0,0.9999998807907104,0.182431161403656
9436838,7143066,6757022,14859,11289,2006,10407,2004,3570,4452,0.5,0.5,78,9.0,412,13,0,98.0,0.4996548593044281,0.23365285992622375
9433938,7220398,4872144,14859,11464,2007,5024,1989,3395,9835,0.0,0.0,66,15.0,19,7,7,63.0,0.36320939660072327,0.15404273569583893
9435343,6805834,7159207,14859,10519,2004,11324,2007,4340,3535,0.0,0.0,39,3.0,13,20,14,1260.0,0.6172112226486206,0.10959865897893906
9433539,5503908,8085395,14859,7397,1996,13144,2011,7462,1715,0.0,0.0,90,2.0,34,1,35,560.0,0.4433665871620178,0.3064410090446472
9438795,8724856,3998451,14859,14012,2014,355,1976,847,14504,0.5,0.0,1,9.0,1,1,847,6902.0,0.5866612792015076,0.31050291657447815
9433853,6132319,4374948,14859,9056,2000,2609,1983,5803,12250,1.0,0.0,8,7.0,2,1,2296,1680.0,0.6836451888084412,-0.005369469057768583
9436824,6735700,7997849,14859,10358,2004,13011,2011,4501,1848,1.0,0.0,69,5.0,4,5,154,252.0,0.41065675020217896,0.19362318515777588
9442545,8634099,4536550,14866,13900,2014,3519,1985,966,11347,1.0,0.0,1,19.0,1,2,966,154.0,0.36675789952278137,-0.05364925041794777
9440322,8087650,6404909,14866,13151,2012,9658,2002,1715,5208,0.5,0.0,5,3.0,3,16,763,2569.0,0.4827265739440918,0.23875638842582703
9444633,8755265,4167040,14866,14047,2014,1342,1979,819,13524,1.0,0.0,2,16.0,1,5,133,483.0,0.8141505122184753,0.3804244101047516
9442267,5363466,4168077,14866,6886,1994,1356,1979,7980,13510,1.0,0.0,88,3.0,4,1,14,5411.0,0.3407002091407776,0.21115975081920624
9440096,6113558,7738618,14866,9014,2000,12584,2010,5852,2282,0.5,0.0,215,6.0,3,7,7,189.0,0.5092917084693909,0.02030067890882492
9440773,6561383,6241659,14866,9994,2003,9287,2001,4872,5579,0.0,0.0,39,42.0,6,16,21,217.0,0.5389273166656494,0.3533309996128082
9445003,8360574,4489210,14866,13543,2013,3274,1984,1323,11592,0.0,0.0,83,28.0,71,3,7,280.0,0.2858163118362427,0.2236894816160202
9442486,6752231,7425216,14866,10400,2004,11947,2008,4466,2919,0.2,0.0,9,5.0,9,145,14,910.0,0.592674732208252,0.04478197917342186
9443469,8164546,5082454,14866,13263,2012,5864,1992,1603,9002,1.0,0.0,4,23.0,1,28,490,56.0,0.5791236758232117,0.12280820310115814
9440535,6710908,4608597,14866,10309,2004,3890,1986,4557,10976,0.0,0.25,423,6.0,65,2,7,119.0,0.09068546444177628,0.3244299292564392
9439557,4899732,6511273,14866,5157,1990,9889,2003,9709,4977,1.0,0.0,55,12.0,1,4,98,602.0,0.3612518012523651,0.2945626378059387
9439631,6554779,4626853,14866,9980,2003,3988,1986,4886,10878,1.0,0.0,133,14.0,98,2,7,21.0,0.6104697585105896,0.26562342047691345
9439720,5527331,8354978,14866,7474,1996,13529,2013,7392,1337,1.0,0.0,261,4.0,15,70,0,14.0,0.6793010234832764,0.06827543675899506
9443518,8370145,5373397,14866,13550,2013,6921,1994,1316,7945,0.5,0.0,7,6.0,4,4,28,259.0,0.46267634630203247,0.15972553193569183
9440179,6981502,5128211,14866,10960,2006,6032,1992,3906,8834,0.3333333333333333,0.0,13,4.0,18,7,0,4151.0,0.39696720242500305,0.1878260374069214
9441156,5585640,5381119,14866,7656,1996,6949,1995,7210,7917,0.0,0.16666666666666666,202,10.0,1,2,35,1960.0,0.5427227020263672,0.027514474466443062
9448165,7751192,5194821,14873,12605,2010,6284,1993,2268,8589,0.0,0.0,9,11.0,32,3,0,14.0,0.00489537650719285,0.10232595354318619
9450603,5729228,4742136,14873,8111,1998,4506,1988,6762,10367,1.0,0.0,121,10.0,5,3,21,504.0,0.5522519946098328,0.10557417571544647
9450522,4454461,4788712,14873,3085,1984,4716,1988,11788,10157,0.5,0.0,5,5.0,1,11,455,1029.0,0.5651549696922302,0.18990106880664825
9445811,5571116,5544195,14873,7614,1996,7523,1996,7259,7350,1.0,0.0,854,6.0,46,8,0,357.0,0.47876787185668945,0.2301025688648224
9447244,6936663,4782350,14873,10834,2005,4688,1988,4039,10185,1.0,0.0,14,29.0,18,2,49,1036.0,0.3118251860141754,0.2109089493751526
9445813,5222975,4470757,14873,6389,1993,3176,1984,8484,11697,1.0,0.0,358,4.0,6,1,7,21.0,0.255740225315094,0.26488226652145386
9445811,8308042,4383442,14873,13466,2012,2693,1983,1407,12180,1.0,0.0,194,1.0,98,3,7,12180.0,0.37252798676490784,0.23393064737319946
9447642,6095265,6485147,14873,8979,2000,9826,2002,5894,5047,0.5,0.0,58,12.0,4,3,14,49.0,0.5166957974433899,0.21400094032287598
9455771,8410775,8741029,14880,13606,2013,14033,2014,1274,847,0.0,0.0,4,1.0,9,6,63,847.0,0.37646374106407166,0.11458873003721237
9451956,6607555,4006457,14880,10092,2003,397,1977,4788,14483,1.0,0.0,63,15.0,11,1,7,4375.0,0.34108445048332214,0.13300924003124237
9453933,7654009,5736258,14880,12451,2010,8132,1998,2429,6748,1.0,0.0,1,13.0,5,2,2429,1288.0,0.3904937505722046,0.08278165757656097
9451959,7682367,4591543,14880,12500,2010,3799,1986,2380,11081,1.0,0.0,31,7.0,23,1,7,8582.0,0.5541483759880066,0.33508333563804626
9453613,6753143,4157400,14880,10400,2004,1251,1979,4480,13629,0.0,0.0,11,4.0,31,2,49,224.0,0.032960645854473114,0.025906646624207497
9455853,8094710,4025450,14880,13158,2012,509,1977,1722,14371,0.0,0.0,5,14.0,6,1,812,1120.0,0.33744943141937256,0.12339173257350922
9460617,8676401,6696758,14887,13956,2014,10281,2004,931,4606,0.25,0.0,5,27.0,11,18,77,763.0,0.29149872064590454,0.24956262111663818
9460698,7285716,5124627,14887,11618,2007,6018,1992,3269,8869,1.0,0.0,4,19.0,5,2,1169,1715.0,0.6156190633773804,0.27362433075904846
9460474,5649104,4784293,14887,7866,1997,4702,1988,7021,10185,1.0,0.0,624,10.0,12,5,0,2723.0,0.3155357837677002,0.21230928599834442
9460907,7180230,6719730,14887,11373,2007,10330,2004,3514,4557,0.5,0.0,13,23.0,5,152,182,14.0,0.41373053193092346,0.14312376081943512
9456896,8323335,5989819,14887,13487,2012,8727,1999,1400,6160,1.0,0.0,54,8.0,125,1,35,1771.0,0.499855101108551,0.09369587153196335
9458649,7283034,8307915,14887,11611,2007,13466,2012,3276,1421,0.3333333333333333,0.0,12,3.0,10,29,98,119.0,0.365243136882782,0.131014883518219
9461410,7163421,4542707,14887,11338,2007,3554,1985,3549,11333,1.0,0.0,70,2.0,4,3,14,9506.0,0.664448618888855,0.28445810079574585
9460469,7536354,4928990,14887,12192,2009,5262,1990,2695,9625,0.5,0.0,108,5.0,287,8,147,4725.0,0.3796994984149933,0.12556400895118713
9456769,6993393,4393257,14887,10988,2006,2749,1983,3899,12138,1.0,0.0,152,4.0,63,4,49,11130.0,0.26387208700180054,0.0865698754787445
9462783,7370605,4193766,14894,11821,2008,1538,1980,3073,13356,0.5,0.0,6,12.0,22,2,308,4816.0,0.6257310509681702,0.1938866376876831
9464703,7930949,4402321,14894,12899,2011,2805,1983,1995,12089,1.0,0.0,3,7.0,1,1,868,910.0,0.28707730770111084,0.3063808083534241
9465770,7797393,4267012,14894,12675,2010,1958,1981,2219,12936,0.5,0.0,12,46.0,4,6,21,1344.0,0.4599149525165558,0.17497311532497406
9466061,7802722,4168189,14894,12689,2010,1356,1979,2205,13538,0.5,0.0,8,7.0,6,6,63,5411.0,0.260687917470932,0.04487169161438942
9467288,4301486,4061705,14894,2147,1981,705,1977,12747,14189,0.0,0.0,19,5.0,7,2,630,497.0,0.3480129539966583,0.13071586191654205
9463041,6324432,8024173,14894,9462,2001,13046,2011,5432,1848,1.0,0.0,104,5.0,12,13,0,105.0,0.24672608077526093,0.20743247866630554
9470505,4985691,5268761,14901,5493,1991,6550,1993,9408,8351,0.0,0.0,29,11.0,8,6,70,1183.0,0.4878336489200592,0.1661142110824585
9474156,6927083,5055007,14901,10813,2005,5759,1991,4088,9142,0.3333333333333333,0.0,9,8.0,149,1,518,525.0,0.44775524735450745,0.15968944132328033
9473576,8074289,7539205,14901,13123,2011,12199,2009,1778,2702,0.0,1.0,29,3.0,15,10,0,1981.0,0.502231240272522,0.4170655906200409
9468438,8397971,7297698,14901,13592,2013,11646,2007,1309,3255,1.0,0.5,144,4.0,1166,1,14,840.0,0.220637246966362,0.07286384701728821
9471835,6950535,7343109,14901,10862,2005,11758,2008,4039,3143,0.5,0.0,62,4.0,3,9,7,917.0,0.5563054084777832,0.400182843208313
9479064,8143800,5019352,14908,13235,2012,5626,1991,1673,9282,0.0,0.0,4,5.0,4,1,56,3094.0,0.44378066062927246,0.17067137360572815
9478438,7776733,4338048,14908,12647,2010,2378,1982,2261,12530,0.5,0.0,20,9.0,8,6,0,931.0,0.5233333110809326,0.18587744235992432
9477967,7072847,4162607,14908,11142,2006,1307,1979,3766,13601,1.0,0.0,28,6.0,14,2,7,2632.0,0.3717346489429474,0.2263004034757614
9475138,4993890,7546699,14908,5528,1991,12220,2009,9380,2688,1.0,0.0,4,6.0,3,176,2317,182.0,0.5243716239929199,0.20949144661426544
9476234,4334573,6162487,14908,2357,1982,9119,2000,12551,5789,0.5,0.0,15,23.0,2,14,21,63.0,0.5681788921356201,0.1668325513601303
9475508,5802982,7184173,14908,8286,1998,11380,2007,6622,3528,0.0,0.0,34,3.0,4,15,154,469.0,0.6103207468986511,0.2010217308998108
9474523,6454777,8932077,14908,9763,2002,14257,2015,5145,651,1.0,0.0,36,1.0,8,4,28,651.0,0.6605326533317566,0.38697487115859985
9476895,5948360,7512607,14908,8650,1999,12143,2009,6258,2765,1.0,0.0,79,3.0,26,8,112,1113.0,0.5770102739334106,0.3408602178096771
9476013,6211141,3978446,14908,9224,2001,243,1976,5684,14665,1.0,0.0,3,11.0,3,1,2443,1190.0,0.49105358123779297,0.12282873690128326
9483850,6963065,6227279,14915,10904,2005,9259,2001,4011,5656,0.0,0.0,9,5.0,3,1,1610,1778.0,0.5135907530784607,0.08568413555622101
9482514,5440112,5341695,14915,7159,1995,6816,1994,7756,8099,0.5,0.5,39,9.0,7,2,14,105.0,0.42589813470840454,0.2379898875951767
9480378,8813297,5481009,14915,14117,2014,7306,1996,798,7609,0.0,0.0,1,3.0,15,1,798,3262.0,0.6202666163444519,0.20480355620384216
9483405,7177950,7587356,14915,11366,2007,12304,2009,3549,2611,1.0,1.0,25,16.0,15,12,161,840.0,0.2508889138698578,0.008129483088850975
9482124,8051645,5137773,14915,13095,2011,6067,1992,1820,8848,0.3333333333333333,0.0,7,11.0,9,10,294,1316.0,0.5864886045455933,0.009273835457861423
9483568,6185558,5044639,14915,9168,2001,5724,1991,5747,9191,1.0,0.0,361,4.0,7,1,7,84.0,0.40532633662223816,0.23111887276172638
9490981,8024775,6053997,14922,13046,2011,8881,2000,1876,6041,0.5,0.0,15,3.0,8,12,161,994.0,0.46551063656806946,0.003961678594350815
9490857,5664005,5817406,14922,7915,1997,8314,1998,7007,6608,1.0,0.0,209,13.0,81,6,210,140.0,0.38684067130088806,0.12294036149978638
9488520,6060321,4384620,14922,8895,2000,2700,1983,6027,12222,0.3333333333333333,0.0,37,15.0,18,1,98,343.0,0.525423526763916,0.1346689611673355
9486421,re37947,8808564,14922,9861,2002,14110,2014,5061,812,0.5,0.0,8,1.0,2,2,1302,812.0,0.38101640343666077,0.12211431562900543
9487891,5735145,4993941,14922,8132,1998,5528,1991,6790,9394,0.5,0.0,92,14.0,23,8,0,4228.0,0.06817226111888885,0.27697256207466125
9489804,6089980,7573089,14922,8965,2000,12276,2009,5957,2646,0.0,0.0,435,5.0,10,4,7,539.0,0.4988645613193512,0.1499810367822647
9491895,4360857,4549756,14922,2518,1982,3589,1985,12404,11333,0.3333333333333333,0.0,9,9.0,3,3,175,2198.0,0.4772146940231323,0.30835220217704773
9486618,5058605,6275114,14922,5773,1991,9357,2001,9149,5565,1.0,0.0,105,7.0,8,11,84,91.0,0.4347953796386719,0.25583788752555847
9486237,6183432,8081644,14922,9168,2001,13137,2011,5754,1785,1.0,0.0,103,3.0,12,2,49,21.0,0.4152695834636688,0.20117609202861786
9489009,6978391,7399500,14922,10946,2005,11884,2008,3976,3038,0.5,0.0,2,6.0,4,8,3052,35.0,0.44279980659484863,0.2381342053413391
9490864,6643522,4812233,14922,10169,2003,4821,1989,4753,10101,1.0,0.0,63,17.0,9,4,7,1022.0,0.5103859901428223,0.07638724893331528
9493011,7530668,4784994,14929,12185,2009,4702,1988,2744,10227,0.5,0.0,9,11.0,2,6,924,2450.0,0.44638821482658386,0.11137932538986206
9496243,6781220,5883638,14929,10463,2004,8475,1999,4466,6454,0.5,0.0,40,16.0,3,5,14,1393.0,0.5814378261566162,0.28990909457206726
9492818,6663768,4929221,14929,10211,2003,5262,1990,4718,9667,0.25,0.0,18,5.0,33,5,1085,4907.0,0.24309749901294708,-0.05703612044453621
9494854,8644588,7501082,14929,13914,2014,12122,2009,1015,2807,0.5,0.0,4,4.0,51,3,70,217.0,0.5085808038711548,0.1827937662601471
9492315,4111201,5372540,14929,978,1978,6921,1994,13951,8008,1.0,0.0,104,19.0,9,14,21,245.0,0.5598469972610474,0.15397216379642487
9494616,7828575,5515585,14929,12731,2010,7439,1996,2198,7490,0.0,0.0,4,11.0,5,13,70,1820.0,0.529759407043457,0.19163978099822998
9495673,6490443,8715318,14929,9833,2002,14005,2014,5096,924,0.3333333333333333,0.0,381,1.0,176,59,28,924.0,0.4611661732196808,0.30389925837516785
9496402,8826213,6355700,14929,14124,2014,9567,2002,805,5362,0.0,0.0,11,7.0,8,3,0,245.0,0.31389445066452026,0.17816074192523956
9495984,6700759,7087752,14929,10288,2004,11177,2006,4641,3752,0.5,0.0,133,5.0,16,29,14,1407.0,0.29948505759239197,0.1928051859140396
9492820,6238910,7420319,14929,9280,2001,11933,2008,5649,2996,0.0,0.0,49,2.0,5,6,84,182.0,0.35930362343788147,0.28449520468711853
9498160,6060327,7995574,14936,8895,2000,13004,2011,6041,1932,0.0,0.0,242,7.0,67,9,7,609.0,0.38583970069885254,0.19870631396770477
9498227,7510562,4215756,14936,12143,2009,1678,1980,2793,13258,1.0,0.0,29,7.0,8,1,21,581.0,0.3810148537158966,0.29304248094558716
9498217,8192457,4296011,14936,13305,2012,2119,1981,1631,12817,1.0,0.0,7,18.0,32,3,231,14.0,1.0000001192092896,0.032753836363554
9499964,5439025,4080187,14936,7159,1995,810,1978,7777,14126,0.5,0.0,21,6.0,10,1,511,4508.0,0.513653039932251,0.11344825476408005
9500731,6100676,4049839,14936,8986,2000,628,1977,5950,14308,0.0,0.0,75,6.0,16,1,448,7665.0,0.2179708331823349,-0.020004823803901672
9498196,4832688,4912241,14936,4891,1989,5199,1990,10045,9737,1.0,0.0,256,3.0,5,1,14,8435.0,0.37580323219299316,0.28405120968818665
9503289,6067626,8693157,14936,8909,2000,13977,2014,6027,959,0.5,0.0,6,1.0,5,5,504,959.0,0.4308406710624695,0.22824089229106903
9501802,5444477,5116659,14936,7173,1995,5990,1992,7763,8946,0.5,0.0,24,30.0,2,8,175,77.0,0.38584503531455994,0.07715973258018494
9498391,6960834,4264227,14936,10897,2005,1944,1981,4039,12992,0.0,0.0,16,7.0,6,1,0,4634.0,0.2753203809261322,0.13232457637786865
9509054,6549167,4782534,14943,9966,2003,4695,1988,4977,10248,0.5,0.0,31,14.0,1,3,28,112.0,0.4425548315048218,0.16210386157035828
9509133,7505747,8154194,14943,12129,2009,13249,2012,2814,1694,0.5,0.0,39,1.0,4,6,14,1694.0,0.46391916275024414,0.1759754866361618
9505108,7131358,6582594,14943,11268,2006,10036,2003,3675,4907,0.5,0.0,24,1.0,3,5,140,4907.0,0.5275635123252869,-0.004067542031407356
9508058,8942684,5109104,14943,14271,2015,5962,1992,672,8981,0.0,0.0,1,15.0,1,1,672,49.0,0.7028178572654724,0.050352297723293304
9508359,5818945,4291107,14943,8314,1998,2091,1981,6629,12852,0.5,0.0,28,20.0,1,2,525,1680.0,0.4689556062221527,0.024238036945462227
9509269,7348967,4274494,14943,11772,2008,2000,1981,3171,12943,0.0,0.0,53,5.0,109,2,14,2660.0,0.5064799785614014,0.17137712240219116
9509054,7256743,9111424,14943,11548,2007,14474,2015,3395,469,0.5,0.0,55,1.0,3,5,28,469.0,0.5066537261009216,0.2218903750181198
9504455,8967443,5588737,14943,14306,2015,7670,1996,637,7273,0.5,0.0,56,8.0,96,15,7,21.0,0.4598860740661621,0.385017067193985
9504413,7831287,8464851,14943,12731,2010,13683,2013,2212,1260,0.5,0.0,81,5.0,298,6,7,147.0,1.0,0.24839691817760468
9513675,5243493,5138459,14950,6459,1993,6067,1992,8491,8883,0.5,0.0,45,14.0,10,15,847,77.0,0.5383109450340271,0.19571718573570251
9513930,5504675,5547296,14950,7397,1996,7537,1996,7553,7413,1.0,0.0,306,6.0,7,11,7,1190.0,0.16434936225414276,0.14774367213249207
9511100,5599795,4947371,14950,7705,1997,5332,1990,7245,9618,0.5,0.0,49,2.0,3,4,0,8337.0,0.30026352405548096,0.17311757802963257
9514466,7853881,4364468,14950,12766,2010,2546,1982,2184,12404,1.0,0.0,167,3.0,4,1,7,4403.0,0.3794979751110077,0.12120811641216278
9514137,7392421,7518618,14950,11863,2008,12157,2009,3087,2793,1.0,0.0,96,8.0,10,14,42,252.0,0.146119624376297,0.11363290250301361
9512759,7104784,4059176,14950,11212,2006,691,1977,3738,14259,0.0,0.0,19,7.0,1,1,56,2485.0,0.5438963770866394,0.3137383460998535
9511866,4611491,5684922,14950,3911,1986,7978,1997,11039,6972,0.0,0.0,19,21.0,1,7,189,392.0,0.059289466589689255,0.2590440511703491
9512759,5974780,6075024,14950,8706,1999,8930,2000,6244,6020,0.3333333333333333,0.0,13,2.0,1,3,56,3605.0,0.4016520082950592,0.16130365431308746
9511274,7222855,8258403,14950,11471,2007,13396,2012,3479,1554,0.5,0.0,32,1.0,54,6,7,1554.0,0.3465214967727661,0.08283602446317673
9519924,7792738,5211856,14957,12668,2010,6347,1993,2289,8610,0.3333333333333333,0.0,22,10.0,1,6,0,2807.0,0.24132563173770905,0.12538181245326996
9519095,7223004,4144875,14957,11471,2007,1174,1979,3486,13783,0.5,0.0,9,14.0,5,5,91,280.0,0.5022177696228027,0.25052544474601746
9517732,6078669,4463070,14957,8937,2000,3134,1984,6020,11823,0.5,0.0,48,4.0,21,2,238,945.0,0.4308084547519684,0.21429046988487244
9520854,8604864,5675092,14957,13858,2013,7950,1997,1099,7007,0.5,0.0,11,7.0,167,1,28,2345.0,0.3591204583644867,0.13758967816829681
9521726,6528782,4072716,14957,9924,2003,768,1978,5033,14189,0.3333333333333333,0.0,46,2.0,1,1,21,4599.0,0.43459299206733704,0.06712854653596878
9519559,5898158,7679919,14957,8517,1999,12493,2010,6440,2464,0.5,0.0,31,5.0,4,11,112,763.0,0.38932594656944275,0.17960801720619202
9517063,5562241,8674001,14957,7586,1996,13956,2014,7371,1001,1.0,0.0,586,2.0,26,15,7,567.0,0.5393339395523071,0.1592760682106018
9516997,7733497,4041352,14957,12577,2010,586,1977,2380,14371,0.3333333333333333,0.0,89,21.0,245,2,7,147.0,0.5319362878799438,0.35141339898109436
9525619,6765921,4080651,14964,10428,2004,810,1978,4536,14154,1.0,0.0,110,2.0,2,3,63,2163.0,0.5482071042060852,0.21904119849205017
9522283,5964787,5956929,14964,8685,1999,8671,1999,6279,6293,1.0,0.0,26,2.0,8,18,217,3444.0,0.3837277293205261,0.07022706419229507
9522115,4160020,5401767,14964,1279,1979,7026,1995,13685,7938,1.0,1.0,246,4.0,1,15,7,6300.0,0.40259769558906555,0.17477372288703918
9524448,8130285,5004702,14964,13214,2012,5570,1991,1750,9394,0.5,0.0,2,18.0,20,2,1092,777.0,0.5198898315429688,0.21665164828300476
9522065,5078676,5342425,14964,5850,1992,6816,1994,9114,8148,1.0,0.0,44,2.0,10,5,140,1470.0,0.3975268006324768,0.09706354141235352
9524235,6836815,4616783,14964,10589,2004,3939,1986,4375,11025,1.0,0.0,93,5.0,5,3,7,3675.0,0.021043624728918076,0.11401459574699402
9525353,8614872,5081563,14964,13872,2013,5857,1992,1092,9107,1.0,0.0,2,14.0,4,16,658,329.0,0.5056837201118469,0.366941899061203
9529113,6163155,5125459,14971,9119,2000,6025,1992,5852,8946,1.0,0.0,121,4.0,16,3,21,2373.0,0.3185213506221771,0.3267285227775574
9532310,7233958,7665024,14971,11492,2007,12465,2010,3479,2506,0.0,0.0,40,9.0,25,15,56,371.0,0.23749282956123352,0.1981830596923828
9527023,6306193,5315395,14971,9427,2001,6718,1994,5544,8253,0.5,0.0,32,5.0,36,1,245,4767.0,0.4491831958293915,0.23578117787837982
9531427,8213758,4229255,14971,13333,2012,1755,1980,1638,13216,0.0,0.0,17,4.0,32,2,7,8316.0,0.1604480743408203,0.32548466324806213
9528966,6846288,4449335,14971,10617,2005,3064,1984,4354,11907,0.5,0.0,44,29.0,17,4,133,126.0,0.5066526532173157,0.17799101769924164
9528789,7823572,7244521,14971,12724,2010,11520,2007,2247,3451,1.0,0.0,32,4.0,13,5,28,392.0,0.5850435495376587,-0.044730812311172485
9527438,8136425,4062487,14971,13228,2012,712,1977,1743,14259,0.3333333333333333,0.0,34,9.0,3,1,14,1701.0,0.39072978496551514,-0.007346197497099638
9526456,5544661,4631249,14971,7530,1996,4009,1986,7441,10962,0.5,0.0,496,9.0,4,6,14,5327.0,0.464764267206192,0.03561371937394142
9529933,8086560,8889621,14971,13144,2011,14201,2014,1827,770,1.0,0.0,4,6.0,4,4,21,63.0,0.6568158268928528,0.06756366789340973
9527739,6683783,3967052,14971,10253,2004,180,1976,4718,14791,0.0,0.0,154,14.0,2,1,63,3052.0,0.3645543158054352,0.02930021658539772
9529378,6443026,7875496,14971,9742,2002,12808,2011,5229,2163,0.0,0.0,5,3.0,7,4,1113,539.0,0.6505007743835449,0.2597326636314392
9530207,6969589,4182688,14971,10925,2005,1468,1980,4046,13503,0.0,0.0,7,11.0,37,1,672,847.0,0.3689213991165161,-0.08198119699954987
9526574,5582609,5137187,14971,7649,1996,6067,1992,7322,8904,1.0,0.0,616,8.0,46,8,7,490.0,0.5350587368011475,0.14361564815044403
9526616,6629534,3989751,14971,10141,2003,306,1976,4830,14665,1.0,0.0,498,7.0,64,1,0,1155.0,0.5174039602279663,0.10508635640144348
9527648,6050412,4706513,14971,8874,2000,4338,1987,6097,10633,0.0,0.0,10,6.0,7,1,1323,5838.0,0.5813632011413574,0.09989209473133087
9535906,8381135,6471607,14978,13564,2013,9798,2002,1414,5180,1.0,0.0,99,9.0,412,5,0,1316.0,0.2803938686847687,0.1356486678123474
9533137,4987181,4678915,14978,5500,1991,4205,1987,9478,10773,1.0,0.0,37,18.0,3,1,112,210.0,0.1458902657032013,0.162767231464386
9533791,6085969,8818966,14978,8958,2000,14117,2014,6020,861,1.0,0.0,39,3.0,7,15,35,406.0,0.3483871817588806,0.1327960342168808
9533751,8538602,7263489,14978,13774,2013,11562,2007,1204,3416,0.5,0.0,2,21.0,4,37,28,7.0,0.7004082202911377,0.24227823317050934
9534165,6333005,8190738,14978,9490,2001,13298,2012,5488,1680,0.0,0.0,23,3.0,40,12,35,707.0,0.2692470848560333,0.21942315995693207
9537050,5283447,4799444,14978,6606,1994,4772,1989,8372,10206,0.5,0.0,69,26.0,8,5,595,532.0,0.5123817324638367,0.059781886637210846
9538325,6771972,9108436,14978,10442,2004,14474,2015,4536,504,0.5,0.0,14,1.0,8,3,21,504.0,0.5606932640075684,0.21875479817390442
9535038,7118206,4913671,14978,11240,2006,5206,1990,3738,9772,0.0,0.0,14,7.0,11,1,189,2877.0,0.2788256108760834,0.14812928438186646
9533182,8060337,5021059,14978,13102,2011,5633,1991,1876,9345,0.0,0.0,13,6.0,22,6,35,35.0,0.516936182975769,0.2691880166530609
9535563,5655117,5982266,14978,7887,1997,8713,1999,7091,6265,0.3333333333333333,0.0,141,5.0,12,15,119,2723.0,0.3093012571334839,0.19017700850963593
9532787,4534351,4422173,14978,3512,1985,2910,1983,11466,12068,0.5,0.0,125,2.0,6,1,7,9576.0,0.487131267786026,0.2907561659812927
9543490,6004881,4165642,14985,8755,1999,1335,1979,6230,13650,1.0,0.0,16,31.0,20,1,112,189.0,0.3309856951236725,0.2690422236919403
9541586,4224672,4968443,14985,1727,1980,5423,1990,13258,9562,0.5,0.0,8,9.0,3,3,1477,1624.0,0.4020722210407257,0.1229638010263443
9542287,7962792,4809809,14985,12948,2011,4814,1989,2037,10171,0.5,0.0,95,3.0,24,5,14,9044.0,0.544284999370575,0.20660609006881714
9543242,6329609,6929522,14985,9476,2001,10820,2005,5509,4165,1.0,0.5,19,3.0,17,1,56,2065.0,0.38167470693588257,0.42154377698898315
9543998,7510126,5118287,14985,12143,2009,5997,1992,2842,8988,0.3333333333333333,0.0,64,5.0,10,4,35,854.0,0.5231130123138428,0.20579592883586884
9544372,8330596,4711187,14985,13494,2012,4359,1987,1491,10626,0.0,0.0,3,8.0,2,5,539,497.0,0.3313572406768799,0.15878048539161682
9540505,8022143,5075960,14985,13046,2011,5843,1991,1939,9142,0.5,0.0,9,8.0,14,4,77,567.0,0.32831791043281555,0.028613658621907234
9541653,8093562,6668705,14985,13158,2012,10225,2003,1827,4760,0.5,0.0,7,3.0,17,1,84,1323.0,0.42032480239868164,0.24893338978290558
9542202,5940517,6418606,14985,8629,1999,9693,2002,6356,5292,0.0,0.0,9,7.0,1,3,294,805.0,0.23291848599910736,0.1482706367969513
9539019,5743850,4326886,14985,8153,1998,2308,1982,6832,12677,1.0,0.0,27,7.0,48,1,21,4417.0,0.4429919123649597,0.07777544111013412
9549022,6449380,6565629,14992,9749,2002,10001,2003,5243,4991,0.5,0.0,28,9.0,9,14,1001,147.0,0.2686629891395569,0.07304263114929199
9547465,7030925,7909904,14992,11065,2006,12864,2011,3927,2128,0.0,0.0,13,1.0,5,7,14,2128.0,0.2648768424987793,0.05044158175587654
9545274,6679668,4671084,14992,10246,2004,4177,1987,4746,10815,0.0,0.0,13,12.0,2,1,49,1190.0,0.32897862792015076,0.1337319016456604
9547470,9219460,8648870,14992,14600,2015,13921,2014,392,1071,0.3333333333333333,0.0,9,1.0,47,2,14,1071.0,0.5161358714103699,0.3448014557361603
9545335,4933843,3980225,14992,5276,1990,257,1976,9716,14735,0.5,0.0,114,13.0,3,1,28,301.0,0.5704189538955688,0.1552278995513916
9547139,6899464,5103367,14992,10743,2005,5941,1992,4249,9051,1.0,0.0,19,21.0,13,4,49,665.0,0.5648708939552307,0.12178398668766022
9545982,6276362,4320371,14992,9364,2001,2266,1982,5628,12726,1.0,0.0,11,5.0,7,2,1540,3514.0,0.4963149130344391,0.3279061019420624
9547736,4609986,6860101,14992,3897,1986,10652,2005,11095,4340,0.25,0.0,356,10.0,6,5,49,1477.0,0.4768986403942108,0.17858825623989105
9545578,5668788,5160326,14992,7929,1997,6151,1992,7063,8841,0.0,0.0,152,39.0,12,45,7,875.0,0.6935665607452393,0.16237343847751617
9549045,6813641,4471572,14992,10533,2004,3183,1984,4459,11809,0.5,0.0,15,6.0,6,3,42,1260.0,0.5684735178947449,0.09813962876796722
9549643,7346939,7417745,14999,11772,2008,11926,2008,3227,3073,0.6666666666666666,0.0,7,7.0,16,4,763,1022.0,0.5745725035667419,0.16152839362621307
9549824,5554191,7066969,14999,7558,1996,11135,2006,7441,3864,1.0,0.0,542,2.0,7,6,7,3220.0,0.4889298677444458,0.15684790909290314
9552261,6826711,5716633,14999,10561,2004,8076,1998,4438,6923,1.0,0.0,434,15.0,83,11,14,14.0,0.382761687040329,0.1299583613872528
9549815,8834563,4503888,14999,14138,2014,3358,1985,861,11641,1.0,0.0,24,9.0,361,2,7,728.0,0.7279086112976074,0.26642051339149475
9549589,6754984,5180484,14999,10407,2004,6228,1993,4592,8771,1.0,0.0,24,5.0,11,14,105,1974.0,0.4047013521194458,0.08520503342151642
9550306,5935367,4572208,14999,8622,1999,3708,1986,6377,11291,0.2,0.25,9,34.0,37,8,308,14.0,0.4317395091056824,0.17019011080265045
9554794,8016881,7914598,15006,13039,2011,12871,2011,1967,2135,1.0,0.0,89,1.0,170,11,42,2135.0,0.0893326997756958,0.25956976413726807
9555145,6346108,4815125,15006,9539,2002,4828,1989,5467,10178,1.0,0.0,13,4.0,4,1,28,5467.0,0.3717716336250305,0.23579055070877075
9556810,5257533,4764934,15006,6515,1993,4611,1988,8491,10395,0.0,0.0,4,11.0,1,3,35,161.0,0.42992812395095825,0.22608725726604462
9555982,5195627,7232075,15006,6291,1993,11492,2007,8715,3514,0.5,0.0,15,4.0,7,5,77,42.0,0.5310891270637512,0.21697254478931427
9555000,4063064,7695439,15006,712,1977,12521,2010,14294,2485,0.0,1.0,369,4.0,2,13,14,1008.0,0.06914298236370087,-0.022644884884357452
9556027,8070922,6293733,15006,13123,2011,9399,2001,1883,5607,0.0,0.0,8,6.0,13,5,77,595.0,0.409673273563385,0.3111635148525238
9559447,6225692,4148101,15006,9252,2001,1188,1979,5754,13818,0.5,0.0,70,3.0,7,1,28,1092.0,0.3915248215198517,0.09025271236896515
9558143,7584335,7000271,15006,12297,2009,11009,2006,2709,3997,1.0,0.0,2,19.0,2,13,672,84.0,0.5227875709533691,0.15476946532726288
9555803,5537003,6819877,15006,7502,1996,10547,2004,7504,4459,0.0,0.16666666666666666,267,11.0,1,2,14,280.0,0.586246132850647,0.18441054224967957
9554854,6033399,4203730,15006,8832,2000,1601,1980,6174,13405,1.0,0.0,602,9.0,6,5,0,5880.0,0.4931229054927826,0.1773962527513504
9557183,7904092,6776424,15006,12850,2011,10456,2004,2156,4550,0.25,0.0,5,2.0,50,24,154,2429.0,0.3725922405719757,0.15035226941108704
9564150,8208350,5670793,15013,13326,2012,7936,1997,1687,7077,1.0,0.0,119,12.0,12,4,42,1589.0,0.3864572048187256,0.2889234721660614
9560978,4958638,6164733,15013,5381,1990,9126,2000,9632,5887,1.0,0.0,109,7.0,4,5,7,1463.0,0.5448684692382812,0.1201581358909607
9562763,5484990,7234913,15013,7320,1996,11499,2007,7693,3514,0.0,0.0,21,4.0,6,5,1407,553.0,0.411926805973053,0.30904749035835266
9564942,7434680,7366497,15013,11975,2008,11807,2008,3038,3206,0.0,1.0,8,6.0,15,3,196,7.0,0.5165047645568848,0.267805814743042
9561068,6432103,5447096,15013,9721,2002,7187,1995,5292,7826,1.0,0.0,210,10.0,142,8,0,1764.0,0.43577662110328674,0.25776803493499756
9564432,7488980,4068141,15013,12094,2009,740,1978,2919,14273,0.3333333333333333,0.3333333333333333,76,3.0,12,2,70,13531.0,0.4611051082611084,0.27560552954673767
9561000,4139011,4285145,15013,1139,1979,2063,1981,13874,12950,1.0,0.0,179,4.0,1,6,0,6314.0,0.3591059446334839,0.16591918468475342
9564369,9000537,6027632,15013,14341,2015,8818,2000,672,6195,1.0,0.0,1,3.0,4,14,672,1393.0,0.7535761594772339,0.3873705267906189
9561666,6247798,6686288,15013,9301,2001,10260,2004,5712,4753,1.0,0.0,15,12.0,13,20,294,1197.0,0.2668321430683136,0.24374976754188538
9563394,5406634,8713910,15013,7040,1995,14005,2014,7973,1008,0.2,0.0,209,1.0,5,5,14,1008.0,0.3443494141101837,0.26512521505355835
9564156,6844996,4049999,15013,10610,2005,628,1977,4403,14385,0.5,0.0,44,5.0,3,1,42,1848.0,0.43916788697242737,0.18462516367435455
9569537,6222919,7684776,15020,9245,2001,12500,2010,5775,2520,0.5,0.5,116,3.0,11,28,7,210.0,0.35056421160697937,0.1826125830411911
9568665,5027168,8038989,15020,5654,1991,13074,2011,9366,1946,0.0,0.0,297,1.0,5,1,7,1946.0,0.21384625136852264,0.16695202887058258
9567388,6079416,4159180,15020,8944,2000,1272,1979,6076,13748,0.5,0.0,9,9.0,10,1,511,7.0,0.48004430532455444,-0.044995758682489395
9571559,6654786,6705629,15020,10190,2003,10302,2004,4830,4718,0.0,0.0,189,16.0,28,11,0,14.0,0.416091650724411,0.22841981053352356
9566188,7731484,4266240,15020,12577,2010,1951,1981,2443,13069,0.0,0.0,10,16.0,2,2,56,336.0,0.4132702350616455,0.18815289437770844
9571400,7903654,4613354,15020,12850,2011,3918,1986,2170,11102,1.0,0.0,31,7.0,244,1,133,2037.0,0.5235677361488342,0.09983687102794647
9566515,6354940,4092637,15020,9567,2002,880,1978,5453,14140,0.5,0.0,60,5.0,10,1,0,9541.0,0.5090590715408325,0.2889459431171417
9566323,6685949,5532343,15020,10260,2004,7488,1996,4760,7532,0.3333333333333333,0.0,14,4.0,7,5,112,2688.0,0.369304358959198,0.1800408810377121
9569627,5999949,9026468,15020,8741,1999,14369,2015,6279,651,0.5,0.5,251,1.0,22,57,105,651.0,0.14290142059326172,0.20365892350673676
9573376,5329306,4306898,15027,6767,1994,2182,1981,8260,12845,1.0,0.0,22,4.0,9,1,385,3325.0,0.43963390588760376,0.14404213428497314
9572475,6996967,5875007,15027,11002,2006,8454,1999,4025,6573,0.0,0.0,13,10.0,7,3,133,14.0,0.17006565630435944,0.12665829062461853
9578182,8667542,5940700,15027,13942,2014,8629,1999,1085,6398,0.5,0.0,37,8.0,1,6,7,98.0,0.5541747808456421,0.2899915874004364
9577306,6584084,6689245,15027,10036,2003,10267,2004,4991,4760,0.5,0.3333333333333333,25,17.0,10,9,7,196.0,0.2567720115184784,0.2761389911174774
9577065,5580381,8558453,15027,7642,1996,13802,2013,7385,1225,0.0,1.0,50,1.0,3,51,112,1225.0,0.37583857774734497,0.3927854597568512
9573969,7531553,7905546,15027,12185,2009,12857,2011,2842,2170,1.0,0.0,7,4.0,2,30,392,210.0,0.5833232998847961,0.05462779849767685
9576315,6407759,6845592,15027,9665,2002,10617,2005,5362,4410,0.5,0.0,19,15.0,14,26,336,49.0,0.37457358837127686,0.24580253660678864
9574350,5950387,5121605,15027,8657,1999,6011,1992,6370,9016,0.3333333333333333,0.0,53,44.0,4,13,49,1015.0,0.5361107587814331,0.12627887725830078
9576056,6950804,4803894,15027,10862,2005,4793,1989,4165,10234,0.5,0.0,137,22.0,20,6,28,56.0,0.37456339597702026,0.08516178280115128
9575058,5797898,5855219,15027,8272,1998,8405,1999,6755,6622,0.0,0.0,417,6.0,22,6,7,560.0,0.42690011858940125,0.256720632314682
9576795,7064346,5761247,15027,11128,2006,8188,1998,3899,6839,1.0,0.0,2034,9.0,7,18,0,3150.0,0.42230159044265747,0.17576827108860016
9577307,8688153,4062007,15027,13970,2014,705,1977,1057,14322,0.5,0.0,21,10.0,23,1,0,4004.0,0.5566441416740417,0.18072609603405
9572852,5663156,5782022,15027,7915,1997,8237,1998,7112,6790,0.25,0.0,14,15.0,4,8,490,126.0,0.43465861678123474,0.11271509528160095
9581126,7698048,4333564,15034,12521,2010,2350,1982,2513,12684,0.0,0.0,12,3.0,3,4,217,5264.0,0.567710280418396,0.06137590855360031
9584605,6678835,4027593,15034,10239,2004,523,1977,4795,14511,0.0,0.0,160,9.0,9,2,7,476.0,0.2534264326095581,0.017885588109493256
9580098,6086087,5552453,15034,8958,2000,7551,1996,6076,7483,1.0,0.0,48,2.0,7,2,77,5782.0,0.5908070802688599,0.0618145614862442
9582644,8063925,7206757,15034,13109,2011,11429,2007,1925,3605,0.0,0.5,10,15.0,6,3,84,126.0,0.37488698959350586,0.38082385063171387
9579393,7217689,7225286,15034,11457,2007,11471,2007,3577,3563,0.6666666666666666,0.0,24,5.0,6,8,35,1141.0,0.35251399874687195,-0.02651788666844368
9582864,7806342,5710619,15034,12696,2010,8055,1998,2338,6979,1.0,0.0,8,21.0,12,3,700,14.0,0.27306774258613586,0.41891250014305115
9582734,5127532,8555786,15034,6032,1992,13802,2013,9002,1232,0.0,0.0,25,2.0,9,8,21,182.0,0.638399064540863,0.12975503504276276
9582400,6490696,8746514,15034,9833,2002,14040,2014,5201,994,1.0,0.0,23,1.0,24,20,35,994.0,0.5099638104438782,0.31076398491859436
9583190,6501698,5119904,15034,9861,2002,6004,1992,5173,9030,0.5,0.0,15,8.0,12,1,938,518.0,0.4056921601295471,-0.006795861292630434
9584885,5541756,8261669,15034,7516,1996,13403,2012,7518,1631,1.0,0.0,24,1.0,1,3,1463,1631.0,0.4549095928668976,0.15164321660995483
9583400,8778789,4888126,15034,14075,2014,5101,1989,959,9933,1.0,0.0,2,23.0,9,7,28,5082.0,0.6470569372177124,0.3187832236289978
9585657,6241723,5269513,15041,9287,2001,6557,1993,5754,8484,1.0,0.0,349,6.0,65,7,7,560.0,0.30226171016693115,0.2310081124305725
9585747,8696743,4026280,15041,13984,2014,516,1977,1057,14525,1.0,0.0,12,5.0,258,1,42,1106.0,0.40019163489341736,0.23696589469909668
9585658,8083120,5626319,15041,13144,2011,7796,1997,1897,7245,1.0,0.0,225,5.0,242,4,0,1904.0,0.5479193925857544,0.33912402391433716
9589148,7181542,6912537,15041,11373,2007,10771,2005,3668,4270,0.5,0.5,49,29.0,27,4,91,84.0,0.2948214113712311,0.38798171281814575
9585810,5336173,4745865,15041,6795,1994,4527,1988,8246,10514,1.0,0.0,32,12.0,9,5,112,1204.0,0.5912338495254517,0.26720765233039856
9585663,6305891,5530058,15041,9427,2001,7481,1996,5614,7560,0.0,0.0,219,6.0,3,8,0,2653.0,0.3991059362888336,0.06842532008886337
9587003,8562992,4538239,15041,13809,2013,3526,1985,1232,11515,0.0,0.0,31,32.0,40,2,14,7.0,0.3580933213233948,0.13309752941131592
9588577,7596430,9255126,15041,12325,2009,14649,2016,2716,392,0.5,0.0,31,1.0,26,9,154,392.0,0.6455113887786865,0.0421009436249733
9590971,6397261,4140017,15041,9644,2002,1146,1979,5397,13895,0.5,0.0,94,2.0,13,1,42,11970.0,0.595337450504303,0.19570210576057434
9586023,5042976,4945737,15041,5717,1991,5332,1990,9324,9709,1.0,0.0,118,14.0,7,9,28,1743.0,0.3676247000694275,-0.038931068032979965
9589273,7013289,7955632,15041,11030,2006,12941,2011,4011,2100,1.0,0.0,316,9.0,23,40,0,105.0,0.3105669915676117,0.08865965157747269
9588599,8187006,4484064,15041,13298,2012,3246,1984,1743,11795,0.0,0.0,40,25.0,64,1,7,49.0,0.3010523021221161,0.18919001519680023
9591318,6925501,6450672,15041,10806,2005,9756,2002,4235,5285,0.0,0.0,29,4.0,17,1,245,560.0,0.5189750790596008,0.12468113750219345
9592052,7918230,4829629,15048,12878,2011,4884,1989,2170,10164,0.5,0.0,140,2.0,486,2,0,8239.0,0.5085302591323853,0.10242084413766861
9592586,5571335,4676853,15048,7614,1996,4198,1987,7434,10850,0.0,0.0,34,20.0,40,3,259,966.0,0.38761472702026367,0.2097758799791336
9595091,7570800,4128686,15048,12269,2009,1069,1978,2779,13979,1.0,0.0,10,24.0,31,1,231,70.0,0.41163453459739685,0.23397906124591827
9595051,7797725,6605885,15048,12675,2010,10085,2003,2373,4963,1.0,0.0,20,8.0,3,19,42,28.0,0.5067005157470703,0.1302950382232666
9595798,6392142,7059651,15048,9637,2002,11121,2006,5411,3927,0.5,0.0,64,10.0,12,20,119,644.0,0.3047022223472595,0.26220619678497314
9593778,6565825,4467236,15048,10001,2003,3155,1984,5047,11893,0.0,0.0,13,21.0,3,3,280,28.0,0.1347552090883255,0.1665535718202591
9596322,7205864,9312417,15048,11429,2007,14712,2016,3619,336,0.0,0.0,47,1.0,4,21,14,336.0,0.22002016007900238,0.28277769684791565
9598328,6576803,6778426,15055,10022,2003,10456,2004,5033,4599,0.3333333333333333,0.0,19,24.0,21,3,21,287.0,0.36891838908195496,0.041008759289979935
9598826,8160782,3996600,15055,13256,2012,341,1976,1799,14714,0.0,0.0,2,17.0,24,1,84,2667.0,0.5589538812637329,0.20871052145957947
9599835,6975294,8605128,15055,10939,2005,13858,2013,4116,1197,0.0,0.0,40,1.0,10,1,147,1197.0,0.5147108435630798,0.3130973279476166
9600205,7150036,4552327,15055,11303,2006,3603,1985,3752,11452,0.0,0.0,113,23.0,32,6,14,112.0,0.33162927627563477,0.40426304936408997
re46346,7508710,5647453,15055,12136,2009,7866,1997,2919,7189,0.5,0.0,78,21.0,26,5,532,1176.0,0.47272437810897827,0.08740309625864029
9597204,7887575,4447644,15055,12829,2011,3050,1984,2226,12005,1.0,0.0,13,4.0,19,2,84,9716.0,0.6576857566833496,0.07699328660964966
9597219,5421809,8680067,15055,7096,1995,13963,2014,7959,1092,1.0,0.0,35,2.0,21,1,28,112.0,0.5076684355735779,0.006102992221713066
9597288,5466465,7101519,15055,7257,1995,11205,2006,7798,3850,1.0,0.0,37,21.0,41,68,56,98.0,0.5304204821586609,0.1258348673582077
9600811,7512567,4642987,15055,12143,2009,4065,1987,2912,10990,0.3333333333333333,0.0,96,12.0,8,2,28,98.0,0.7890687584877014,0.14251749217510223
9598527,5917006,4231039,15055,8580,1999,1762,1980,6475,13293,0.3333333333333333,0.0,23,14.0,22,1,28,693.0,0.4667646884918213,0.05237821117043495
9597224,5192301,7055525,15055,6277,1993,11114,2006,8778,3941,1.0,1.0,826,4.0,8,7,0,1001.0,0.3691319525241852,0.3755722939968109
9606209,6876198,4479390,15062,10687,2005,3225,1984,4375,11837,1.0,1.0,8,17.0,4,4,357,2471.0,0.37819600105285645,0.1780880093574524
9604009,4498904,8491109,15062,3330,1985,13718,2013,11732,1344,1.0,0.0,133,2.0,3,6,0,413.0,0.48563629388809204,0.4141913950443268
9604034,4832019,4221804,15062,4891,1989,1713,1980,10171,13349,0.5,0.5,37,2.0,3,2,49,12782.0,0.36049795150756836,0.16096489131450653
9603441,5511275,7097354,15062,7425,1996,11198,2006,7637,3864,1.0,0.0,53,3.0,19,19,70,1687.0,0.6635707020759583,0.0986403226852417
9604118,5941782,4007485,15062,8636,1999,404,1977,6426,14658,0.3333333333333333,0.0,195,9.0,8,1,21,8092.0,0.577671229839325,0.23186461627483368
9608245,6183903,6735721,15062,9168,2001,10358,2004,5894,4704,0.5,0.0,11,16.0,9,6,378,119.0,0.6067054867744446,0.09674283117055893
9603550,9125868,4220415,15062,14495,2015,1706,1980,567,13356,0.5,0.0,4,13.0,116,1,175,6041.0,0.10752034187316895,0.18413279950618744
9606701,7327869,5316040,15062,11723,2008,6725,1994,3339,8337,1.0,0.0,12,11.0,10,2,1309,1428.0,0.4485132396221161,0.14533057808876038
9603595,5222963,4488895,15062,6389,1993,3274,1984,8673,11788,1.0,0.0,549,2.0,10,2,7,7945.0,0.35810598731040955,0.12762312591075897
9607582,6985158,4169763,15062,10967,2006,1370,1979,4095,13692,0.5,0.0,18,15.0,5,2,245,1946.0,0.6434089541435242,0.16891521215438843
9605498,8215887,7060414,15062,13340,2012,11121,2006,1722,3941,1.0,0.0,5,3.0,32,15,49,3402.0,0.3688048720359802,0.10369432717561722
9605084,7112324,4863453,15062,11226,2006,4996,1989,3836,10066,0.5,0.5,14,51.0,1,7,0,364.0,0.5155807137489319,0.10951028019189835
9606167,4233682,7334550,15062,1776,1980,11744,2008,13286,3318,0.5,0.0,31,2.0,1,5,1526,1071.0,0.5675745606422424,0.08822073042392731
9605069,5585089,7509639,15062,7656,1996,12136,2009,7406,2926,1.0,0.0,1208,4.0,8,12,0,476.0,0.45497244596481323,0.05964547023177147
9609937,8684013,7585680,15069,13970,2014,12304,2009,1099,2765,1.0,0.0,1,2.0,14,12,1099,448.0,0.4128529131412506,0.18008582293987274
9611992,5134554,7914598,15069,6053,1992,12871,2011,9016,2198,0.5,0.0,31,2.0,18,11,7,35.0,0.6252326369285583,0.29054373502731323
9610031,4975175,6846226,15069,5451,1990,10617,2005,9618,4452,0.0,0.0,195,2.0,3,10,35,154.0,0.46039581298828125,0.2722893953323364
9611756,7594386,3995255,15069,12325,2009,334,1976,2744,14735,1.0,0.0,14,4.0,10,1,14,3934.0,0.2774249315261841,0.06799877434968948
9615062,6493032,6094236,15069,9840,2002,8972,2000,5229,6097,0.5,0.3333333333333333,87,37.0,136,29,217,630.0,0.7084949016571045,0.17661163210868835
9610955,4853856,4782805,15069,4961,1989,4695,1988,10108,10374,0.0,0.0,50,4.0,6,1,21,1792.0,0.3715609908103943,0.3652195334434509
9610374,9227164,9193789,15069,14614,2016,14572,2015,455,497,0.2,0.25,1,1.0,9,4,455,497.0,0.3365693688392639,0.08933774381875992
9610113,5453599,4169771,15069,7208,1995,1370,1979,7861,13699,0.0,0.0,54,9.0,8,4,98,2114.0,0.4422507584095001,0.1128828227519989
9620806,5229223,7385649,15076,6410,1993,11849,2008,8666,3227,0.5,0.0,15,2.0,8,17,1281,1498.0,0.24239815771579742,0.19048406183719635
9617446,4487860,4240385,15076,3267,1984,1818,1980,11809,13258,0.5,0.0,27,8.0,3,2,1204,4942.0,0.5910826325416565,0.3042832314968109
9616319,8496535,4441188,15076,13725,2013,3015,1984,1351,12061,1.0,0.0,2,2.0,15,3,574,10577.0,0.633550226688385,0.17655299603939056
9618166,8456075,5140384,15076,13669,2013,6074,1992,1407,9002,0.5,0.5,3,24.0,13,3,7,1316.0,0.4596361517906189,0.23443089425563812
9615940,6375681,6450983,15076,9609,2002,9756,2002,5467,5320,1.0,1.0,146,26.0,7,19,0,21.0,0.5098295211791992,0.3481164872646332
9619810,7681134,4138966,15076,12493,2010,1139,1979,2583,13937,1.0,0.0,84,8.0,1,1,28,3451.0,0.2131049633026123,0.14464443922042847
9619143,6326970,5152154,15076,9469,2001,6123,1992,5607,8953,1.0,0.0,57,4.0,55,3,301,896.0,0.24218861758708954,0.25668177008628845
9616334,7139983,5235018,15076,11282,2006,6431,1993,3794,8645,0.0,0.0,166,54.0,52,8,42,1015.0,0.3690761625766754,-0.02014485001564026
9622859,6786925,6521875,15083,10477,2004,9910,2003,4606,5173,1.0,0.0,258,3.0,21,5,14,2156.0,0.26985666155815125,0.11842573434114456
9623859,9340228,6989362,15083,14747,2016,10981,2006,336,4102,0.3333333333333333,0.0,13,1.0,123,2,7,4102.0,0.8540846705436707,0.11763928830623627
9628163,6292788,5043721,15083,9392,2001,5717,1991,5691,9366,0.0,0.5,45,11.0,6,11,140,49.0,0.06273527443408966,0.2452879101037979
9623295,8012039,4124838,15083,13032,2011,1041,1978,2051,14042,0.5,0.0,16,30.0,21,1,14,2443.0,0.5685372948646545,0.06284132599830627
9625660,5224187,5624164,15083,6389,1993,7789,1997,8694,7294,1.0,0.0,19,7.0,18,9,210,4438.0,0.6543057560920715,0.11698643863201141
9622823,6450978,7071104,15083,9756,2002,11142,2006,5327,3941,1.0,0.0,121,3.0,26,2,21,217.0,0.373139888048172,0.389713317155838
9623234,7894907,6842916,15083,12836,2011,10610,2005,2247,4473,1.0,0.0,47,4.0,20,16,35,210.0,0.41652581095695496,0.418212890625
9628035,7061320,4851365,15083,11121,2006,4954,1989,3962,10129,1.0,0.0,3,47.0,7,10,1127,714.0,0.5689019560813904,0.21837002038955688
9628458,5161227,7153942,15083,6151,1992,11317,2006,8932,3766,0.5,0.0,161,13.0,12,27,56,140.0,0.6137728095054626,0.14536814391613007
9628142,7696467,4209699,15083,12521,2010,1636,1980,2562,13447,0.0,0.0,2,4.0,10,2,973,2429.0,0.537724494934082,0.24861183762550354
9625600,7679991,5914640,15083,12493,2010,8573,1999,2590,6510,1.0,0.0,3,14.0,6,4,651,1624.0,0.49930521845817566,0.2903631627559662
9629814,7150748,6116126,15090,11310,2006,9021,2000,3780,6069,1.0,0.0,221,4.0,9,7,0,686.0,0.310207337141037,0.31426945328712463
9630748,5613312,5181025,15090,7754,1997,6228,1993,7336,8862,0.5,0.0,18,15.0,6,8,91,7.0,0.4990359842777252,0.22582492232322693
9632490,7439862,6439838,15090,11982,2008,9735,2002,3108,5355,0.0,0.0,61,21.0,13,4,49,56.0,0.23502130806446075,0.2113543599843979
9634593,8476873,5687229,15090,13697,2013,7985,1997,1393,7105,0.3333333333333333,0.0,9,22.0,81,14,70,147.0,0.1630312204360962,0.2324971854686737
9630876,5942338,7094389,15090,8636,1999,11191,2006,6454,3899,0.3333333333333333,0.0,70,9.0,6,3,84,161.0,0.5171434879302979,0.23014475405216217
9635427,6081830,5207897,15090,8944,2000,6333,1993,6146,8757,0.0,0.0,478,15.0,20,11,0,504.0,0.4742982089519501,0.19681678712368011
9630033,5184696,4227456,15090,6249,1993,1748,1980,8841,13342,1.0,0.0,9,3.0,3,1,427,1715.0,0.6284324526786804,0.2882538437843323
9635406,5768528,6014627,15090,8202,1998,8776,2000,6888,6314,0.5,0.0,626,9.0,14,5,0,91.0,0.3694901764392853,0.19062113761901855
9633722,6534812,9136809,15090,9938,2003,14502,2015,5152,588,0.5,0.0,4,1.0,8,7,56,588.0,0.6221499443054199,0.24832381308078766
9635210,8755701,6907491,15090,14047,2014,10757,2005,1043,4333,0.5,0.0,2,2.0,5,2,483,1806.0,0.6145654320716858,0.06803813576698303
9634575,6545887,4026375,15090,9959,2003,516,1977,5131,14574,1.0,0.0,35,6.0,6,1,259,5859.0,0.31285810470581055,0.15869899094104767
9633608,7460103,5237990,15090,12024,2008,6445,1993,3066,8645,1.0,0.0,53,5.0,7,3,119,406.0,0.6179499626159668,0.30239883065223694
9633674,6505183,6758028,15090,9868,2003,10414,2004,5222,4676,0.0,0.0,89,5.0,2,10,0,301.0,0.22418998181819916,0.19425839185714722
9631592,5343699,9259834,15090,6823,1994,14656,2016,8267,434,0.5,0.0,99,1.0,19,46,56,434.0,0.48116904497146606,0.18294553458690643
9635176,8054951,5422423,15090,13095,2011,7096,1995,1995,7994,1.0,0.0,2,22.0,22,12,1232,175.0,0.4487898647785187,0.1479494571685791
9630959,7060331,4306982,15090,11121,2006,2182,1981,3969,12908,0.0,0.0,10,4.0,2,1,70,7553.0,0.46855247020721436,0.16636024415493011
9629628,5680981,8453550,15090,7971,1997,13669,2013,7119,1421,1.0,0.0,560,2.0,44,2,0,714.0,0.6773818135261536,0.24566160142421722
9629656,7172562,5323166,15090,11359,2007,6746,1994,3731,8344,0.5,0.0,93,3.0,15,1,14,5425.0,0.4025614857673645,0.3728801906108856
9640642,7468304,4517293,15097,12045,2008,3421,1985,3052,11676,1.0,0.0,2108,6.0,2,1,0,6664.0,0.3355449438095093,0.08364294469356537
9636163,5383888,6284840,15097,6963,1995,9378,2001,8134,5719,1.0,0.0,503,25.0,13,12,7,21.0,0.47224217653274536,0.29192790389060974
9637055,4530571,8832390,15097,3491,1985,14131,2014,11606,966,0.5,0.0,16,1.0,1,2,42,966.0,0.665717363357544,0.019353535026311874
9637221,5054998,6056185,15097,5759,1991,8888,2000,9338,6209,1.0,0.0,14,5.0,4,14,350,2422.0,0.4855150282382965,0.14684993028640747
9641693,6324404,5088555,15097,9462,2001,5892,1992,5635,9205,0.3333333333333333,0.0,104,8.0,3,3,7,952.0,0.40897539258003235,0.12583774328231812
9636713,8051975,7438763,15097,13095,2011,11982,2008,2002,3115,0.0,0.0,1,4.0,10,5,2002,553.0,0.26657870411872864,0.14891548454761505
re46387,5630127,5468694,15097,7803,1997,7264,1995,7294,7833,1.0,0.0,195,29.0,10,9,14,189.0,0.19068336486816406,0.05891711637377739
9636213,4994083,5552483,15097,5528,1991,7551,1996,9569,7546,1.0,0.0,47,14.0,2,14,35,196.0,0.5867321491241455,0.14613182842731476
9637182,7740303,6244394,15097,12591,2010,9294,2001,2506,5803,0.0,0.0,37,20.0,117,5,70,49.0,0.5336313843727112,0.3045945167541504
9636495,5769880,4400983,15097,8209,1998,2798,1983,6888,12299,1.0,0.0,226,2.0,33,1,0,4158.0,0.4145701229572296,0.11199014633893967
9646458,7371171,8470377,15104,11821,2008,13690,2013,3283,1414,1.0,0.0,28,1.0,34,1,21,1414.0,0.5269176959991455,0.09391044825315475
9647555,6750637,6737221,15104,10393,2004,10365,2004,4711,4739,0.0,0.0,13,4.0,9,12,140,938.0,0.42034900188446045,0.2878170311450958
9645131,5191132,4294593,15104,6270,1993,2112,1981,8834,12992,0.0,0.0,75,8.0,6,1,0,343.0,0.3004245460033417,0.14512547850608826
9644476,5322127,4058477,15104,6746,1994,684,1977,8358,14420,1.0,0.0,189,8.0,5,1,161,7644.0,0.38173866271972656,0.3441482484340668
re46400,6320905,4104570,15104,9455,2001,943,1978,5649,14161,0.5,0.0,75,13.0,1,3,224,6958.0,0.6673189401626587,0.13329894840717316
9643052,7487045,4315882,15104,12087,2009,2238,1982,3017,12866,0.3333333333333333,0.0,29,2.0,16,1,7,1491.0,0.5115244388580322,0.02200523018836975
9647114,8367528,4755396,15104,13550,2013,4569,1988,1554,10535,0.5,0.0,54,11.0,233,5,7,5110.0,0.31006285548210144,0.25290313363075256
9645774,5974234,4683388,15104,8699,1999,4226,1987,6405,10878,1.0,0.0,153,16.0,6,1,7,1596.0,0.5970678925514221,0.15897083282470703
9642598,6045508,4592282,15104,8860,2000,3806,1986,6244,11298,0.5,0.0,56,8.0,81,9,119,126.0,0.44607746601104736,0.17539247870445251
9643151,7066586,6916869,15104,11135,2006,10785,2005,3969,4319,0.0,0.0,604,2.0,59,4,7,2639.0,0.2796182632446289,0.14939922094345093
9644175,6326364,4141876,15104,9469,2001,1153,1979,5635,13951,0.5,0.0,41,24.0,10,3,91,210.0,0.5687862634658813,0.36403870582580566
9644440,8162078,4125038,15104,13263,2012,1048,1978,1841,14056,1.0,0.0,10,26.0,21,3,7,441.0,0.5043512582778931,0.3328000605106354
9647691,7743279,4510242,15104,12591,2010,3386,1985,2513,11718,0.3333333333333333,0.0,6,13.0,19,8,210,2142.0,0.493776798248291,0.1312921941280365
9652620,7609839,5037715,15111,12353,2009,5696,1991,2758,9415,0.3333333333333333,0.0,5,17.0,3,1,98,315.0,0.5735372304916382,0.14596612751483917
9653070,7707029,5128277,15111,12535,2010,6032,1992,2576,9079,0.3333333333333333,0.0,2,2.0,6,9,2128,7854.0,0.3943254053592682,0.2560672163963318
9649089,6575908,4604745,15111,10022,2003,3869,1986,5089,11242,1.0,0.0,66,30.0,22,4,0,1204.0,0.2990918457508087,0.2572595477104187
9649110,6517528,6169884,15111,9903,2003,9133,2001,5208,5978,1.0,0.0,166,14.0,19,3,7,147.0,0.45327675342559814,0.08883799612522125
9652760,6278885,5272099,15111,9364,2001,6564,1993,5747,8547,0.0,0.0,27,30.0,6,7,7,2800.0,0.2645200192928314,0.2276184856891632
9652655,7112273,8227229,15111,11226,2006,13354,2012,3885,1757,0.3333333333333333,0.0,71,10.0,37,31,7,140.0,0.5918402075767517,-0.02116328664124012
9650099,4869332,8026489,15111,5017,1989,13053,2011,10094,2058,0.5,0.0,32,1.0,8,7,77,2058.0,0.22962863743305206,0.05944443866610527
9654721,6799327,4705756,15111,10498,2004,4331,1987,4613,10780,1.0,0.0,213,17.0,26,4,21,280.0,0.3826577961444855,0.14259707927703857
9650381,8063032,4168378,15111,13109,2011,1356,1979,2002,13755,0.5,1.0,26,6.0,12,2,21,2016.0,0.5225545763969421,0.17613154649734497
9650903,7263772,8085822,15111,11569,2007,13144,2011,3542,1967,0.0,0.0,6,1.0,4,8,266,1967.0,0.27024176716804504,0.30332615971565247
9649441,5868711,7430862,15111,8440,1999,11968,2008,6671,3143,1.0,0.0,113,2.0,9,39,0,1407.0,0.3653503656387329,0.33444440364837646
9649208,5630840,4264507,15111,7810,1997,1944,1981,7301,13167,1.0,0.0,240,2.0,32,1,14,3458.0,0.6808503866195679,0.23695403337478638
9654744,6748173,4030302,15111,10386,2004,537,1977,4725,14574,1.0,0.0,7,6.0,5,1,1701,623.0,0.661270022392273,0.164715975522995
9653378,7948757,4411008,15111,12927,2011,2847,1983,2184,12264,0.4,0.0,3,19.0,18,10,399,1456.0,0.3915857672691345,0.06523378938436508
9657589,7297260,7269447,15118,11646,2007,11576,2007,3472,3542,0.2,0.0,13,4.0,72,8,182,1274.0,0.6497453451156616,0.16549554467201233
9661736,4812658,4048634,15118,4821,1989,621,1977,10297,14497,0.0,0.0,39,5.0,2,1,42,6930.0,0.320038765668869,0.07240734994411469
9660890,6182125,5627020,15118,9161,2001,7796,1997,5957,7322,0.5,0.0,144,5.0,10,8,35,3654.0,0.45305904746055603,0.13938839733600616
9656056,5873835,4179959,15118,8454,1999,1454,1979,6664,13664,1.0,0.0,308,4.0,5,1,7,1554.0,0.31687843799591064,0.10868803411722183
9655628,5601563,9296822,15118,7712,1997,14698,2016,7406,420,1.0,0.5,255,1.0,39,32,7,420.0,0.5125064253807068,0.06292890012264252
9655940,5098709,3991777,15118,5927,1992,320,1976,9191,14798,1.0,0.0,19,13.0,2,1,35,896.0,0.31595224142074585,0.09363771975040436
9659671,6438044,5817406,15118,9728,2002,8314,1998,5390,6804,1.0,0.0,33,13.0,6,6,140,49.0,0.5603216290473938,0.24447868764400482
9655614,8348129,4404746,15118,13522,2013,2819,1983,1596,12299,0.5,0.0,194,9.0,432,1,7,357.0,0.523780345916748,0.3480260670185089
9655502,5933275,4239321,15118,8615,1999,1811,1980,6503,13307,0.0,0.0,24,11.0,9,1,14,2156.0,0.24636760354042053,0.11519797146320343
9656019,6595956,7672490,15118,10064,2003,12479,2010,5054,2639,1.0,0.5,187,4.0,8,3,14,224.0,0.5983526706695557,-0.006615772843360901
9660464,7739373,7136191,15118,12584,2010,11275,2006,2534,3843,0.0,0.3333333333333333,3,10.0,3,19,1540,56.0,0.3911191523075104,0.13590200245380402
9662962,7246496,7297739,15125,11527,2007,11646,2007,3598,3479,0.5,0.0,44,4.0,20,2,14,168.0,0.4082356095314026,0.10885141789913177
9662156,8187275,6597759,15125,13298,2012,10064,2003,1827,5061,1.0,0.0,4,17.0,104,13,406,119.0,0.56453937292099,0.2895596921443939
9663127,4646241,7052834,15125,4072,1987,11107,2006,11053,4018,0.0,0.0,73,3.0,3,1,35,63.0,0.33825942873954773,-0.019658466801047325
9663326,8342294,4337937,15125,13515,2013,2378,1982,1610,12747,0.5,0.0,2,5.0,3,1,357,8232.0,0.44158849120140076,0.34110522270202637
9668121,6363348,4602602,15125,9581,2002,3862,1986,5544,11263,0.0,0.0,93,8.0,3,3,0,7203.0,0.3100164234638214,0.14209112524986267
9667317,8588567,6979177,15125,13837,2013,10953,2005,1288,4172,0.0,0.0,31,7.0,33,11,7,343.0,0.20962101221084595,0.20630775392055511
9667729,6243667,6499324,15125,9287,2001,9861,2002,5838,5264,0.0,0.0,211,7.0,194,14,7,1806.0,0.4905559718608856,0.18348737061023712
9664978,4123346,8293468,15125,1034,1978,13445,2012,14091,1680,0.0,0.0,88,2.0,1,3,434,252.0,0.43824851512908936,0.1410752534866333
9663618,6472495,9131478,15125,9798,2002,14495,2015,5327,630,0.5,0.0,21,1.0,8,3,7,630.0,0.5754801630973816,0.14436905086040497
9664338,7159738,5230286,15125,11331,2007,6417,1993,3794,8708,0.3333333333333333,0.0,4,2.0,3,3,147,5299.0,0.5196558833122253,0.13915210962295532
9665757,8643717,4099121,15125,13914,2014,915,1978,1211,14210,0.5,0.3333333333333333,58,68.0,85,1,0,105.0,0.3556150794029236,0.09154587239027023
9668593,5485934,5518679,15132,7327,1996,7446,1996,7805,7686,1.0,0.0,9,11.0,7,9,217,420.0,0.5253106355667114,0.17559295892715454
9670588,8308931,5908749,15132,13466,2012,8552,1999,1666,6580,1.0,0.0,15,6.0,100,6,49,637.0,0.7886059284210205,0.045636992901563644
9674560,4682292,6217471,15132,4219,1987,9238,2001,10913,5894,0.0,0.0,110,10.0,4,8,441,287.0,0.4368336498737335,0.19740375876426697
9669035,7312341,7382740,15132,11681,2007,11842,2008,3451,3290,0.0,0.0,21,6.0,3,1,14,665.0,0.3316435217857361,0.04260117933154106
9669162,4837049,4529607,15132,4905,1989,3484,1985,10227,11648,0.0,0.0,429,12.0,4,3,21,2597.0,0.2178320735692978,0.04076828062534332
9671336,7253898,4413133,15132,11541,2007,2861,1983,3591,12271,0.25,0.0,5,2.0,6,2,189,9793.0,0.5175413489341736,0.16906391084194183
9668827,5203351,7434259,15132,6319,1993,11968,2008,8813,3164,0.5,0.0,30,7.0,2,2,1078,574.0,0.5520613789558411,0.07993893325328827
9675890,8285740,4512021,15139,13431,2012,3393,1985,1708,11746,0.3333333333333333,0.0,17,9.0,3,1,70,644.0,0.32354506850242615,0.15351884067058563
9680670,5903373,5316336,15139,8531,1999,6725,1994,6608,8414,1.0,0.0,76,9.0,32,3,7,7.0,0.4886091649532318,0.10323084145784378
9675941,4717394,4712797,15139,4387,1988,4366,1987,10752,10773,0.5,0.0,107,6.0,15,1,98,287.0,0.8456001281738281,-0.05468466877937317
9679590,6632483,6867670,15139,10148,2003,10666,2005,4991,4473,0.0,0.0,32,7.0,11,10,7,1029.0,0.3975948691368103,0.2829825282096863
9681403,9439158,4427199,15139,14859,2016,2945,1984,280,12194,1.0,0.0,1,10.0,1,4,280,42.0,0.4831109941005707,0.3914753496646881
9680017,8680576,4997937,15139,13963,2014,5542,1991,1176,9597,1.0,0.0,21,3.0,12,3,14,6524.0,0.7208424210548401,-0.030051380395889282
9677353,6352159,4266997,15139,9560,2002,1958,1981,5579,13181,0.3333333333333333,0.0,14,9.0,4,1,35,6923.0,0.365947961807251,0.2533683180809021
9678203,7768445,8469189,15139,12633,2010,13690,2013,2506,1449,1.0,0.0,1,3.0,9,8,2506,105.0,0.4851507246494293,0.26376867294311523
9678621,7561159,7388475,15139,12248,2009,11856,2008,2891,3283,0.5,0.3333333333333333,47,7.0,4,6,14,7.0,0.28602856397628784,0.3063565194606781
re46438,6332154,4251859,15139,9483,2001,1874,1981,5656,13265,0.5,0.5,156,9.0,5,3,14,5782.0,0.3064396381378174,0.24268901348114014
9681671,5451417,8234241,15146,7201,1995,13361,2012,7945,1785,1.0,0.0,18,1.0,13,8,1400,1785.0,0.6231703162193298,0.22114162147045135
9686379,8195187,4171853,15146,13305,2012,1391,1979,1841,13755,1.0,0.0,9,23.0,141,1,98,154.0,0.394467294216156,0.24025072157382965
9681841,6571123,6779288,15146,10008,2003,10463,2004,5138,4683,1.0,0.0,93,15.0,19,31,42,77.0,0.6860565543174744,0.32465416193008423
9685365,7294928,4879022,15146,11639,2007,5059,1989,3507,10087,0.5,0.0,75,10.0,48,6,7,392.0,0.2925126254558563,0.27191612124443054
9682567,7014305,4414358,15146,11037,2006,2868,1983,4109,12278,1.0,0.0,11,4.0,28,2,168,203.0,0.7172086238861084,0.21608372032642365
9682815,6416271,4722254,15146,9686,2002,4415,1988,5460,10731,0.25,0.0,26,2.0,31,1,7,4179.0,0.45579594373703003,0.38202399015426636
9685992,6301420,9190808,15146,9413,2001,14565,2015,5733,581,0.0,0.0,131,1.0,5,1,7,581.0,0.14219824969768524,0.16601839661598206
9681819,5113869,5641192,15146,5983,1992,7845,1997,9163,7301,1.0,0.0,812,14.0,7,2,7,553.0,0.5233439803123474,0.051816463470458984
9681920,7744608,4729603,15146,12598,2010,4450,1988,2548,10696,0.5,0.0,13,24.0,233,2,35,161.0,0.5604005455970764,0.32185471057891846
9690314,5646069,5602734,15153,7859,1997,7712,1997,7294,7441,0.0,0.0,65,18.0,4,28,7,14.0,0.15252254903316498,0.16414281725883484
9692411,5973415,4538581,15153,8699,1999,3533,1985,6454,11620,0.0,0.0,20,4.0,34,1,910,3402.0,0.6707151532173157,0.1477394849061966
9693111,8130674,8495240,15153,13214,2012,13718,2013,1939,1435,1.0,0.0,3,1.0,5,97,469,1435.0,0.26094430685043335,0.1724795550107956
9692722,7853881,4187295,15153,12766,2010,1496,1980,2387,13657,0.5,0.0,207,2.0,4,1,0,11725.0,0.43527093529701233,0.1797039806842804
9687230,7731072,8644101,15153,12577,2010,13914,2014,2576,1239,1.0,0.0,349,5.0,384,8,7,35.0,0.5976093411445618,0.20364460349082947
9689156,7380292,7317903,15153,11842,2008,11695,2008,3311,3458,0.5,0.0,12,10.0,23,8,35,105.0,0.4707365930080414,0.19062553346157074
9697033,8224931,7138275,15160,13347,2012,11282,2006,1813,3878,0.5,0.0,113,5.0,8,2,0,518.0,0.5557801127433777,0.1044664978981018
9693795,7517352,5001555,15160,12157,2009,5556,1991,3003,9604,1.0,0.0,47,29.0,113,4,77,497.0,0.5800102353096008,0.16985119879245758
9698207,7592652,4451112,15160,12318,2009,3071,1984,2842,12089,0.3333333333333333,0.0,15,37.0,28,3,49,56.0,0.42601409554481506,0.45795103907585144
9698607,7375492,4542170,15160,11828,2008,3547,1985,3332,11613,0.25,0.0,214,5.0,14,10,35,189.0,0.5434080362319946,-0.004966402892023325
9696967,7886222,6194651,15160,12822,2011,9189,2001,2338,5971,1.0,0.0,5,9.0,1,3,182,119.0,0.2936292886734009,0.12030074745416641
9699864,6266538,4070008,15160,9336,2001,754,1978,5824,14406,0.2,0.0,54,27.0,6,1,49,504.0,0.3668811619281769,0.18233482539653778
9694753,6278941,4643717,15160,9364,2001,4065,1987,5796,11095,0.0,0.0,183,33.0,5,1,0,42.0,0.32660940289497375,0.35897940397262573
9696890,7191391,4079782,15160,11394,2007,810,1978,3766,14350,1.0,0.0,48,13.0,28,1,714,210.0,0.5091039538383484,0.2595161199569702
9693713,7340287,6553556,15160,11751,2008,9973,2003,3409,5187,1.0,0.0,280,10.0,124,6,7,126.0,0.41413283348083496,0.3143845498561859
9694629,6915826,7813857,15160,10785,2005,12703,2010,4375,2457,0.3333333333333333,0.0,8,3.0,10,21,231,756.0,0.37573474645614624,0.263265997171402
9694053,8801700,5518359,15160,14103,2014,7446,1996,1057,7714,0.5,0.0,6,16.0,60,1,14,1246.0,0.14465871453285217,0.08671189099550247
9697568,8015107,4518265,15160,13032,2011,3428,1985,2128,11732,1.0,0.0,19,2.0,68,2,0,8876.0,0.4431260824203491,0.08563469350337982
9694989,6299404,7276230,15160,9413,2001,11597,2007,5747,3563,0.0,0.0,26,5.0,20,1,406,294.0,0.28035449981689453,-0.07700270414352417
9697824,9437191,8877217,15160,14859,2016,14187,2014,301,973,0.75,0.0,1,1.0,4,4,301,973.0,1.0,0.04695235192775726
9706265,8677253,4089659,15167,13956,2014,866,1978,1211,14301,0.3333333333333333,0.0,9,2.0,11,4,0,13286.0,0.35924434661865234,0.13563312590122223
9702173,6116665,4060850,15167,9021,2000,698,1977,6146,14469,1.0,0.0,16,18.0,3,2,420,1834.0,0.6042353510856628,0.2448122799396515
9702231,5095978,5667228,15167,5920,1992,7929,1997,9247,7238,1.0,0.0,27,12.0,3,1,154,77.0,0.34783580899238586,0.26512381434440613
9702693,5805290,5265186,15167,8286,1998,6536,1993,6881,8631,0.3333333333333333,0.0,137,10.0,9,8,413,1785.0,0.5902383923530579,0.31890398263931274
9704590,7342831,6210611,15167,11758,2008,9224,2001,3409,5943,0.3333333333333333,0.0,96,5.0,22,11,21,224.0,0.31711146235466003,0.2548452317714691
9700904,4256262,4494967,15167,1902,1981,3309,1985,13265,11858,0.0,0.0,15,14.0,1,3,21,602.0,0.35510876774787903,0.3016788959503174
9705030,6943377,4883154,15167,10848,2005,5080,1989,4319,10087,1.0,0.0,31,4.0,9,7,105,567.0,0.38170355558395386,0.11219342797994614
9700416,7115145,7501393,15167,11233,2006,12122,2009,3934,3045,1.0,1.0,16,14.0,5,46,147,525.0,0.7212827205657959,0.09923841804265976
9700227,8308650,7584638,15167,13466,2012,12304,2009,1701,2863,1.0,0.0,25,2.0,170,4,49,2436.0,0.41117677092552185,0.18175315856933594
9704523,6072663,4805951,15167,8923,2000,4800,1989,6244,10367,1.0,0.0,12,9.0,2,1,3164,161.0,0.4669336676597595,0.2792893052101135
9702140,5759670,5019441,15167,8188,1998,5626,1991,6979,9541,0.5,0.5,9,3.0,16,2,7,6496.0,0.49231380224227905,0.3556896448135376
9700144,5464381,7131543,15167,7250,1995,11268,2006,7917,3899,0.0,1.0,34,15.0,8,22,112,301.0,0.5011898875236511,0.3331012725830078
9704088,6286022,4567295,15167,9378,2001,3680,1986,5789,11487,0.5,0.0,102,3.0,15,1,7,10101.0,0.15312816202640533,0.044783350080251694
9700101,7624517,4567295,15167,12388,2009,3680,1986,2779,11487,0.5,0.0,14,3.0,18,1,21,10101.0,0.2877483069896698,0.15285204350948334
9700444,5833694,7546350,15167,8349,1998,12213,2009,6818,2954,1.0,0.0,226,2.0,24,16,14,1064.0,0.5970256328582764,0.1454492211341858
9707342,5514071,5844180,15174,7432,1996,8370,1998,7742,6804,0.5,0.0,28,7.0,7,4,259,511.0,0.4670827090740204,0.2912614345550537
9710852,6611816,8063113,15174,10099,2003,13109,2011,5075,2065,1.0,0.0,187,2.0,35,12,14,1169.0,0.46345970034599304,-0.012189106084406376
9712719,7187472,4130610,15174,11387,2007,1083,1978,3787,14091,0.3333333333333333,0.0,14,5.0,8,1,294,13118.0,0.6239867210388184,0.17164191603660583
9711495,7842975,7552767,15174,12752,2010,12234,2009,2422,2940,0.5,0.0,114,5.0,187,14,7,644.0,0.5118637681007385,0.10522686690092087
9707085,8636807,6073883,15174,13907,2014,8930,2000,1267,6244,1.0,0.0,3,38.0,84,4,630,56.0,0.5881710052490234,0.1366320252418518
9707478,8384668,4910030,15174,13571,2013,5192,1990,1603,9982,0.0,0.0,38,12.0,835,4,35,1148.0,0.9830069541931152,0.22325025498867035
9707478,5422956,4878077,15174,7096,1995,5052,1989,8078,10122,0.0,0.0,52,19.0,6,6,35,2730.0,0.3857274055480957,0.2680332362651825
9713302,6901624,5051270,15181,10750,2005,5745,1991,4431,9436,0.0,0.0,144,11.0,15,10,7,3304.0,0.41034892201423645,0.08617183566093445
9713522,6929658,5142556,15181,10820,2005,6081,1992,4361,9100,1.0,0.0,15,9.0,20,3,28,2198.0,0.6113882660865784,0.15201175212860107
9715932,9484082,6230362,15181,14915,2016,9266,2001,266,5915,1.0,0.0,3,14.0,73,36,14,98.0,0.7840530276298523,0.32535794377326965
9715875,6978239,5484727,15181,10946,2005,7320,1996,4235,7861,0.5,0.0,42,6.0,15,7,7,3437.0,0.3871970772743225,0.08304145187139511
9715985,8203403,4375360,15181,13319,2012,2616,1983,1862,12565,1.0,0.0,5,15.0,27,2,259,119.0,0.5205469727516174,0.08246231079101562
9717141,6657606,4112490,15181,10197,2003,978,1978,4984,14203,0.0,0.0,17,13.0,1,3,49,3143.0,0.528349757194519,0.14459484815597534
9715875,6321092,6653015,15181,9455,2001,10190,2003,5726,4991,0.5,0.0,435,9.0,25,9,7,1120.0,0.24094092845916748,0.1268794685602188
9715529,7567953,3986342,15181,12262,2009,292,1976,2919,14889,1.0,0.0,47,12.0,26,1,7,1197.0,0.4150877594947815,0.09099940210580826
9721821,6433346,6242582,15188,9721,2002,9287,2001,5467,5901,0.3333333333333333,0.0,14,21.0,3,3,14,42.0,0.5388500690460205,0.09538263827562332
9718295,4102456,7588383,15188,936,1978,12311,2009,14252,2877,0.0,0.0,24,2.0,1,1,462,133.0,0.378627747297287,0.29826804995536804
9719106,6011018,4400438,15188,8769,2000,2791,1983,6419,12397,0.5,0.0,25,4.0,1,2,161,532.0,0.2523260712623596,0.24166569113731384
9717895,5562617,4830209,15188,7586,1996,4884,1989,7602,10304,1.0,0.0,150,6.0,37,10,7,5873.0,0.5608075261116028,0.15157154202461243
9717577,6497575,4607167,15188,9854,2002,3883,1986,5334,11305,1.0,0.0,35,35.0,9,2,84,203.0,0.45085179805755615,0.3625909984111786
9717682,5004595,5486875,15188,5570,1991,7327,1996,9618,7861,0.0,0.0,81,3.0,14,4,511,5271.0,0.39891213178634644,0.09236257523298264
9719392,7100407,7584638,15188,11205,2006,12304,2009,3983,2884,0.0,0.0,16,2.0,15,4,112,2457.0,0.23825888335704803,0.283738374710083
9720277,7855709,4599101,15188,12773,2010,3841,1986,2415,11347,0.0,0.0,3,4.0,8,5,231,2674.0,0.6889556646347046,0.21516194939613342
9723274,9520063,4871035,15188,14957,2016,5024,1989,231,10164,0.0,0.0,1,10.0,1,1,231,4116.0,0.3737904131412506,0.039332933723926544
9722798,6081597,6620639,15188,8944,2000,10120,2003,6244,5068,1.0,0.0,109,2.0,15,1,14,2506.0,0.37240156531333923,0.106541708111763
9720195,7259325,6321942,15188,11555,2007,9462,2001,3633,5726,0.0,0.0,48,19.0,7,3,84,140.0,0.3837541341781616,0.16381001472473145
9717425,7289835,6107178,15188,11625,2007,9000,2000,3563,6188,1.0,0.0,324,3.0,4,4,28,5285.0,0.4260982871055603,0.15924973785877228
9717680,9439926,5471840,15188,14866,2016,7278,1995,322,7910,1.0,0.0,5,13.0,82,9,21,378.0,0.9999998807907104,0.11940404772758484
9720241,6160552,6154951,15188,9112,2000,9105,2000,6076,6083,0.3333333333333333,0.0,121,3.0,13,2,0,4949.0,0.24348562955856323,0.1793724149465561
9727867,6466779,6869727,15195,9784,2002,10673,2005,5411,4522,0.5,0.0,54,3.0,6,13,21,490.0,0.47571489214897156,0.18824823200702667
9725385,7673857,4167040,15195,12486,2010,1342,1979,2709,13853,0.0,0.0,1,16.0,12,5,2709,812.0,0.15278281271457672,0.07610040158033371
9724098,8205781,7217966,15195,13326,2012,11457,2007,1869,3738,1.0,0.0,281,10.0,480,13,0,1631.0,0.5911791920661926,0.11406411230564117
9724778,4521572,6348892,15195,3442,1985,9546,2002,11753,5649,0.0,0.0,8,21.0,4,6,7,7.0,0.003504630411043763,0.15969915688037872
9724094,5405072,5239912,15195,7040,1995,6452,1993,8155,8743,0.5,0.0,403,2.0,17,6,0,8358.0,0.521149218082428,0.2900235056877136
9723772,5230602,7310182,15195,6417,1993,11674,2007,8778,3521,0.0,0.0,20,3.0,5,4,140,2198.0,0.5692262053489685,0.18934987485408783
9724016,5758644,4490061,15195,8188,1998,3281,1984,7007,11914,1.0,0.0,646,7.0,18,1,7,9079.0,0.13664713501930237,0.04660214111208916
9724091,7963432,6255022,15195,12955,2011,9315,2001,2240,5880,1.0,0.0,215,8.0,267,8,7,2954.0,0.5644176602363586,0.11311528086662292
9723866,4421251,6871739,15195,2910,1983,10680,2005,12285,4515,0.0,0.0,11,18.0,3,13,1253,189.0,0.2870466113090515,0.2070518285036087
9727363,6145066,7156426,15195,9077,2000,11324,2007,6118,3871,1.0,0.0,99,1.0,6,3,182,3871.0,0.49785315990448,0.2089327871799469
9727810,6458530,4595738,15195,9770,2002,3820,1986,5425,11375,0.3333333333333333,0.0,69,29.0,30,2,21,868.0,0.4643987715244293,0.06784488260746002
9724473,5913455,4943566,15195,8573,1999,5318,1990,6622,9877,0.5,0.3333333333333333,31,14.0,27,3,112,1379.0,0.444306880235672,0.28882715106010437
9725359,9128666,5830079,15195,14495,2015,8342,1998,700,6853,0.0,0.0,2,22.0,96,8,245,1113.0,0.5373662710189819,0.1757112741470337
9724092,8276802,6476487,15195,13424,2012,9805,2002,1771,5390,1.0,0.0,233,8.0,17,12,0,119.0,0.7117278575897217,0.3679428696632385
9727813,7793851,7321329,15195,12675,2010,11709,2008,2520,3486,0.5,0.0,66,26.0,132,5,7,56.0,0.645928680896759,0.21015459299087524
9727631,6070171,4464809,15195,8916,2000,3148,1984,6279,12047,0.5,0.0,73,9.0,3,2,28,854.0,0.3127908706665039,0.17158803343772888
9727254,8595428,5380655,15195,13844,2013,6949,1995,1351,8246,0.5,0.0,5,2.0,2,1,147,6398.0,0.5137617588043213,0.13291025161743164
9724170,6527767,4988265,15195,9924,2003,5507,1991,5271,9688,1.0,0.0,218,6.0,33,3,0,1197.0,0.5804925560951233,0.2103569060564041
9724083,6527800,9421932,15195,9924,2003,14845,2016,5271,350,1.0,0.0,231,1.0,40,13,14,350.0,0.3589189052581787,0.22430968284606934
9724098,7214224,4276298,15195,11450,2007,2007,1981,3745,13188,1.0,0.0,300,28.0,18,1,0,1995.0,0.176793172955513,0.16059540212154388
9724090,5968045,4507790,15195,8692,1999,3372,1985,6503,11823,1.0,0.0,116,6.0,13,2,28,4256.0,0.4779888391494751,0.17714357376098633
9725522,7822540,4476830,15195,12717,2010,3211,1984,2478,11984,0.0,0.0,7,8.0,3,10,413,7833.0,0.10054752230644226,0.15700794756412506
9728539,8194471,4464438,15195,13305,2012,3141,1984,1890,12054,0.5,0.0,8,12.0,44,6,28,63.0,0.4174151122570038,0.07085379958152771
9730695,5977746,4169771,15202,8706,1999,1370,1979,6496,13832,0.0,0.0,93,9.0,9,4,0,2247.0,0.14616690576076508,-0.07015492022037506
9734193,8521513,4924823,15202,13753,2013,5248,1990,1449,9954,1.0,0.0,38,9.0,13,5,14,1589.0,0.41851815581321716,0.1421789526939392
9730886,9133123,4090962,15202,14502,2015,873,1978,700,14329,1.0,0.0,2,14.0,10,2,140,1631.0,0.9791837334632874,0.12174656987190247
9730380,7322424,4135243,15202,11716,2008,1111,1979,3486,14091,0.5,0.0,5,12.0,11,2,168,4235.0,0.675166130065918,0.10517964512109756
9731365,5826477,4671616,15202,8335,1998,4177,1987,6867,11025,0.0,0.0,3,5.0,6,5,2009,8281.0,0.5252069234848022,0.1922338604927063
9733460,5208651,7844913,15202,6333,1993,12752,2010,8869,2450,0.25,0.0,148,11.0,4,8,70,63.0,0.3701775372028351,0.3499824106693268
9733938,7421566,5163425,15202,11933,2008,6165,1992,3269,9037,1.0,0.0,14,28.0,18,9,21,70.0,0.43884921073913574,0.10626064240932465
9732002,5759260,4322331,15202,8188,1998,2280,1982,7014,12922,1.0,0.0,10,12.0,43,2,1750,5089.0,0.52403324842453,0.1777031570672989
9733945,9395996,4056225,15202,14810,2016,670,1977,392,14532,1.0,0.0,1,23.0,2,1,392,721.0,1.0,0.2707825303077698
9731959,6084308,8498568,15202,8951,2000,13725,2013,6251,1477,0.0,0.0,107,1.0,8,23,42,1477.0,0.6343745589256287,0.30079907178878784
9738975,6962348,8462900,15209,10904,2005,13676,2013,4305,1533,0.0,0.0,10,2.0,4,2,455,1197.0,0.36529937386512756,0.13441166281700134
9739966,6899776,8963741,15209,10743,2005,14299,2015,4466,910,0.0,0.0,17,1.0,7,7,189,910.0,0.2879825532436371,0.09354425221681595
9743343,7453838,5074032,15209,12010,2008,5836,1991,3199,9373,1.0,0.0,6,7.0,2,6,315,231.0,0.5656837821006775,0.13364030420780182
9740075,6377383,4920948,15209,9609,2002,5234,1990,5600,9975,0.5,0.0,52,43.0,35,7,140,497.0,0.6250322461128235,0.1898343414068222
9742204,6108579,6364346,15209,9000,2000,9588,2002,6209,5621,0.25,0.0,175,6.0,4,53,7,406.0,0.2042022943496704,0.05589112639427185
9737691,6893431,8328596,15209,10729,2005,13494,2012,4480,1715,1.0,0.0,114,3.0,36,58,0,700.0,0.4381377398967743,0.1962185502052307
9739962,9158071,4625963,15209,14530,2015,3988,1986,679,11221,1.0,0.0,2,22.0,1,4,406,364.0,0.2807629108428955,-0.06699886918067932
9740574,7814118,6763449,15209,12703,2010,10421,2004,2506,4788,1.0,1.0,37,7.0,79,5,105,189.0,0.65366530418396,0.19203387200832367
9739363,8602935,5647432,15209,13858,2013,7866,1997,1351,7343,0.5,0.0,3,13.0,3,9,854,273.0,0.4364868402481079,0.027758197858929634
9740266,8650426,4200494,15209,13921,2014,1580,1980,1288,13629,1.0,0.0,4,6.0,25,2,49,6328.0,0.5406609177589417,0.11668755114078522
9739428,5936599,4158686,15209,8622,1999,1265,1979,6587,13944,0.0,0.0,202,8.0,36,1,21,3507.0,0.49244141578674316,0.30570685863494873
9741139,6954662,8954838,15209,10876,2005,14285,2015,4333,924,0.5,0.5,184,1.0,20,5,14,924.0,0.42428821325302124,0.21760958433151245
9737731,7199382,5761694,15209,11415,2007,8188,1998,3794,7021,0.3333333333333333,0.0,137,6.0,117,5,0,308.0,0.3722941279411316,0.1540149450302124
9741253,9567099,4499687,15209,15020,2017,3337,1985,189,11872,0.3333333333333333,0.0,1,6.0,36,1,189,2352.0,0.49056416749954224,-0.002445429563522339
9740647,8984240,4362401,15209,14320,2015,2532,1982,889,12677,1.0,0.0,4,6.0,4,1,21,3612.0,0.3814839720726013,0.06734205782413483
9743974,6547784,5100415,15216,9966,2003,5934,1992,5250,9282,1.0,0.5,55,15.0,14,1,56,21.0,0.5425889492034912,0.3045938313007355
9748153,8089297,4592304,15216,13151,2012,3806,1986,2065,11410,0.0,0.5,15,7.0,3,2,7,5369.0,0.45221060514450073,0.30798599123954773
9747612,6577861,4845830,15216,10022,2003,4940,1989,5194,10276,1.0,0.0,237,5.0,29,3,49,1554.0,0.4594285190105438,0.14382264018058777
9749603,7300155,6370069,15216,11653,2007,9595,2002,3563,5621,0.3333333333333333,0.0,11,6.0,6,7,147,2618.0,0.4407136142253876,0.17765873670578003
9746139,4257672,5969052,15216,1909,1981,8692,1999,13307,6524,0.0,0.0,64,17.0,2,13,7,35.0,0.4210771322250366,0.14873191714286804
9744026,6409757,4260091,15216,9672,2002,1923,1981,5544,13293,1.0,0.0,159,13.0,12,1,0,644.0,0.6778820753097534,0.20111164450645447
9747006,6763501,7341878,15216,10421,2004,11758,2008,4795,3458,1.0,0.0,749,30.0,3,35,7,126.0,0.30255046486854553,0.08970742672681808
9746230,6969246,4587050,15216,10925,2005,3778,1986,4291,11438,0.0,0.0,11,12.0,10,3,168,5943.0,0.2983235716819763,0.11593993008136749
9746354,5056783,5481413,15216,5766,1991,7306,1996,9450,7910,0.2,0.0,124,6.0,22,6,14,5320.0,0.44721466302871704,0.15970756113529205
9743691,7163015,5757532,15216,11338,2007,8181,1998,3878,7035,0.5,0.0,18,3.0,8,2,147,4074.0,0.5343090891838074,0.22389839589595795
9745702,7935221,6858457,15216,12906,2011,10645,2005,2310,4571,0.5,0.0,7,2.0,2,1,84,1939.0,0.5605270266532898,0.07532850652933121
9749247,5914950,8487088,15216,8573,1999,13711,2013,6643,1505,0.5,0.0,273,7.0,9,4,98,105.0,0.5598341226577759,0.07649509608745575
9743940,8777875,7261790,15216,14075,2014,11562,2007,1141,3654,1.0,0.0,64,3.0,237,71,0,546.0,0.4726969301700592,0.1994752287864685
9747898,5440428,6833139,15216,7159,1995,10582,2004,8057,4634,0.3333333333333333,0.0,239,2.0,6,19,7,1456.0,0.3235139846801758,0.162883460521698
9743925,8623048,5031190,15216,13886,2014,5668,1991,1330,9548,1.0,0.0,28,10.0,104,4,0,2191.0,0.9181907773017883,0.26166805624961853
9749053,6972729,6798973,15216,10932,2005,10498,2004,4284,4718,0.3333333333333333,0.3333333333333333,54,5.0,11,5,0,2023.0,0.39797353744506836,0.2511928975582123
9750442,8663107,4385166,15223,13942,2014,2700,1983,1281,12523,1.0,0.0,76,4.0,269,2,21,7322.0,0.6488695740699768,0.06464499980211258
9750549,6379364,4443987,15223,9616,2002,3036,1984,5607,12187,0.5,0.0,111,13.0,148,5,0,1407.0,0.5168159008026123,0.33317336440086365
9752185,8337777,8156023,15223,13508,2012,13249,2012,1715,1974,0.3333333333333333,0.0,6,2.0,2,1,21,1141.0,0.4724537432193756,0.14945586025714874
9753703,6178425,6139039,15223,9154,2001,9070,2000,6069,6153,0.3333333333333333,0.0,732,6.0,4,18,7,609.0,0.44181597232818604,0.23530954122543335
9752348,6202985,5395536,15223,9210,2001,7005,1995,6013,8218,0.3333333333333333,0.0,15,12.0,10,6,14,364.0,0.4755024015903473,0.14571578800678253
9750498,6736825,6043570,15223,10365,2004,8853,2000,4858,6370,1.0,0.0,242,6.0,78,4,7,1169.0,0.46875083446502686,0.31690722703933716
9750532,6530933,5327390,15223,9931,2003,6760,1994,5292,8463,1.0,0.0,238,49.0,59,10,0,14.0,0.35572072863578796,0.07800156623125076
9755697,5019832,5650560,15223,5626,1991,7873,1997,9597,7350,0.3333333333333333,0.0,54,6.0,1,2,7,84.0,0.3218194246292114,0.1616678386926651
9751268,7247262,4594495,15223,11527,2007,3813,1986,3696,11410,0.0,0.0,18,7.0,7,2,434,3080.0,0.297564834356308,0.18987047672271729
9752351,6837080,9195889,15223,10596,2005,14572,2015,4627,651,0.5,0.0,1,2.0,4,651,4627,217.0,0.47722840309143066,0.14289842545986176
9751150,4857822,4018346,15223,4975,1989,474,1977,10248,14749,0.0,0.0,134,6.0,6,1,49,476.0,0.1422622948884964,0.21846957504749298
9752116,6979670,6333758,15223,10953,2005,9490,2001,4270,5733,0.0,0.0,20,3.0,2,12,217,1827.0,0.27916502952575684,0.11681539565324783
9754424,4533962,3992041,15223,3505,1985,320,1976,11718,14903,0.0,0.0,81,12.0,9,1,14,385.0,0.5238089561462402,0.17179666459560394
9750787,7182956,5042810,15223,11380,2007,5717,1991,3843,9506,0.5,0.0,63,26.0,14,1,28,119.0,0.46132707595825195,0.039002496749162674
9750612,5133758,4579408,15223,6053,1992,3743,1986,9170,11480,0.5,0.0,146,33.0,5,1,21,28.0,0.1827928125858307,0.1727488785982132
9754243,8468144,6870103,15223,13683,2013,10673,2005,1540,4550,0.5,0.0,4,23.0,1,21,70,63.0,0.23065590858459473,0.16935493052005768
9754171,8581922,5006602,15223,13830,2013,5577,1991,1393,9646,0.6666666666666666,0.0,8,7.0,2,1,161,812.0,0.21410860121250153,0.1740218847990036
9752536,6742989,7461861,15223,10379,2004,12031,2008,4844,3192,0.25,0.0,14,3.0,2,29,14,2415.0,0.36307018995285034,0.35250145196914673
9754820,9023719,4664722,15223,14369,2015,4149,1987,854,11074,1.0,0.0,35,10.0,23,4,7,413.0,0.5237528085708618,0.13566668331623077
9753966,7360044,7102603,15223,11793,2008,11205,2006,3430,4018,1.0,0.0,2,2.0,11,13,1925,2982.0,0.3017829358577728,-0.05803406983613968
9762750,6345876,5721727,15230,9539,2002,8090,1998,5691,7140,0.0,0.5,10,22.0,2,8,896,889.0,0.29290497303009033,0.16156919300556183
9757599,7216674,9029866,15230,11457,2007,14376,2015,3773,854,0.0,0.3333333333333333,9,1.0,32,60,161,854.0,0.23626407980918884,0.298468679189682
9758163,6968736,9444311,15230,10925,2005,14866,2016,4305,364,0.0,0.0,145,1.0,11,4,28,364.0,0.3389367461204529,0.31468433141708374
9757149,6451027,6358724,15230,9756,2002,9574,2002,5474,5656,0.25,0.0,158,2.0,12,3,14,154.0,0.5142872333526611,0.05312695726752281
9757128,6587750,7069442,15230,10043,2003,11135,2006,5187,4095,0.0,0.0,434,11.0,28,193,0,350.0,0.34754544496536255,0.09008511155843735
9761119,7956735,7089411,15230,12941,2011,11177,2006,2289,4053,1.0,0.0,15,4.0,20,8,175,665.0,0.6171000003814697,0.31714800000190735
9758941,4913238,4685852,15230,5206,1990,4240,1987,10024,10990,0.3333333333333333,0.0,67,14.0,11,8,35,5551.0,0.4457796514034271,0.21242418885231018
9757238,6424332,6610052,15230,9700,2002,10099,2003,5530,5131,0.0,0.5,81,4.0,17,31,14,56.0,0.477015882730484,0.175805926322937
9758531,6831175,6989410,15230,10575,2004,10981,2006,4655,4249,1.0,0.0,89,3.0,13,6,14,735.0,0.33239832520484924,0.0299832820892334
re46548,5991085,8072995,15230,8727,1999,13123,2011,6503,2107,0.0,0.0,281,3.0,225,12,7,679.0,0.4228297173976898,0.261857271194458
9757124,7308998,7565195,15230,11674,2007,12255,2009,3556,2975,1.0,1.0,384,19.0,252,14,0,35.0,0.5601327419281006,0.16616970300674438
9761843,6486997,4773604,15230,9826,2002,4653,1988,5404,10577,0.5,0.0,140,4.0,12,1,49,6573.0,0.3792017698287964,0.24683937430381775
9763091,7383052,7821576,15230,11842,2008,12717,2010,3388,2513,0.3333333333333333,0.3333333333333333,77,2.0,112,22,126,1946.0,0.5642073750495911,0.31618788838386536
9769861,8958422,7321301,15237,14292,2015,11709,2008,945,3528,1.0,0.0,1,10.0,1,25,945,77.0,0.47345054149627686,0.275995135307312
9768810,6608603,6338929,15237,10092,2003,9511,2002,5145,5726,0.5,0.0,74,13.0,2,5,0,2324.0,0.38116970658302307,0.09777026623487473
9766444,5153668,5288352,15237,6123,1992,6627,1994,9114,8610,0.0,0.0,70,3.0,7,5,56,5656.0,0.4310981333255768,0.22212937474250793
9764145,5984896,6335129,15237,8720,1999,9497,2002,6517,5740,1.0,0.0,56,4.0,9,4,7,406.0,0.27449873089790344,0.030402949079871178
9764873,5310043,7100198,15237,6704,1994,11198,2006,8533,4039,0.3333333333333333,0.0,38,4.0,13,3,63,1029.0,0.31743094325065613,0.23211583495140076
9765983,4622544,4095120,15237,3967,1986,894,1978,11270,14343,0.0,0.0,94,15.0,6,1,35,1652.0,0.3274811804294586,0.08387789875268936
9764944,5693568,7507075,15237,8006,1997,12136,2009,7231,3101,0.3333333333333333,0.0,59,5.0,9,6,140,105.0,0.4190261662006378,0.08719653636217117
9763605,8437829,4891477,15237,13641,2013,5115,1990,1596,10122,0.4,0.25,10,4.0,39,3,14,1960.0,0.35920053720474243,0.2301967889070511
9763964,5541348,4004366,15237,7516,1996,390,1977,7721,14847,0.5,0.0,11,10.0,1,1,784,2408.0,0.4612387716770172,0.06581266224384308
9770558,7118553,8533778,15244,11240,2006,13767,2013,4004,1477,1.0,0.0,62,2.0,7,8,14,707.0,0.5540374517440796,0.28057733178138733
9770269,5196013,9033163,15244,6291,1993,14383,2015,8953,861,1.0,0.0,137,2.0,8,17,70,245.0,0.5065805912017822,0.3382461667060852
9770543,8262619,4011513,15244,13403,2012,432,1977,1841,14812,1.0,0.0,14,9.0,40,1,56,2149.0,0.3023241460323334,0.16778497397899628
9772214,8671750,5291853,15244,13956,2014,6641,1994,1288,8603,1.0,0.0,3,20.0,2,6,0,378.0,0.6696193218231201,0.2527465522289276
9770350,5827321,5726421,15244,8335,1998,8104,1998,6909,7140,1.0,0.0,325,9.0,32,13,0,28.0,0.6299965381622314,0.3189774751663208
9772186,6416272,4140525,15244,9686,2002,1146,1979,5558,14098,0.0,0.0,22,5.0,14,3,196,5691.0,0.2300378978252411,-0.05120837315917015
9774309,6272360,9049829,15244,9350,2001,14404,2015,5894,840,0.3333333333333333,0.0,34,5.0,39,9,7,140.0,0.37977901101112366,0.18309612572193146
9774906,5915094,7605676,15244,8573,1999,12346,2009,6671,2898,0.5,0.0,367,2.0,17,6,7,525.0,0.27177366614341736,0.09557394683361053
9771875,8127557,7478129,15244,13214,2012,12066,2009,2030,3178,1.0,0.0,3,18.0,5,3,0,14.0,0.6261402368545532,0.19054973125457764
9773051,8966062,5450418,15244,14299,2015,7194,1995,945,8050,1.0,0.0,23,9.0,3,4,70,2884.0,0.5336676239967346,0.18228046596050262
9775258,4984982,7644072,15244,5493,1991,12423,2010,9751,2821,0.5,0.0,91,28.0,6,24,70,56.0,0.3498767614364624,0.15177690982818604
9771424,6984720,8335448,15244,10967,2006,13501,2012,4277,1743,0.3333333333333333,0.0,70,1.0,61,2,35,1743.0,0.44359448552131653,0.14361564815044403
9774415,5852630,7182220,15244,8391,1998,11380,2007,6853,3864,0.5,0.0,701,2.0,4,6,14,1813.0,0.43903815746307373,0.19014650583267212
9772684,8292833,8924937,15244,13445,2012,14243,2014,1799,1001,0.75,0.25,5,1.0,21,30,196,1001.0,0.41035887598991394,0.25811514258384705
9774520,7792991,4254905,15244,12668,2010,1895,1981,2576,13349,0.0,0.0,8,5.0,32,1,161,10612.0,0.49851247668266296,0.13908334076404572
9780953,8498908,4905308,15251,13725,2013,5171,1990,1526,10080,0.0,0.0,22,9.0,5,3,7,1281.0,0.2794349491596222,0.18680281937122345
9778866,5832283,8991858,15251,8342,1998,14334,2015,6909,917,1.0,0.0,68,2.0,13,21,35,721.0,0.3741845190525055,0.0775044709444046
9775543,5082550,6504609,15251,5864,1992,9868,2003,9387,5383,0.0,0.0,489,4.0,4,10,7,1631.0,0.446392685174942,0.3025306165218353
9776008,7366572,5795672,15251,11807,2008,8265,1998,3444,6986,1.0,0.0,104,13.0,68,1,21,84.0,0.3675243854522705,-0.004891412332653999
9778820,9256674,3980132,15251,14649,2016,257,1976,602,14994,0.5,0.0,1,11.0,3,1,602,175.0,0.24363195896148682,0.18802781403064728
9775659,8162942,4203711,15251,13263,2012,1601,1980,1988,13650,0.5,0.0,10,2.0,7,2,0,10829.0,0.4330466091632843,0.2556156814098358
9781428,5812787,5139156,15251,8300,1998,6074,1992,6951,9177,0.5,0.0,115,7.0,10,7,0,1729.0,0.6174687743186951,0.09960930794477463
9778745,6433771,4192189,15251,9721,2002,1531,1980,5530,13720,0.0,0.0,42,14.0,76,1,42,721.0,0.5572308897972107,0.24110327661037445
9775563,6144837,4544166,15251,9077,2000,3561,1985,6174,11690,0.0,0.0,471,7.0,19,3,7,399.0,0.32971853017807007,0.24791979789733887
9775611,4378901,8562300,15251,2651,1983,13809,2013,12600,1442,0.0,0.0,42,1.0,4,39,112,1442.0,0.39902573823928833,0.23968687653541565
9780745,5594385,4497962,15251,7684,1997,3323,1985,7567,11928,1.0,0.0,51,4.0,3,1,7,7462.0,0.4720395803451538,-0.04321371391415596
9778055,4675656,6226635,15251,4191,1987,9252,2001,11060,5999,0.0,0.3333333333333333,213,24.0,2,6,77,49.0,0.2696733772754669,0.3001064360141754
9786197,8150959,4039207,15258,13242,2012,579,1977,2016,14679,0.5,0.0,13,9.0,17,1,84,9569.0,0.40561643242836,0.29327067732810974
9787958,8698810,5971733,15258,13984,2014,8699,1999,1274,6559,0.3333333333333333,0.0,2,14.0,3,5,105,35.0,0.296545147895813,0.19857105612754822
9783115,4694295,4207209,15258,4275,1987,1622,1980,10983,13636,0.0,0.0,164,22.0,11,2,0,3710.0,0.282073438167572,0.05862167850136757
9787412,8514980,4288675,15258,13746,2013,2077,1981,1512,13181,0.5,0.0,58,9.0,20,1,7,2975.0,0.3442237377166748,0.2671716511249542
9785859,6208749,5201046,15258,9217,2001,6305,1993,6041,8953,0.2,0.25,245,17.0,31,3,0,63.0,0.2749648094177246,0.4733661115169525
9783329,5312023,5241498,15258,6711,1994,6452,1993,8547,8806,0.5,0.0,913,7.0,41,5,0,882.0,0.6513903737068176,0.18066100776195526
9782076,5451424,4742939,15258,7201,1995,4513,1988,8057,10745,0.3333333333333333,0.0,89,26.0,31,3,84,1421.0,0.14418618381023407,0.2217564582824707
9782245,6911003,4010432,15258,10771,2005,425,1977,4487,14833,0.5,0.0,281,44.0,103,1,7,490.0,0.4220539331436157,0.21293389797210693
9782186,5833632,8354978,15258,8349,1998,13529,2013,6909,1729,1.0,0.0,191,4.0,7,70,7,280.0,0.6051920652389526,0.03341146185994148
9788032,8471868,6918583,15258,13690,2013,10792,2005,1568,4466,0.3333333333333333,0.0,13,8.0,7,5,161,154.0,0.4000749886035919,0.17463822662830353
9782019,7010924,7805347,15258,11030,2006,12689,2010,4228,2569,0.5,0.0,5,5.0,6,14,287,1281.0,0.3415544629096985,0.21641716361045837
9782155,6171329,6452115,15258,9140,2001,9756,2002,6118,5502,1.0,0.0,342,5.0,12,2,14,2226.0,0.40562084317207336,0.2991567850112915
9790101,6315886,7547035,15265,9448,2001,12220,2009,5817,3045,0.3333333333333333,0.0,71,4.0,9,16,35,112.0,0.006120109930634499,0.2101794183254242
9790521,7659104,4791111,15265,12458,2010,4730,1988,2807,10535,1.0,0.0,25,15.0,7,5,21,140.0,0.25652918219566345,0.24716432392597198
9791317,5912764,4552816,15265,8566,1999,3603,1985,6699,11662,0.5,0.0,150,11.0,2,6,7,1575.0,0.5176019668579102,0.23775558173656464
9790995,8432659,4432375,15265,13634,2013,2973,1984,1631,12292,0.0,0.0,5,9.0,2,4,231,2149.0,0.496461421251297,0.20660562813282013
9791590,6816571,5123720,15265,10540,2004,6018,1992,4725,9247,1.0,0.0,105,9.0,45,3,49,231.0,0.502825915813446,0.18201139569282532
9790681,4114388,4144138,15265,992,1978,1167,1979,14273,14098,0.0,0.0,21,21.0,2,3,7,889.0,0.4222356379032135,0.08419398218393326
9793333,9506633,4905559,15265,14943,2016,5178,1990,322,10087,0.0,0.0,2,4.0,25,3,105,931.0,0.321199506521225,0.20168857276439667
9793955,6362789,4161438,15265,9581,2002,1293,1979,5684,13972,0.25,0.0,97,3.0,3,1,0,847.0,0.33922746777534485,0.2447129338979721
9791347,7313301,9266288,15265,11681,2007,14663,2016,3584,602,0.5,0.0,3,2.0,5,1,413,28.0,0.3872147798538208,0.041019465774297714
9790418,6715553,6484473,15265,10323,2004,9826,2002,4942,5439,0.6666666666666666,0.0,72,9.0,31,6,56,1134.0,0.5927597284317017,0.3123112916946411
9789690,9308721,4246210,15265,14712,2016,1846,1981,553,13419,1.0,0.0,1,4.0,2,8,553,8498.0,0.7149479389190674,0.3076607882976532
9791207,7905614,9059297,15265,12857,2011,14411,2015,2408,854,0.25,0.0,5,1.0,1,23,28,854.0,0.7165080308914185,0.28371354937553406
9793951,7974387,6895946,15265,12969,2011,10736,2005,2296,4529,0.5,0.0,60,5.0,4,2,7,1057.0,0.30180397629737854,0.15145115554332733
9794707,6934766,5321321,15265,10827,2005,6739,1994,4438,8526,0.0,0.5,94,9.0,23,6,7,168.0,0.3518662452697754,0.30143383145332336
9790697,6247283,4202632,15265,9301,2001,1594,1980,5964,13671,0.5,0.0,7,2.0,6,1,182,11165.0,0.3743113577365875,0.17621049284934998
9791032,4711795,5128211,15265,4359,1987,6032,1992,10906,9233,0.0,0.0,12,4.0,1,7,7,4550.0,0.35667911171913147,0.15464210510253906
9795506,7632242,7437080,15272,12402,2009,11975,2008,2870,3297,1.0,0.0,84,4.0,244,18,14,2275.0,0.3568722903728485,0.17805230617523193
9798393,6081780,8954377,15272,8944,2000,14285,2015,6328,987,0.0,0.5,216,1.0,12,5,14,987.0,0.39101216197013855,0.42284542322158813
9795723,4946434,4050883,15272,5332,1990,635,1977,9940,14637,0.0,0.0,39,4.0,9,2,35,133.0,0.5371523499488831,0.2822518050670624
9796688,8420604,5311063,15272,13620,2013,6704,1994,1652,8568,0.0,0.0,32,6.0,15,3,7,245.0,0.19761215150356293,0.007427881937474012
9797791,7854173,6113735,15272,12773,2010,9014,2000,2499,6258,1.0,0.0,4,7.0,6,25,658,63.0,0.5454996228218079,0.31640759110450745
9797441,8328486,5106960,15272,13494,2012,5955,1992,1778,9317,0.3333333333333333,0.0,8,7.0,13,16,35,700.0,0.39126983284950256,0.21671701967716217
9798429,6362633,6318697,15272,9581,2002,9455,2001,5691,5817,0.0,0.0,85,18.0,40,10,14,14.0,0.5566551685333252,0.2950204312801361
9803806,4912371,8610824,15279,5199,1990,13865,2013,10080,1414,0.5,0.0,68,2.0,9,3,28,1211.0,0.55363929271698,0.3211705684661865
9806226,6946788,4022308,15279,10855,2005,495,1977,4424,14784,1.0,0.0,25,11.0,7,2,420,2639.0,0.4604937434196472,0.21996206045150757
9803806,7309965,4684045,15279,11674,2007,4233,1987,3605,11046,0.5,0.0,248,21.0,190,5,21,497.0,0.35603198409080505,0.23638752102851868
9801634,8858571,4020095,15279,14166,2014,481,1977,1113,14798,1.0,0.0,194,5.0,295,1,0,91.0,0.39350634813308716,0.13376113772392273
9805418,6400996,4786561,15279,9651,2002,4709,1988,5628,10570,0.0,0.0,1070,20.0,656,2,7,217.0,0.10479427874088287,0.07324815541505814
9805012,6956593,6064426,15279,10883,2005,8902,2000,4396,6377,0.0,0.0,166,25.0,38,5,21,245.0,0.6605707406997681,0.20621047914028168
9806823,6944122,5157321,15279,10848,2005,6137,1992,4431,9142,1.0,0.0,11,25.0,14,4,350,203.0,0.39043527841567993,0.012348179705440998
9801744,6056993,7489183,15279,8888,2000,12094,2009,6391,3185,0.0,0.0,436,2.0,36,11,35,406.0,0.3186177909374237,0.016999440267682076
9801648,8469981,8130578,15279,13690,2013,13214,2012,1589,2065,1.0,0.0,49,4.0,355,7,7,84.0,0.5169488191604614,0.1858418881893158
9802063,6409720,4632403,15279,9672,2002,4016,1986,5607,11263,1.0,0.0,175,16.0,88,2,84,112.0,0.34564757347106934,0.11748655885457993
9801627,4684051,7523677,15279,4233,1987,12171,2009,11046,3108,1.0,0.0,250,3.0,3,8,0,1673.0,0.4177245795726776,0.347139835357666
9802099,6712737,4034016,15279,10316,2004,551,1977,4963,14728,1.0,0.0,43,5.0,9,1,322,5901.0,0.4517093002796173,0.029702357947826385
9801634,8991677,9376066,15279,14334,2015,14789,2016,945,490,1.0,0.0,147,1.0,2006,36,0,490.0,0.3245121240615845,0.14508779346942902
9807842,5122733,4004265,15279,6011,1992,383,1977,9268,14896,0.0,0.0,102,10.0,2,1,0,42.0,0.29961392283439636,0.19249404966831207
9811314,9300266,5481413,15286,14698,2016,7306,1996,588,7980,0.3333333333333333,0.0,36,6.0,19,6,21,5390.0,0.34653934836387634,0.261922687292099
9808619,5350414,5755167,15286,6844,1994,8181,1998,8442,7105,1.0,0.0,77,2.0,42,2,84,6027.0,0.46848246455192566,0.02498406544327736
9811671,7080857,4638210,15286,11163,2006,4037,1987,4123,11249,0.0,0.0,15,5.0,13,3,609,4025.0,0.34052565693855286,0.08579374104738235
9811649,7616784,6928733,15286,12367,2009,10820,2005,2919,4466,1.0,0.0,7,11.0,7,18,42,210.0,0.4050682783126831,0.22965534031391144
9808648,5730745,4497285,15286,8118,1998,3323,1985,7168,11963,1.0,0.0,26,12.0,20,5,91,112.0,0.42950791120529175,0.21200530230998993
9808247,8167185,4767475,15286,13270,2012,4625,1988,2016,10661,1.0,0.0,293,9.0,1087,1,0,4816.0,0.33257216215133667,0.13486863672733307
9808395,4280485,7095638,15286,2035,1981,11191,2006,13251,4095,1.0,0.0,65,9.0,6,10,77,497.0,0.5611497163772583,0.2156701236963272
9812846,6014214,4445368,15286,8776,2000,3043,1984,6510,12243,0.25,0.25,130,3.0,5,1,14,4347.0,0.4771738052368164,0.1796700656414032
9814772,6146632,4965152,15293,9084,2000,5409,1990,6209,9884,0.5,0.0,46,6.0,5,5,91,1554.0,0.5993776917457581,0.10981275886297226
9817992,9230085,8398332,15293,14614,2016,13592,2013,679,1701,0.5,0.0,20,2.0,82,9,7,210.0,0.4967670738697052,0.17523795366287231
9814589,6821298,4394663,15293,10554,2004,2756,1983,4739,12537,1.0,0.0,213,8.0,32,3,7,980.0,0.5208678841590881,0.17106352746486664
9814418,5791347,9115781,15293,8258,1998,14481,2015,7035,812,1.0,0.0,430,2.0,2,61,7,140.0,0.4116665720939636,0.18428699672222137
9817025,7915909,6404440,15293,12871,2011,9658,2002,2422,5635,1.0,0.0,7,5.0,10,5,175,1197.0,0.7297322154045105,0.1623586267232895
9819499,7573941,6015623,15293,12276,2009,8783,2000,3017,6510,0.5,0.0,2,2.0,3,3,1344,5110.0,0.423490434885025,0.07212361693382263
9815313,8670011,4865011,15293,13949,2014,5003,1989,1344,10290,0.5,0.0,2,3.0,2,6,399,2331.0,0.4339745044708252,0.22678838670253754
9818982,6639249,8126933,15293,10162,2003,13207,2012,5131,2086,1.0,0.0,16,4.0,436,4,532,854.0,0.5340016484260559,0.3085242211818695
9823839,6282521,4130610,15300,9371,2001,1083,1978,5929,14217,1.0,0.0,300,5.0,6,1,7,13244.0,0.3038288652896881,0.2727433741092682
9826106,8976368,6141719,15300,14313,2015,9070,2000,987,6230,0.0,0.5,71,26.0,5,26,14,952.0,0.0958840399980545,0.07573937624692917
9824074,6587837,7138920,15300,10043,2003,11282,2006,5257,4018,1.0,0.0,435,14.0,66,9,7,595.0,0.41899052262306213,0.36375072598457336
9821134,6192886,5556941,15300,9189,2001,7565,1996,6111,7735,0.5,0.3333333333333333,198,2.0,21,3,14,3976.0,0.545370876789093,0.1888016164302826
9820770,5865800,7453597,15300,8433,1999,12010,2008,6867,3290,1.0,0.0,174,3.0,90,12,28,2597.0,0.1136375367641449,0.06137346103787422
9820810,6942657,4812009,15300,10848,2005,4821,1989,4452,10479,1.0,0.0,157,38.0,32,11,7,420.0,0.3851284384727478,0.29558485746383667
9820684,4442836,5069632,15300,3029,1984,5815,1991,12271,9485,1.0,0.0,230,21.0,2,3,21,273.0,0.31416353583335876,0.19029781222343445
9826197,4734764,8725395,15300,4471,1988,14012,2014,10829,1288,1.0,0.0,322,1.0,41,1,14,1288.0,0.5060703158378601,0.17129957675933838
9825179,7453065,5625898,15300,12010,2008,7796,1997,3290,7504,0.0,0.0,2431,3.0,5,2,0,6580.0,0.20601142942905426,0.11899880319833755
9820642,7048686,8835364,15300,11100,2006,14138,2014,4200,1162,1.0,0.0,12,4.0,12,136,497,238.0,0.382328599691391,0.1548619270324707
9821152,7641636,4991605,15300,12423,2010,5521,1991,2877,9779,1.0,0.0,15,22.0,7,13,14,21.0,0.6683504581451416,0.24694067239761353
9820814,6306132,6073883,15300,9427,2001,8930,2000,5873,6370,1.0,0.0,133,39.0,18,4,0,126.0,0.22272735834121704,0.1431969702243805
9828418,8021645,8765274,15307,13046,2011,14061,2014,2261,1246,0.0,0.0,2,1.0,1,2,637,1246.0,0.4197145402431488,0.10486557334661484
9827942,8474862,9279261,15307,13697,2013,14677,2016,1610,630,1.0,0.0,4,1.0,19,2,497,630.0,0.4649953544139862,0.1841818392276764
9827126,6251132,5029125,15307,9308,2001,5661,1991,5999,9646,1.0,0.0,282,47.0,30,9,0,1701.0,0.6225563287734985,0.20080672204494476
9830782,5907199,6940843,15307,8545,1999,10841,2005,6762,4466,0.0,0.25,20,28.0,59,4,56,182.0,0.3614853322505951,0.2690732479095459
9827391,5113857,7392474,15307,5983,1992,11863,2008,9324,3444,1.0,0.0,134,8.0,4,9,63,525.0,0.464592844247818,0.12505124509334564
9828732,9103083,4166164,15307,14467,2015,1335,1979,840,13972,1.0,0.0,1,3.0,8,5,840,91.0,0.6601195335388184,0.0060008130967617035
9831198,8549363,4185631,15307,13788,2013,1489,1980,1519,13818,0.0,0.0,9,16.0,8,2,7,7.0,0.2374451905488968,0.1668054610490799
9826978,5944172,4305523,15307,8643,1999,2175,1981,6664,13132,0.0,0.0,258,2.0,2,3,0,126.0,0.3518499732017517,0.35289520025253296
9827755,7758947,4096452,15307,12619,2010,901,1978,2688,14406,0.25,0.0,5,7.0,7,2,0,2870.0,0.18569327890872955,0.1382756531238556
9830367,6993591,8678207,15307,10988,2006,13963,2014,4319,1344,1.0,0.0,60,6.0,33,9,119,371.0,0.45078521966934204,0.24239051342010498
9826716,8656866,5855195,15307,13935,2014,8405,1999,1372,6902,1.0,0.0,1,7.0,21,15,1372,336.0,0.5638360977172852,0.14424651861190796
9833242,6063097,8663777,15314,8902,2000,13942,2014,6412,1372,1.0,0.0,578,7.0,13,6,0,119.0,0.40569132566452026,0.06875171512365341
9832928,6389884,6948172,15314,9637,2002,10855,2005,5677,4459,1.0,0.0,9,5.0,11,9,42,14.0,0.5235990285873413,0.2505781948566437
9833336,6881228,4447482,15314,10701,2005,3050,1984,4613,12264,1.0,0.5,156,4.0,48,8,21,35.0,0.48637187480926514,0.49431532621383667
9835640,5635137,4961701,15314,7824,1997,5395,1990,7490,9919,0.6666666666666666,0.0,4,7.0,9,7,63,1743.0,0.3603224754333496,0.3548630177974701
9835959,6393037,7739648,15314,9637,2002,12584,2010,5677,2730,0.0,0.0,22,2.0,11,4,133,1820.0,0.47114238142967224,0.2514435946941376
9833289,6896678,5155744,15314,10736,2005,6130,1992,4578,9184,1.0,0.0,15,9.0,17,2,448,5523.0,0.6381353735923767,0.1455198973417282
9833244,8734153,7082882,15314,14026,2014,11170,2006,1288,4144,0.5,0.0,8,9.0,10,5,7,231.0,0.48299640417099,0.14081096649169922
9835103,7347183,8516644,15314,11772,2008,13753,2013,3542,1561,1.0,0.0,9,1.0,3,3,140,1561.0,0.4929737448692322,0.14762084186077118
9839041,7623879,6693436,15314,12381,2009,10274,2004,2933,5040,1.0,0.0,21,16.0,2,9,210,539.0,0.5402743220329285,0.21791110932826996
9833245,4800874,4051085,15314,4779,1989,635,1977,10535,14679,1.0,0.0,243,7.0,4,1,7,5936.0,0.32794591784477234,0.04513849318027496
9835265,5887847,7004283,15314,8489,1999,11016,2006,6825,4298,0.5,0.0,19,11.0,3,14,168,28.0,0.4506820738315582,0.139755517244339
9833227,6039761,7961654,15314,8846,2000,12948,2011,6468,2366,1.0,0.0,568,10.0,16,23,7,875.0,0.3440289795398712,0.19744981825351715
9833158,5579284,9308984,15314,7635,1996,14712,2016,7679,602,0.0,0.0,73,1.0,8,16,14,602.0,0.2219112068414688,0.20359086990356445
9841161,7994525,5052536,15321,13004,2011,5752,1991,2317,9569,0.25,0.0,181,7.0,1,3,14,1505.0,0.33944371342658997,0.039116647094488144
9841935,re41487,8784246,15321,12640,2010,14082,2014,2681,1239,0.5,0.0,25,2.0,52,4,0,735.0,0.2895602881908417,0.2024819701910019
9842345,5173851,6666818,15321,6200,1992,10218,2003,9121,5103,0.3333333333333333,0.0,557,10.0,4,27,21,168.0,0.42159050703048706,0.049704667180776596
9843212,4703191,8885139,15321,4317,1987,14194,2014,11004,1127,0.3333333333333333,0.0,44,8.0,22,66,42,91.0,0.5175474286079407,0.226754829287529
9843201,6329908,7854964,15321,9476,2001,12773,2010,5845,2548,0.0,0.0,46,2.0,19,5,7,1862.0,0.34115010499954224,0.008367251604795456
9839386,6485439,5120240,15321,9826,2002,6004,1992,5495,9317,1.0,0.0,187,10.0,27,11,21,4102.0,0.5692700147628784,0.29319730401039124
9841727,7158735,4239321,15321,11324,2007,1811,1980,3997,13510,1.0,0.0,45,11.0,31,1,0,2359.0,0.7301400899887085,0.2037578672170639
9841724,7174122,8252891,15321,11359,2007,13389,2012,3962,1932,1.0,0.0,46,2.0,13,5,7,77.0,0.5256500840187073,0.07412423193454742
9847704,4354126,9532446,15328,2476,1982,14971,2016,12852,357,1.0,0.0,62,1.0,3,41,616,357.0,0.5302781462669373,0.17819535732269287
9848075,6221026,5932494,15328,9245,2001,8615,1999,6083,6713,0.5,0.0,28,8.0,1,2,175,77.0,0.2854924499988556,0.09706181287765503
9845368,6833415,8745635,15328,10582,2004,14033,2014,4746,1295,0.5,0.0,224,2.0,52,3,0,140.0,0.2817394733428955,0.09480442851781845
9846878,7593896,5729924,15328,12318,2009,8118,1998,3010,7210,0.5,0.0,53,22.0,88,17,0,1652.0,0.45521461963653564,0.22164595127105713
9844368,7588177,5908069,15328,12311,2009,8552,1999,3017,6776,1.0,0.0,385,14.0,245,7,7,413.0,0.4637790322303772,0.21257279813289642
9846622,7636824,4343022,15328,12409,2009,2406,1982,2919,12922,1.0,0.0,24,3.0,5,4,84,6608.0,0.5321349501609802,0.2803182303905487
9844374,7419080,4671484,15328,11933,2008,4177,1987,3395,11151,1.0,0.0,529,4.0,7,5,0,3759.0,0.637894332408905,0.2539122402667999
9844871,8745789,5582417,15328,14040,2014,7649,1996,1288,7679,0.5,0.0,4,7.0,54,7,399,14.0,0.326357901096344,0.2573559582233429
9848076,9037455,5607753,15328,14383,2015,7733,1997,945,7595,0.0,0.0,9,4.0,18,11,112,1617.0,0.6486184000968933,0.21277758479118347
9847850,7289828,5119340,15328,11625,2007,5997,1992,3703,9331,0.3333333333333333,0.0,43,26.0,12,1,0,203.0,0.20766115188598633,0.2428206205368042
9853692,7027311,6015516,15335,11058,2006,8783,2000,4277,6552,0.5,0.0,213,9.0,7,3,0,609.0,0.5713991522789001,0.06488379091024399
9853732,8509850,4649371,15335,13739,2013,4086,1987,1596,11249,0.5,0.0,38,19.0,19,5,49,735.0,0.3919718861579895,0.1820123940706253
9850148,5145585,8727516,15335,6095,1992,14019,2014,9240,1316,1.0,0.0,48,1.0,11,14,224,1316.0,0.6996812224388123,0.2299545854330063
9854523,8238260,8955033,15335,13368,2012,14285,2015,1967,1050,1.0,0.5,7,2.0,1,1,119,294.0,0.402601033449173,0.4053308665752411
9849817,5975629,4010386,15335,8706,1999,425,1977,6629,14910,0.0,0.0,49,14.0,46,1,7,196.0,0.37550947070121765,0.18744902312755585
9853820,7979626,4066117,15335,12976,2011,733,1978,2359,14602,0.5,0.0,10,43.0,6,1,0,455.0,0.2714337110519409,0.07144051045179367
9852930,9165793,4066600,15335,14537,2015,733,1978,798,14602,1.0,0.0,18,26.0,44,2,28,6104.0,0.43100619316101074,0.2067692130804062
9859465,9209351,5166238,15342,14586,2015,6172,1992,756,9170,1.0,0.0,2,12.0,4,3,378,266.0,0.47971829771995544,0.18142169713974
9860570,7373415,5035580,15342,11821,2008,5689,1991,3521,9653,0.0,0.0,39,24.0,2,8,28,287.0,0.3851645588874817,0.21936345100402832
9855376,4221543,6400528,15342,1713,1980,9651,2002,13629,5691,0.25,0.0,57,2.0,5,5,126,2254.0,0.3815585672855377,0.21147511899471283
9858559,8335161,6463561,15342,13501,2012,9777,2002,1841,5565,0.5,0.0,69,18.0,11,5,105,70.0,0.35044118762016296,0.052475254982709885
9862026,5364078,4413093,15349,6893,1994,2861,1983,8456,12488,0.3333333333333333,0.0,66,3.0,7,1,7,8680.0,0.30738237500190735,0.07979574054479599
9862778,5264365,8576637,15349,6536,1993,13823,2013,8813,1526,0.0,0.0,55,2.0,2,10,56,63.0,0.35545849800109863,0.15533636510372162
9861536,5914084,8427287,15349,8573,1999,13627,2013,6776,1722,0.25,0.0,102,1.0,5,1,21,1722.0,0.5823644995689392,0.032133910804986954
9861470,6214015,6470392,15349,9231,2001,9791,2002,6118,5558,1.0,0.0,49,7.0,60,16,231,1638.0,0.6221206188201904,0.23811012506484985
9865911,7301440,4343749,15349,11653,2007,2413,1982,3696,12936,0.2,0.0,50,2.0,270,2,7,511.0,0.4414234161376953,0.0863783061504364
9864769,7216164,5162710,15349,11450,2007,6158,1992,3899,9191,1.0,0.0,34,8.0,15,7,0,5264.0,0.3666341304779053,0.12080474197864532
9861359,8043328,5002547,15349,13081,2011,5563,1991,2268,9786,1.0,1.0,223,10.0,154,6,14,7.0,0.5369920134544373,0.3033355474472046
9861304,8489364,4210769,15349,13711,2013,1643,1980,1638,13706,0.0,0.0,137,3.0,328,2,14,12348.0,0.21299220621585846,0.10819581151008606
9864091,8774351,5365684,15349,14068,2014,6900,1994,1281,8449,1.0,0.0,3,7.0,1,3,98,525.0,0.5519415140151978,0.13980598747730255
9865280,5757358,6592909,15349,8181,1998,10057,2003,7168,5292,0.0,0.0,243,6.0,10,1,0,1946.0,0.32916519045829773,0.11341213434934616
9864988,8332290,8749659,15349,13494,2012,14040,2014,1855,1309,1.0,0.3333333333333333,22,2.0,15,6,161,91.0,0.571478009223938,0.1940065324306488
9861505,9597209,5063693,15349,15055,2017,5794,1991,294,9555,1.0,0.0,1,3.0,17,10,294,7014.0,0.9999999403953552,0.36611849069595337
9863880,8467061,7927672,15349,13683,2013,12892,2011,1666,2457,0.0,0.0,9,2.0,67,4,119,987.0,0.520573616027832,0.11817222833633423
9861492,8308781,9534682,15349,13466,2012,14978,2017,1883,371,1.0,0.0,3,1.0,2,8,210,371.0,0.4263078570365906,0.2910701632499695
9864957,6236365,5008287,15349,9273,2001,5584,1991,6076,9765,0.0,0.0,702,2.0,166,1,7,3185.0,0.3214021921157837,-0.07529331743717194
9862617,4649227,9449468,15349,4086,1987,14873,2016,11263,476,0.2,0.0,9,1.0,3,272,238,476.0,0.665585994720459,0.08922524750232697
9870218,6189011,4613932,15356,9175,2001,3918,1986,6181,11438,0.5,0.0,850,5.0,10,6,7,1295.0,0.3200986087322235,0.06782258301973343
9867761,7030985,7544014,15356,11065,2006,12213,2009,4291,3143,0.25,0.0,7,3.0,204,17,154,1330.0,0.48486220836639404,0.15550464391708374
9872072,7930285,4359884,15356,12892,2011,2518,1982,2464,12838,0.0,0.0,10,2.0,75,2,0,5250.0,0.454659104347229,-0.01280995924025774
9869692,8124895,5070377,15356,13207,2012,5815,1991,2149,9541,0.0,0.0,4,19.0,4,2,259,819.0,0.5140408873558044,0.0685502141714096
9869450,7918581,4601288,15356,12878,2011,3855,1986,2478,11501,1.0,0.0,26,32.0,108,7,98,364.0,0.5990416407585144,0.24137181043624878
9871616,6545586,6763604,15356,9959,2003,10428,2004,5397,4928,0.0,0.0,4,4.0,8,5,931,2702.0,0.513160228729248,0.15040689706802368
9871599,8071431,5033429,15356,13123,2011,5682,1991,2233,9674,0.25,0.0,43,2.0,31,1,21,1736.0,0.4683592915534973,0.018950464203953743
9871355,8927888,4986119,15356,14250,2015,5500,1991,1106,9856,0.0,0.0,2,10.0,9,2,616,35.0,0.3274363875389099,0.13062667846679688
9876279,7463212,5028267,15363,12031,2008,5661,1991,3332,9702,1.0,0.0,6,7.0,25,6,301,826.0,0.5823529958724976,0.14107626676559448
9872613,6289144,5225192,15363,9385,2001,6396,1993,5978,8967,0.0,1.0,55,14.0,5,6,105,1162.0,0.39304736256599426,0.25146329402923584
9876320,9386961,4879752,15363,14803,2016,5059,1989,560,10304,0.5,0.0,31,52.0,530,3,0,847.0,0.28668448328971863,0.10938668996095657
9872684,6644532,7297698,15363,10176,2003,11646,2007,5187,3717,1.0,0.5,765,4.0,44,1,0,1302.0,0.5660576820373535,0.010983024723827839
9876587,8072323,5865564,15363,13123,2011,8433,1999,2240,6930,0.3333333333333333,0.0,85,27.0,15,11,0,56.0,0.39452990889549255,0.2532302439212799
9876957,8760563,8846601,15363,14054,2014,14152,2014,1309,1211,1.0,0.0,98,2.0,108,14,0,476.0,0.47665736079216003,0.048184994608163834
9872781,7875062,4571485,15363,12808,2011,3701,1986,2555,11662,1.0,0.0,10,39.0,13,2,7,378.0,0.392546683549881,0.17634466290473938
9873045,5558339,4317036,15363,7572,1996,2245,1982,7791,13118,1.0,0.0,284,24.0,20,1,42,259.0,0.6569283604621887,0.1989232897758484
9876401,6888272,4540624,15363,10715,2005,3540,1985,4648,11823,0.5,0.0,22,17.0,13,2,140,700.0,0.6537376046180725,0.30260568857192993
9872944,7163618,4569046,15363,11338,2007,3687,1986,4025,11676,0.0,0.0,12,9.0,24,18,91,8834.0,0.35583722591400146,0.15891756117343903
9874235,8632286,8885812,15363,13900,2014,14194,2014,1463,1169,0.0,0.0,6,3.0,4,128,98,546.0,0.7320947647094727,0.12676902115345
9872960,5975355,5211241,15363,8706,1999,6347,1993,6657,9016,0.0,0.0,7,9.0,9,3,609,28.0,0.4506831765174866,0.32248032093048096
9872682,7055730,7246431,15363,11114,2006,11527,2007,4249,3836,1.0,0.0,525,17.0,67,22,7,28.0,0.5959576964378357,0.2384617030620575
9875636,8058985,7801974,15363,13102,2011,12682,2010,2261,2681,0.25,0.0,10,3.0,35,7,273,126.0,0.3528057932853699,0.11670869588851929
9873362,7195274,4731696,15363,11408,2007,4457,1988,3955,10906,0.5,0.0,21,20.0,19,3,0,399.0,0.4578339457511902,0.22412218153476715
9875414,6150930,4266282,15363,9091,2000,1951,1981,6272,13412,0.0,0.0,64,18.0,10,3,0,56.0,0.3719128370285034,0.1942140758037567
9878324,6989128,4853541,15370,10981,2006,4961,1989,4389,10409,0.5,0.0,49,4.0,21,1,21,6013.0,0.5481544733047485,0.12433263659477234
9878897,5297423,8616960,15370,6662,1994,13879,2013,8708,1491,0.3333333333333333,0.0,53,3.0,14,23,420,105.0,0.6121038794517517,0.21748510003089905
9880395,6549650,4136291,15370,9966,2003,1118,1979,5404,14252,0.0,0.0,104,33.0,11,2,14,140.0,0.5130255818367004,0.2106066644191742
9883360,6611757,5128233,15370,10099,2003,6032,1992,5271,9338,0.0,0.0,151,7.0,22,6,35,7595.0,0.5378676056861877,0.0589570552110672
9878993,7531536,4043604,15370,12185,2009,600,1977,3185,14770,0.5,0.0,28,5.0,55,1,322,1064.0,0.6101593971252441,0.10068872570991516
9883884,7156189,8968048,15377,11324,2007,14306,2015,4053,1071,0.25,0.0,117,1.0,31,23,42,1071.0,0.1519450694322586,0.3147711157798767
9887000,6812464,4115518,15377,10533,2004,992,1978,4844,14385,0.0,0.0,34,25.0,13,2,77,77.0,0.3075547516345978,-0.07418905198574066
9886953,4802223,4756366,15377,4779,1989,4576,1988,10598,10801,1.0,0.0,70,6.0,2,6,0,6104.0,0.3964192569255829,0.19746306538581848
9887082,8492170,7097613,15377,13718,2013,11198,2006,1659,4179,0.5,0.0,31,5.0,10,27,35,2072.0,0.22507049143314362,0.2709089517593384
9886692,6339384,7487836,15377,9511,2002,12094,2009,5866,3283,0.0,0.0,50,7.0,11,19,147,77.0,0.4696856737136841,0.12868444621562958
9884456,4664305,5934240,15377,4149,1987,8622,1999,11228,6755,0.5,0.0,696,3.0,14,5,0,3675.0,0.3092888295650482,0.14605805277824402
9886322,5918017,4796709,15377,8580,1999,4758,1989,6797,10619,0.5,0.0,182,27.0,9,4,49,854.0,0.46189579367637634,0.16226860880851746
9885117,8083853,4711777,15377,13144,2011,4359,1987,2233,11018,1.0,0.0,123,11.0,122,1,7,3283.0,0.3304993808269501,0.14367608726024628
9887035,6753749,4748905,15377,10400,2004,4541,1988,4977,10836,0.5,0.0,10,9.0,4,2,70,1029.0,0.5290955305099487,0.1412317007780075
9893236,6996147,4825215,15384,10995,2006,4863,1989,4389,10521,0.5,0.0,233,6.0,16,6,14,2016.0,0.23711352050304413,-0.1602560430765152
9894141,5339392,5752469,15384,6802,1994,8174,1998,8582,7210,0.5,0.0,674,3.0,11,2,7,4648.0,0.310818612575531,0.22538527846336365
9890420,5840867,4871035,15384,8363,1998,5024,1989,7021,10360,0.16666666666666666,0.0,85,10.0,4,1,84,4312.0,0.39316800236701965,0.14974112808704376
9889054,6971997,8175261,15384,10932,2005,13277,2012,4452,2107,0.5,0.0,91,3.0,79,4,14,427.0,0.3949992060661316,0.05306689068675041
9890234,6207782,6600501,15384,9217,2001,10071,2003,6167,5313,0.3333333333333333,0.0,32,32.0,9,7,49,28.0,0.5846427083015442,0.11122611910104752
9888919,8444549,4815186,15384,13655,2013,4835,1989,1729,10549,1.0,0.0,222,8.0,13,3,7,5012.0,0.34701940417289734,0.27335426211357117
9891837,6882569,6742537,15384,10701,2005,10379,2004,4683,5005,0.0,0.0,14,6.0,5,7,1330,2366.0,0.5405683517456055,0.20285511016845703
9889600,6640679,4246558,15384,10169,2003,1846,1981,5215,13538,0.5,0.0,13,6.0,4,5,245,1288.0,0.3319084644317627,0.22950337827205658
9893905,8095594,5217177,15384,13158,2012,6368,1993,2226,9016,0.5,0.0,661,6.0,18,8,0,630.0,0.4904961884021759,0.15057283639907837
9895147,9351727,6861891,15391,14761,2016,10652,2005,630,4739,1.0,0.0,86,10.0,2295,5,14,805.0,0.7176947593688965,0.24375134706497192
9898266,7478377,4055423,15391,12066,2009,663,1977,3325,14728,1.0,0.0,6,8.0,19,1,189,1316.0,0.364070326089859,0.04878237098455429
9896424,7637968,7702619,15391,12416,2009,12528,2010,2975,2863,0.25,0.0,31,3.0,1,11,35,28.0,0.26162242889404297,0.08709414303302765
9899834,7068459,4695808,15391,11135,2006,4282,1987,4256,11109,0.5,0.0,156,15.0,17,1,14,161.0,0.16357548534870148,0.25743597745895386
9895179,5201735,4470190,15391,6312,1993,3176,1984,9079,12215,1.0,0.0,75,17.0,11,4,35,343.0,0.5096414089202881,0.0258636511862278
9898357,8954979,7245566,15391,14285,2015,11520,2007,1106,3871,1.0,0.0,9,2.0,10,10,14,2422.0,0.3672332763671875,0.2698579728603363
9895471,5215522,5640455,15391,6361,1993,7838,1997,9030,7553,1.0,0.0,483,6.0,59,1,0,3388.0,0.3809342682361603,0.08552828431129456
9895148,7799965,7452204,15391,12682,2010,12010,2008,2709,3381,0.25,0.25,180,1.0,16,12,0,3381.0,0.12736289203166962,0.11347384750843048
9899743,6624796,8178853,15391,10127,2003,13284,2012,5264,2107,1.0,0.0,10,4.0,11,20,714,658.0,0.6289713382720947,0.2435176968574524
9895012,7520633,5618703,15391,12164,2009,7768,1997,3227,7623,0.0,0.0,5,45.0,14,4,805,28.0,0.5342974066734314,0.019566528499126434
9895199,5558083,4707418,15391,7572,1996,4338,1987,7819,11053,1.0,0.0,131,10.0,10,14,147,2513.0,0.3376394212245941,0.24247629940509796
9905005,6440706,4487611,15398,9735,2002,3267,1984,5663,12131,0.0,0.0,195,9.0,8,6,0,609.0,0.1229550689458847,-0.03978665918111801
9901481,5479944,6950020,15398,7306,1996,10862,2005,8092,4536,1.0,0.0,56,7.0,6,12,0,161.0,0.5428882241249084,0.11053671687841415
9904576,7171479,6254280,15398,11352,2007,9315,2001,4046,6083,1.0,0.0,11,4.0,15,2,294,483.0,0.4571788012981415,0.1330740600824356
9902803,8084130,9165646,15398,13144,2011,14537,2015,2254,861,0.2,0.0,1,2.0,4,9,2254,315.0,0.6493220329284668,0.1260281652212143
9906850,7388960,4866109,15398,11856,2008,5003,1989,3542,10395,1.0,0.0,13,5.0,7,1,91,8120.0,0.5470157265663147,0.17812325060367584
9906260,5557292,7630744,15398,7565,1996,12395,2009,7833,3003,0.0,1.0,44,6.0,5,2,168,819.0,0.4126257002353668,0.1835043728351593
9906269,4030048,4008004,15398,530,1977,411,1977,14868,14987,0.3333333333333333,0.0,104,5.0,1,1,0,917.0,0.2688511312007904,0.17209380865097046
9903020,4857140,7605676,15398,4975,1989,12346,2009,10423,3052,0.0,0.5,105,2.0,4,6,21,679.0,0.3964625895023346,0.03194967284798622
9901344,7510107,7304618,15398,12143,2009,11660,2007,3255,3738,1.0,0.0,632,15.0,23,17,0,161.0,0.5378075242042542,0.14160187542438507
9902995,7745609,4087610,15398,12598,2010,852,1978,2800,14546,0.3333333333333333,0.0,75,3.0,227,1,0,8106.0,0.5172635912895203,0.25343114137649536
9901343,5403326,7295542,15398,7033,1995,11639,2007,8365,3759,1.0,0.0,553,5.0,30,4,35,7.0,0.3728690445423126,0.11358775198459625
9913139,6362789,9277619,15405,9581,2002,14670,2016,5824,735,0.0,0.0,136,1.0,3,5,0,735.0,0.2598157525062561,0.2253302037715912
9913341,8674613,4442015,15405,13956,2014,3022,1984,1449,12383,0.3333333333333333,0.0,17,11.0,1,3,98,413.0,0.3308335244655609,0.12225688248872757
9907687,7288076,4234837,15405,11625,2007,1783,1980,3780,13622,1.0,0.0,71,4.0,12,5,42,5033.0,0.570115864276886,0.20113247632980347
9911915,8525553,4054477,15405,13760,2013,656,1977,1645,14749,0.0,0.0,2,22.0,7,1,1456,287.0,0.34066471457481384,0.3294503688812256
9912832,7533180,4553610,15405,12185,2009,3610,1985,3220,11795,0.0,0.0,2,3.0,15,1,2919,539.0,0.1721656769514084,0.14014410972595215
9907641,6352553,4261306,15405,9560,2002,1930,1981,5845,13475,1.0,0.0,248,4.0,321,1,42,6006.0,0.6034975051879883,-0.032333988696336746
9912083,7857667,5390737,15405,12780,2010,6991,1995,2625,8414,0.5,0.0,20,17.0,8,11,7,77.0,0.5827704668045044,0.30044180154800415
9910285,6137633,4191379,15405,9063,2000,1524,1980,6342,13881,0.25,0.0,73,2.0,8,1,392,10934.0,0.5729213953018188,0.21747525036334991
9910950,6553559,4321781,15405,9973,2003,2280,1982,5432,13125,0.5,0.0,215,10.0,24,1,7,1337.0,0.1691296547651291,0.30265358090400696
9913069,8931001,4712797,15405,14250,2015,4366,1987,1155,11039,1.0,0.0,8,7.0,3,1,175,217.0,0.4099699854850769,0.22746460139751434
9917341,9270013,5128211,15412,14663,2016,6032,1992,749,9380,0.5,0.0,65,4.0,5,7,7,4697.0,0.4477871358394623,0.044334813952445984
9913630,7229439,5732739,15412,11485,2007,8125,1998,3927,7287,1.0,0.0,14,6.0,133,1,154,791.0,0.5961933732032776,0.12347042560577393
9916616,6954733,4008548,15412,10876,2005,418,1977,4536,14994,1.0,0.0,118,24.0,6,1,49,252.0,0.4361008107662201,0.1773252934217453
9914097,7713413,4247573,15412,12549,2010,1853,1981,2863,13559,0.0,0.0,39,9.0,11,4,119,525.0,0.3420713245868683,0.12893278896808624
9916370,8914500,8521388,15412,14229,2014,13753,2013,1183,1659,1.0,1.0,2,7.0,46,9,154,217.0,0.27754491567611694,0.056599948555231094
9913935,7452354,5456862,15412,12010,2008,7222,1995,3402,8190,0.5,0.0,14,12.0,63,5,7,3087.0,0.5391896367073059,0.24042899906635284
9915613,5578270,9221434,15412,7635,1996,14607,2015,7777,805,0.5,0.0,159,1.0,3,4,7,805.0,0.20191165804862976,0.16793115437030792
9913953,6949709,8463284,15412,10862,2005,13676,2013,4550,1736,0.0,0.0,9,1.0,5,192,1043,1736.0,0.12420536577701569,0.21994313597679138
9919210,6857122,4825804,15419,10638,2005,4870,1989,4781,10549,0.0,0.0,44,14.0,6,4,14,2093.0,0.2543752193450928,0.08021267503499985
9922843,7315077,5300315,15419,11688,2008,6669,1994,3731,8750,1.0,0.0,58,4.0,11,2,7,5250.0,0.5002015233039856,0.2987286150455475
9918852,5885299,4861104,15419,8482,1999,4989,1989,6937,10430,1.0,0.0,384,32.0,95,3,0,7.0,0.3754536211490631,0.19524657726287842
9919396,4561825,5587244,15419,3652,1985,7663,1996,11767,7756,0.5,0.0,14,13.0,1,13,1211,28.0,0.38950246572494507,0.2228916585445404
9920361,6183958,3999130,15419,9168,2001,355,1976,6251,15064,0.3333333333333333,0.0,31,4.0,1,1,84,6972.0,0.6468349695205688,0.16074694693088531
9923966,9092441,7079505,15419,14453,2015,11156,2006,966,4263,0.5,0.5,13,4.0,26,8,21,196.0,0.5366035103797913,0.4005935490131378
9922490,8177622,4080108,15419,13284,2012,811,1978,2135,14608,0.0,0.0,11,4.0,11,1,182,5803.0,0.3850637674331665,0.3664838671684265
9925060,8377098,4471392,15426,13564,2013,3176,1984,1862,12250,1.0,0.0,19,6.0,320,1,133,10234.0,0.48337581753730774,0.16802291572093964
9927835,5825352,5683358,15426,8328,1998,7978,1997,7098,7448,0.0,0.0,1301,22.0,21,4,7,126.0,0.3212212026119232,0.19089865684509277
9929281,6781109,4902696,15426,10463,2004,5164,1990,4963,10262,0.5,0.0,9,4.0,3,10,763,6741.0,0.3239506185054779,-0.015019242651760578
9929508,5944550,8314197,15426,8643,1999,13473,2012,6783,1953,1.0,0.0,6,3.0,3,3,49,539.0,0.6726861000061035,0.032756317406892776
9927964,6882337,6967951,15426,10701,2005,10918,2005,4725,4508,0.0,0.0,71,20.0,14,29,21,1197.0,0.5005168318748474,0.32260552048683167
9927591,6160946,7907736,15426,9112,2000,12857,2011,6314,2569,1.0,0.0,226,8.0,8,161,14,77.0,0.577191174030304,0.2441142201423645
9924923,7621873,4075819,15426,12381,2009,789,1978,3045,14637,1.0,0.0,21,12.0,47,1,301,385.0,0.5166748762130737,0.15515093505382538
9924930,6635073,5488979,15426,10155,2003,7341,1996,5271,8085,1.0,0.0,361,5.0,24,15,7,1918.0,0.23774632811546326,0.3724943697452545
9924916,7945013,7264590,15426,12920,2011,11569,2007,2506,3857,0.5,0.5,6,23.0,2,12,308,77.0,0.6685490608215332,0.2750498652458191
9928144,7953802,4050484,15426,12934,2011,635,1977,2492,14791,1.0,0.0,22,8.0,274,1,420,196.0,0.44370171427726746,0.10776360332965851
9925008,6726694,6372655,15426,10344,2004,9602,2002,5082,5824,1.0,0.0,180,14.0,105,2,7,1351.0,0.43472620844841003,0.18459628522396088
9925286,6461569,6478807,15426,9777,2002,9812,2002,5649,5614,1.0,1.0,46,15.0,7,21,0,49.0,0.4456193745136261,0.3067338466644287
9926622,5645900,6897462,15426,7859,1997,10736,2005,7567,4690,0.3333333333333333,0.0,56,9.0,12,5,21,378.0,0.5711814761161804,0.1249963566660881
9926478,6379751,6881217,15426,9616,2002,10701,2005,5810,4725,0.1111111111111111,0.0,38,2.0,15,6,14,1589.0,0.42692700028419495,0.02196279540657997
9928477,9760851,5140270,15426,15230,2017,6074,1992,196,9352,0.3333333333333333,0.0,2,6.0,85,1,140,6657.0,0.7785887718200684,0.16430296003818512
9933053,7641580,4524266,15433,12423,2010,3456,1985,3010,11977,0.25,0.0,4,10.0,5,3,49,3626.0,0.5560197234153748,0.14267446100711823
9934572,7798263,4489634,15433,12682,2010,3281,1984,2751,12152,0.0,0.0,51,8.0,15,1,119,287.0,0.5544090270996094,0.22490493953227997
9931352,9278106,4379266,15433,14677,2016,2651,1983,756,12782,1.0,0.0,46,7.0,7,11,7,5838.0,0.6863237023353577,-0.021966567263007164
9932533,5098591,4266896,15433,5927,1992,1958,1981,9506,13475,0.0,0.0,52,5.0,17,1,1148,3080.0,0.5128544569015503,0.1812933385372162
9931134,5029574,6000063,15433,5668,1991,8748,1999,9765,6685,1.0,0.0,139,8.0,8,8,42,301.0,0.3421836793422699,0.23051771521568298
9941921,5627879,5611455,15440,7796,1997,7747,1997,7644,7693,1.0,0.0,306,6.0,37,4,7,1064.0,0.3956591486930847,0.09101472795009613
9942705,6901260,5089286,15440,10743,2005,5892,1992,4697,9548,0.5,0.0,40,9.0,4,12,35,700.0,0.5879555940628052,0.20242008566856384
9937387,6213889,6550109,15440,9231,2001,9973,2003,6209,5467,1.0,0.0,10,3.0,11,2,301,357.0,0.6262299418449402,0.31308722496032715
9941051,7579709,7962744,15440,12290,2009,12948,2011,3150,2492,0.0,0.0,8,5.0,5,14,7,595.0,0.3786923885345459,0.12921060621738434
9937075,8003124,6495875,15440,13018,2011,9847,2002,2422,5593,1.0,0.0,15,2.0,68,4,7,3458.0,0.26367324590682983,0.20560361444950104
9938765,7079045,6780286,15440,11156,2006,10463,2004,4284,4977,0.0,0.0,8,2.0,4,25,553,4074.0,0.2783210277557373,0.2209234982728958
9938673,5288166,4303979,15440,6627,1994,2161,1981,8813,13279,0.5,0.0,49,14.0,5,1,70,609.0,0.4158063232898712,0.11540361493825912
9937233,6251665,4455210,15440,9308,2001,3092,1984,6132,12348,0.0,0.0,49,12.0,4,4,70,1071.0,0.3986128270626068,0.16647657752037048
9939981,8060476,4261727,15440,13102,2011,1930,1981,2338,13510,0.5,0.0,91,5.0,89,5,14,1750.0,0.5352196097373962,0.00873126182705164
9939862,9748765,5013732,15440,15216,2017,5605,1991,224,9835,0.0,0.0,1,7.0,105,2,224,3514.0,0.40289321541786194,-0.04958934709429741
9939405,5746908,4389304,15440,8160,1998,2728,1983,7280,12712,0.5,0.5,15,19.0,7,6,175,2499.0,0.21147003769874573,0.16027000546455383
9947982,7518529,4386771,15447,12157,2009,2714,1983,3290,12733,0.3333333333333333,0.0,102,12.0,12,1,14,1092.0,0.2639918029308319,0.2872477173805237
9945580,7896570,4787128,15447,12843,2011,4716,1988,2604,10731,0.0,0.0,3,8.0,3,5,567,3822.0,0.14843177795410156,0.2517145574092865
9943755,6181343,4274519,15447,9161,2001,2000,1981,6286,13447,0.5,0.0,502,19.0,7,1,7,2436.0,0.509668231010437,0.09960948675870895
9945773,6401769,4492693,15447,9658,2002,3295,1985,5789,12152,0.0,0.0,7,2.0,7,1,490,11697.0,0.5611585974693298,0.08436893671751022
9946283,6586917,4482168,15447,10043,2003,3239,1984,5404,12208,1.0,0.0,23,10.0,4,5,497,70.0,0.508816659450531,0.21985480189323425
9948333,6452467,4395539,15447,9756,2002,2763,1983,5691,12684,0.0,0.0,133,2.0,10,1,0,10787.0,0.1813526451587677,-0.08629019558429718
9944408,7686247,4159241,15447,12507,2010,1272,1979,2940,14175,1.0,0.0,12,9.0,10,1,56,154.0,0.41880056262016296,0.08754923194646835
9953408,9311566,8281237,15454,14712,2016,13424,2012,742,2030,0.5,0.25,8,2.0,28,30,21,1309.0,0.29289671778678894,0.1513763666152954
9952950,8082433,6624894,15454,13137,2011,10127,2003,2317,5327,1.0,0.0,123,23.0,34,9,21,1085.0,0.5422496795654297,0.12979361414909363
9953445,8185819,4674125,15454,13291,2012,4184,1987,2163,11270,0.5,0.5,77,10.0,63,3,7,140.0,0.3933950662612915,0.196624755859375
9949833,5345483,8273045,15454,6823,1994,13417,2012,8631,2037,0.0,1.0,39,5.0,53,33,98,7.0,0.3619181215763092,0.336582750082016
9954975,8135392,8139748,15454,13221,2012,13228,2012,2233,2226,1.0,1.0,170,3.0,9,21,0,973.0,0.38363996148109436,0.2898155152797699
9950138,5318041,5893683,15454,6732,1994,8503,1999,8722,6951,1.0,0.0,50,13.0,16,9,1155,14.0,0.5615264177322388,0.1717585325241089
9952455,6574413,7988044,15454,10015,2003,12997,2011,5439,2457,1.0,0.0,5,2.0,5,29,84,1554.0,0.45612406730651855,0.1890171468257904
9951357,7932438,7204336,15454,12899,2011,11429,2007,2555,4025,0.25,0.0,35,4.0,72,5,14,154.0,0.9834161996841431,0.02511238493025303
9950171,5217471,7283981,15454,6368,1993,11611,2007,9086,3843,1.0,0.0,184,5.0,3,1,14,1008.0,0.2723233699798584,0.15707498788833618
9951128,5723323,4895629,15454,8097,1998,5136,1990,7357,10318,0.25,0.0,412,7.0,13,4,0,2835.0,0.2061435580253601,0.023677116259932518
9957499,8859229,7891039,15461,14166,2014,12836,2011,1295,2625,0.6666666666666666,0.0,7,4.0,30,7,126,1449.0,0.5866510272026062,0.0775563046336174
9959275,5887134,6735474,15461,8482,1999,10358,2004,6979,5103,1.0,0.0,684,14.0,5,32,21,7.0,0.33456671237945557,0.0918794646859169
9958854,8634950,7078697,15461,13900,2014,11156,2006,1561,4305,0.0,0.0,5,19.0,15,7,21,392.0,0.4557398557662964,-0.018079973757267
9957118,6454496,5504204,15461,9763,2002,7397,1996,5698,8064,0.0,0.0,5,2.0,10,31,308,21.0,0.4582248330116272,0.12668520212173462
9955726,6803545,4836438,15461,10512,2004,4905,1989,4949,10556,0.25,0.0,72,22.0,14,3,7,161.0,0.18364088237285614,0.23283785581588745
9959012,7111129,6345196,15461,11219,2006,9532,2002,4242,5929,0.3333333333333333,0.0,54,5.0,39,9,7,924.0,0.10843932628631592,0.09122598171234131
9961196,5559855,9534760,15461,7572,1996,14978,2017,7889,483,1.0,0.0,55,1.0,3,4,175,483.0,0.5130913853645325,0.25698456168174744
9961355,7372999,7112154,15461,11821,2008,11226,2006,3640,4235,0.0,0.0,16,8.0,5,6,126,595.0,0.4716004431247711,0.2752923369407654
9956412,6609031,4202951,15461,10092,2003,1594,1980,5369,13867,0.5,0.0,247,4.0,31,2,0,8498.0,0.556053876876831,-0.02432856149971485
9956320,6287333,6201767,15461,9385,2001,9203,2001,6076,6258,1.0,0.0,51,8.0,19,9,14,84.0,0.2727283239364624,0.10467885434627533
9962486,7676263,7870477,15468,12486,2010,12794,2011,2982,2674,1.0,0.0,40,5.0,269,2,203,770.0,0.21105487644672394,0.10602401196956635
9967704,5887249,5602734,15468,8482,1999,7712,1997,6986,7756,0.5,0.0,104,18.0,21,28,14,329.0,0.43167439103126526,0.33857449889183044
9964891,9519254,4483528,15468,14957,2016,3246,1984,511,12222,0.5,0.0,1,10.0,9,5,511,5684.0,0.6474047899246216,0.30593374371528625
9961946,7404752,6558135,15468,11898,2008,9987,2003,3570,5481,1.0,0.0,4,6.0,8,1,294,126.0,0.4737136662006378,0.10446463525295258
9964163,8235868,5067240,15468,13368,2012,5808,1991,2100,9660,1.0,0.0,2,11.0,11,2,1603,546.0,0.6801894903182983,0.30925506353378296
9962270,6280456,5645040,15468,9371,2001,7859,1997,6097,7609,1.0,0.0,238,13.0,12,5,42,581.0,0.630932629108429,0.20546433329582214
9964277,6373629,8471110,15468,9602,2002,13690,2013,5866,1778,0.0,0.0,16,4.0,7,8,287,966.0,0.37498095631599426,0.15249677002429962
9964963,7401622,4626578,15468,11891,2008,3988,1986,3577,11480,0.6666666666666666,0.0,5,2.0,6,17,693,10941.0,0.45088881254196167,0.10008338838815689
9967704,7280822,7658998,15468,11604,2007,12458,2010,3864,3010,0.5,0.0,124,6.0,5,16,14,259.0,0.5105394721031189,0.02522074617445469
9967704,7162256,8214071,15468,11331,2007,13333,2012,4137,2135,0.5,0.0,29,3.0,2,21,14,1302.0,0.35028693079948425,0.14641614258289337
9967772,8644412,5102209,15468,13914,2014,5941,1992,1554,9527,1.0,0.0,5,13.0,36,2,623,140.0,0.5649608969688416,0.15487819910049438
9962158,9204878,4340999,15468,14586,2015,2399,1982,882,13069,1.0,0.0,147,5.0,2129,1,21,4606.0,0.4716387689113617,0.3455624282360077
9966130,6600200,4792905,15468,10071,2003,4737,1988,5397,10731,0.5,0.0,110,10.0,5,7,14,5152.0,0.5044411420822144,0.18884669244289398
9962486,8119593,7838605,15468,13200,2012,12745,2010,2268,2723,0.5,0.0,44,2.0,13,14,21,2366.0,0.22933629155158997,0.16735528409481049
9971774,7603381,4894224,15475,12339,2009,5129,1990,3136,10346,0.5,0.0,78,10.0,8,2,7,784.0,0.24971860647201538,0.08758273720741272
9971752,7418656,9046145,15475,11926,2008,14397,2015,3549,1078,1.0,0.0,59,3.0,30,3,84,476.0,0.38896071910858154,0.15677782893180847
9972304,6490560,4130355,15475,9833,2002,1083,1978,5642,14392,1.0,0.0,116,5.0,6,1,0,980.0,0.5030255317687988,0.28588396310806274
9972304,6546388,9301048,15475,9959,2003,14698,2016,5516,777,0.0,0.5,352,1.0,4,1,0,777.0,0.3006744682788849,0.246968612074852
9969660,7214841,6906053,15475,11450,2007,10757,2005,4025,4718,0.3333333333333333,0.0,43,18.0,7,8,28,644.0,0.40878868103027344,0.027046646922826767
9973940,7199680,7201402,15475,11415,2007,11422,2007,4060,4053,0.3333333333333333,0.0,95,4.0,4,13,0,833.0,0.3484615683555603,0.14412599802017212
9972670,6475836,7156495,15475,9805,2002,11324,2007,5670,4151,0.3333333333333333,0.0,138,4.0,14,18,63,1855.0,0.32582083344459534,0.23242488503456116
9968354,7837080,6765760,15475,12745,2010,10428,2004,2730,5047,1.0,0.0,464,3.0,234,27,7,3437.0,0.5688017010688782,0.16372808814048767
9976365,7762343,7583484,15482,12626,2010,12297,2009,2856,3185,0.5,0.0,16,2.0,29,28,126,98.0,0.6893332600593567,0.2107677012681961
9977435,6056237,7969341,15482,8888,2000,12962,2011,6594,2520,0.16666666666666666,0.0,184,10.0,1,32,7,854.0,0.43827489018440247,0.08679354190826416
9980223,6811534,4166532,15482,10533,2004,1342,1979,4949,14140,0.3333333333333333,0.0,582,23.0,26,1,0,42.0,0.4291866421699524,0.15724773705005646
9975052,8332260,8810475,15482,13494,2012,14110,2014,1988,1372,0.3333333333333333,0.0,40,2.0,4,1,0,504.0,0.3398505449295044,0.23271521925926208
9975687,6646019,7995574,15482,10176,2003,13004,2011,5306,2478,0.125,0.0,74,8.0,19,9,21,490.0,0.1971815824508667,0.11889122426509857
9976691,8047479,6642850,15482,13088,2011,10169,2003,2394,5313,0.3333333333333333,0.0,4,4.0,8,3,308,3311.0,0.672893226146698,0.20684005320072174
9978780,8836878,4045542,15482,14138,2014,607,1977,1344,14875,1.0,0.0,1,4.0,15,2,1344,10388.0,1.0,0.2447977215051651
9974525,7912262,6334121,15482,12864,2011,9490,2001,2618,5992,0.0,0.0,2,15.0,12,10,56,56.0,0.5214989185333252,0.12504354119300842
9975742,7201366,4296164,15482,11422,2007,2119,1981,4060,13363,1.0,0.0,7,24.0,32,1,98,3339.0,0.6648934483528137,0.06218508630990982
9976718,6517914,4177478,15482,9903,2003,1433,1979,5579,14049,0.2,0.0,24,8.0,1,1,21,6741.0,0.42796242237091064,0.16998077929019928
9975854,6867210,5606881,15482,10666,2005,7733,1997,4816,7749,0.3333333333333333,0.0,28,6.0,22,5,84,1358.0,0.6622673273086548,0.20819328725337982
9975688,7249687,7446489,15482,11534,2007,11996,2008,3948,3486,0.25,0.0,4,4.0,32,3,581,357.0,0.532137930393219,0.19424302875995636
9980706,6142955,7607007,15489,9077,2000,12346,2009,6412,3143,0.5,0.0,296,6.0,222,15,35,56.0,0.3167537450790405,0.21703559160232544
9980721,5290308,7879152,15489,6634,1994,12815,2011,8855,2674,1.0,0.0,26,2.0,13,1,273,742.0,0.4425370991230011,0.23443736135959625
9983556,4635410,4881721,15489,4030,1987,5073,1989,11459,10416,0.0,0.0,18,8.0,7,4,77,238.0,0.33887726068496704,0.19574671983718872
9982994,7738113,5785251,15489,12584,2010,8244,1998,2905,7245,1.0,0.0,11,14.0,6,6,112,1890.0,0.47351622581481934,0.09641680121421814
9982070,5998537,4559092,15489,8741,1999,3638,1985,6748,11851,1.0,0.0,18,3.0,8,4,385,1785.0,0.33868637681007385,0.3212309777736664
9980600,8701548,9259967,15489,13991,2014,14656,2016,1498,833,1.0,0.0,4,1.0,5,31,315,833.0,0.5279484987258911,0.27278414368629456
9980480,6572748,6065962,15489,10015,2003,8909,2000,5474,6580,0.0,0.0,12,8.0,5,5,1239,1036.0,0.15039238333702087,0.2694271206855774
9980726,5553765,4594613,15489,7558,1996,3813,1986,7931,11676,1.0,0.0,758,44.0,8,6,0,301.0,0.6440507769584656,0.3528568744659424
9980878,5290254,4417448,15489,6634,1994,2889,1983,8855,12600,1.0,0.0,93,20.0,4,3,0,5425.0,0.30275461077690125,0.24763435125350952
9980713,7083626,4321980,15489,11170,2006,2280,1982,4319,13209,1.0,0.0,183,13.0,39,1,0,6489.0,0.4354870915412903,0.30050989985466003
9986419,6535610,5295605,15489,9938,2003,6655,1994,5551,8834,0.3333333333333333,0.0,82,6.0,19,3,14,1820.0,0.23550653457641602,0.09392532706260681
9988190,4861632,4761759,15496,4989,1989,4597,1988,10507,10899,1.0,0.0,112,22.0,10,2,63,455.0,0.3372350335121155,0.030461786314845085
9987012,7845538,8615293,15496,12759,2010,13872,2013,2737,1624,0.0,1.0,109,1.0,286,38,0,1624.0,0.4103500545024872,0.11861854791641235
9987004,8028884,5413908,15496,13060,2011,7068,1995,2436,8428,1.0,0.0,295,20.0,62,2,0,21.0,0.660042405128479,0.10559014230966568
9989129,4758208,4168652,15496,4583,1988,1363,1979,10913,14133,1.0,0.0,55,8.0,2,1,14,8799.0,0.544818103313446,0.13873226940631866
9988306,7086466,4947371,15496,11177,2006,5332,1990,4319,10164,0.3333333333333333,0.0,60,2.0,38,4,49,8883.0,0.4838617444038391,0.25829070806503296
9991395,7501293,4385067,15496,12122,2009,2700,1983,3374,12796,1.0,0.0,2680,3.0,2,1,0,1316.0,0.5745882391929626,0.08202572911977768
9986899,6582361,5654697,15496,10036,2003,7887,1997,5460,7609,1.0,0.0,25,7.0,9,10,0,6090.0,0.31327906250953674,0.05417169630527496
9989280,6595009,4284673,15496,10064,2003,2056,1981,5432,13440,1.0,0.0,12,17.0,9,5,182,4396.0,0.5421961545944214,0.33362847566604614
9991770,7064462,8533778,15496,11128,2006,13767,2013,4368,1729,0.2,0.0,29,4.0,24,8,35,126.0,0.40767329931259155,0.2395462691783905
9990565,6975326,6330735,15496,10939,2005,9483,2001,4557,6013,0.5,0.0,9,8.0,7,34,56,14.0,0.38835954666137695,0.24318575859069824
9988047,6266082,9283478,15496,9336,2001,14684,2016,6160,812,0.0,0.0,260,1.0,4,1,14,812.0,0.4282565414905548,-0.006462988443672657
9993349,6183517,9111424,15503,9168,2001,14474,2015,6335,1029,1.0,0.0,182,1.0,11,5,14,1029.0,0.39374208450317383,0.24392008781433105
9997251,6202124,4302212,15503,9203,2001,2154,1981,6300,13349,0.5,0.0,21,23.0,8,3,336,9198.0,0.6089000105857849,0.18375368416309357
9993350,8323345,7150641,15503,13487,2012,11310,2006,2016,4193,1.0,0.0,48,10.0,11,5,0,189.0,0.5288291573524475,0.29524824023246765
9998485,9043696,4052677,15503,14390,2015,642,1977,1113,14861,0.5,0.3333333333333333,54,5.0,164,1,0,5320.0,0.4738265872001648,0.08524245768785477
9997106,5278542,4844543,15503,6585,1994,4933,1989,8918,10570,1.0,0.0,156,26.0,8,1,21,574.0,0.592985987663269,0.30757036805152893
9993797,9353323,4174602,15503,14761,2016,1419,1979,742,14084,0.3333333333333333,0.0,4,17.0,3,3,70,7.0,0.705423891544342,0.16032324731349945
9995744,4595661,5034014,15503,3820,1986,5682,1991,11683,9821,0.5,0.0,68,15.0,8,2,161,1911.0,0.696002721786499,0.036555737257003784
9993239,9307972,9534682,15503,14712,2016,14978,2017,791,525,1.0,0.0,4,2.0,157,8,14,56.0,0.32914286851882935,0.1486860066652298
9998932,4558325,9301256,15503,3631,1985,14698,2016,11872,805,0.0,0.5,125,1.0,4,3,0,805.0,0.09948278218507767,0.3070743978023529
9997888,6853653,8276476,15503,10631,2005,13424,2012,4872,2079,0.5,0.0,31,2.0,57,16,7,28.0,0.5527814030647278,0.18995580077171326
9999045,8385322,7270970,15503,13571,2013,11583,2007,1932,3920,0.5,0.0,11,6.0,4,200,280,112.0,0.4179319441318512,0.16878782212734222
9994762,5996692,5269269,15503,8741,1999,6557,1993,6762,8946,0.0,0.0,36,21.0,20,3,42,1561.0,0.5552628636360168,0.19938844442367554
9993258,5209747,5351003,15503,6340,1993,6844,1994,9163,8659,1.0,0.0,889,36.0,4,4,0,455.0,0.48019760847091675,0.23041340708732605
9993207,6544174,4169862,15503,9959,2003,1370,1979,5544,14133,0.5,0.0,354,23.0,10,1,35,917.0,0.5899339318275452,0.0051574609242379665
10002189,6598039,4097889,15510,10064,2003,908,1978,5446,14602,1.0,0.0,187,9.0,40,3,21,2079.0,0.5989973545074463,0.16340641677379608
10003647,6578120,4854085,15510,10022,2003,4968,1989,5488,10542,0.5,0.0,73,19.0,20,1,91,196.0,0.48043498396873474,0.1451437771320343
10002174,7527558,5417949,15510,12178,2009,7082,1995,3332,8428,0.0,0.0,38,21.0,4,7,420,91.0,0.397438108921051,0.18766771256923676
10002250,8234693,4520512,15510,13361,2012,3442,1985,2149,12068,1.0,0.0,12,7.0,1,1,112,483.0,0.3374917209148407,0.14304238557815552
9999194,5773683,9501360,15510,8216,1998,14936,2016,7294,574,1.0,0.0,1432,1.0,1,46,7,574.0,0.6821708083152771,0.08438560366630554
10003938,9477208,5270707,15510,14908,2016,6557,1993,602,8953,0.3333333333333333,0.0,4,10.0,7,6,7,259.0,0.4461510479450226,0.2922271192073822
10003219,8909139,4882459,15510,14222,2014,5073,1989,1288,10437,0.3333333333333333,0.3333333333333333,13,5.0,4,5,7,3017.0,0.5216363072395325,0.12015848606824875
10003640,7054831,7076283,15510,11107,2006,11149,2006,4403,4361,0.25,0.0,117,4.0,19,26,63,7.0,0.20261871814727783,0.11295847594738007
9999678,8247546,5282395,15510,13382,2012,6606,1994,2128,8904,0.3333333333333333,0.0,1,12.0,5,4,2128,3451.0,0.2918148338794708,0.10087742656469345
10000695,8766295,8710531,15510,14061,2014,13998,2014,1449,1512,0.25,0.25,198,1.0,5,2,7,1512.0,0.07434111088514328,0.10957664251327515
10003315,7643588,5131967,15510,12423,2010,6046,1992,3087,9464,0.5,0.0,42,10.0,3,10,21,1218.0,0.15688645839691162,-0.04354531690478325
10007636,6704879,6996993,15517,10295,2004,11002,2006,5222,4515,0.25,0.0,66,2.0,22,11,63,3913.0,0.34093648195266724,0.17925293743610382
10004875,9339206,6258243,15517,14747,2016,9322,2001,770,6195,1.0,0.0,14,9.0,1004,48,7,196.0,0.40446725487709045,0.18485628068447113
10008886,9520725,5595029,15517,14957,2016,7691,1997,560,7826,0.5,0.0,76,11.0,1,7,0,357.0,0.7013294696807861,0.1296357810497284
10009094,6374124,5056578,15517,9602,2002,5766,1991,5915,9751,1.0,0.0,156,6.0,32,6,42,1015.0,0.41980746388435364,0.22158724069595337
10006148,5625814,7946784,15517,7789,1997,12927,2011,7728,2590,0.5,0.0,104,4.0,30,6,238,357.0,0.12232176214456558,0.04328853636980057
10005431,5311636,4437902,15517,6711,1994,3001,1984,8806,12516,1.0,0.0,38,16.0,1,3,133,987.0,0.6437628865242004,0.023204969242215157
10004462,7931370,4050655,15517,12899,2011,635,1977,2618,14882,0.5,0.0,14,18.0,5,1,70,406.0,0.4399704337120056,0.22496435046195984
10006272,5318131,5980081,15517,6732,1994,8713,1999,8785,6804,1.0,0.0,192,15.0,5,5,140,7.0,0.35542964935302734,0.15504135191440582
10009060,8089310,6165479,15517,13151,2012,9126,2000,2366,6391,0.5,0.0,2,20.0,5,4,1617,98.0,0.2780297100543976,0.017414111644029617
10004510,7156871,9328889,15517,11324,2007,14733,2016,4193,784,1.0,0.0,27,1.0,24,1,112,784.0,0.4555823802947998,0.09556395560503006
10004505,7549563,5577750,15517,12227,2009,7635,1996,3290,7882,0.5,0.0,426,14.0,26,8,0,1113.0,0.38142386078834534,0.28555265069007874
10004693,5409711,6788844,15517,7054,1995,10477,2004,8463,5040,1.0,0.0,67,6.0,4,10,140,3143.0,0.4545709788799286,0.012210770510137081
10015602,7580537,4546647,15524,12290,2009,3575,1985,3234,11949,1.0,0.0,33,10.0,22,5,112,2366.0,0.4542549252510071,0.16346266865730286
10013915,7903127,4879054,15524,12850,2011,5059,1989,2674,10465,0.5,0.0,30,18.0,9,1,21,994.0,0.5752514004707336,0.15546029806137085
10010339,5015227,5042625,15524,5612,1991,5717,1991,9912,9807,1.0,0.0,665,16.0,8,3,0,140.0,0.5394092202186584,0.1950843781232834
10012255,4479341,6924878,15524,3225,1984,10806,2005,12299,4718,0.0,0.0,53,6.0,1,33,28,266.0,0.44554319977760315,0.10172238945960999
10010046,9017947,4765672,15524,14362,2015,4618,1988,1162,10906,0.6666666666666666,0.0,273,19.0,44,3,7,1239.0,0.6188803911209106,0.07129395008087158
10013907,5880582,6336487,15524,8468,1999,9504,2002,7056,6020,0.0,0.0,121,6.0,9,5,0,581.0,0.3891054093837738,0.10957170277833939
10010276,8229533,5684182,15524,13354,2012,7978,1997,2170,7546,0.5,0.0,189,4.0,325,3,7,4865.0,0.22286872565746307,0.05643383041024208
10010790,5742233,7853731,15524,8146,1998,12766,2010,7378,2758,0.0,0.0,474,22.0,33,1,21,84.0,0.40410739183425903,0.23712565004825592
10010790,5733131,4865996,15524,8125,1998,5003,1989,7399,10521,0.25,0.0,156,11.0,8,3,21,3563.0,0.30976343154907227,0.13881909847259521
10012355,8220957,4592304,15524,13347,2012,3806,1986,2177,11718,1.0,0.0,3,7.0,127,2,763,5677.0,0.5825880169868469,0.09928195923566818
10019314,7710777,5645902,15531,12542,2010,7859,1997,2989,7672,0.5,0.0,35,9.0,17,4,0,525.0,0.5423735976219177,0.12089981138706207
10016283,8262666,5423959,15531,13403,2012,7103,1995,2128,8428,1.0,0.0,60,10.0,11,6,7,147.0,0.5295944809913635,0.13578276336193085
10021596,8897720,7834807,15531,14208,2014,12738,2010,1323,2793,1.0,0.0,3,6.0,1,4,371,315.0,0.49301889538764954,0.25325077772140503
10017174,8834317,4044458,15531,14138,2014,607,1977,1393,14924,0.5,0.0,4,2.0,6,1,7,3416.0,0.6493370532989502,0.2684333622455597
10016744,5046479,4069162,15531,5731,1991,747,1978,9800,14784,0.0,0.0,67,10.0,6,1,119,2163.0,0.25246426463127136,0.36811554431915283
10021523,8447234,7379191,15531,13655,2013,11835,2008,1876,3696,0.5,0.0,105,3.0,112,4,0,245.0,0.5861189365386963,0.13765734434127808
10016343,5419879,6345407,15531,7089,1995,9539,2002,8442,5992,0.5,0.0,25,6.0,10,7,91,854.0,0.3402754068374634,0.13582243025302887
10016994,8297739,4786251,15531,13452,2012,4709,1988,2079,10822,0.5,0.0,28,8.0,11,2,77,2569.0,0.32183873653411865,0.2383933663368225
10020321,6566720,7047073,15531,10001,2003,11093,2006,5530,4438,0.3333333333333333,0.0,98,5.0,2,4,119,98.0,0.35319021344184875,0.2926379144191742
10021062,7870204,4280817,15531,12794,2011,2035,1981,2737,13496,0.5,0.0,24,37.0,27,1,182,84.0,1.0,0.18242569267749786
10016585,6190352,9615244,15531,9182,2001,15069,2017,6349,462,1.0,0.0,108,1.0,10,5,42,462.0,0.4846327006816864,0.162681445479393
10026337,9087458,5315395,15538,14446,2015,6718,1994,1092,8820,0.5,0.0,7,5.0,2,1,77,5334.0,0.632012665271759,0.20222897827625275
10028081,7181252,5133999,15538,11373,2007,6053,1992,4165,9485,0.5,0.0,77,21.0,14,6,35,2282.0,0.5810286998748779,0.18112732470035553
10023101,7066632,5129134,15538,11135,2006,6039,1992,4403,9499,0.0,0.0,7,5.0,25,5,2471,1015.0,0.5105658173561096,0.25162744522094727
10022368,6491945,4987793,15538,9840,2002,5507,1991,5698,10031,1.0,0.0,75,9.0,8,8,7,161.0,0.632515549659729,0.21968446671962738
10026064,7334222,4861911,15538,11737,2008,4989,1989,3801,10549,1.0,0.0,54,3.0,17,1,7,6076.0,0.3614409863948822,0.010291777551174164
10022182,8080006,9173533,15538,13137,2011,14551,2015,2401,987,1.0,0.0,74,1.0,27,11,21,987.0,0.2265600711107254,0.16852638125419617
10023329,5186419,5682273,15538,6256,1993,7971,1997,9282,7567,1.0,0.0,19,38.0,6,27,21,98.0,0.508492112159729,0.1662166267633438
10026056,7316358,6257274,15538,11695,2008,9322,2001,3843,6216,1.0,0.0,19,2.0,37,4,35,2170.0,0.31382909417152405,0.2569420337677002
10022126,7556186,4522099,15538,12241,2009,3449,1985,3297,12089,1.0,0.0,544,7.0,182,1,7,161.0,0.46776261925697327,0.1981457769870758
10024310,4651435,6804281,15538,4100,1987,10512,2004,11438,5026,0.0,0.0,3,8.0,1,11,8589,1645.0,0.09262227267026901,0.07548931986093521
10026052,8694441,5350928,15538,13977,2014,6844,1994,1561,8694,1.0,0.0,3,3.0,17,4,161,5509.0,0.2947409749031067,0.2836410403251648
10024319,5004407,5937173,15538,5570,1991,8622,1999,9968,6916,0.25,0.0,30,12.0,3,3,119,805.0,0.46399903297424316,0.01826471835374832
10028799,4991764,6372655,15545,5521,1991,9602,2002,10024,5943,1.0,0.0,298,14.0,17,2,7,1470.0,0.589122474193573,0.08803974092006683
10028680,6088608,5224240,15545,8958,2000,6396,1993,6587,9149,1.0,0.0,927,23.0,14,5,7,49.0,0.44491490721702576,0.18983659148216248
10029895,5629674,6918583,15545,7803,1997,10792,2005,7742,4753,0.0,0.0,3,8.0,7,5,959,441.0,0.1782885193824768,0.20417837798595428
10031632,8049732,9629558,15545,13088,2011,15090,2017,2457,455,0.0,0.2,309,1.0,34,108,0,455.0,0.5215446352958679,0.4151017963886261
10029107,6221011,6190389,15545,9245,2001,9182,2001,6300,6363,0.5,0.5,408,24.0,15,11,7,91.0,0.4096035957336426,0.3998384475708008
10028781,5611796,7121130,15545,7747,1997,11247,2006,7798,4298,1.0,0.0,6,3.0,5,5,308,245.0,0.4414340853691101,0.15356944501399994
10030594,8447480,7873572,15545,13655,2013,12801,2011,1890,2744,0.25,0.0,18,9.0,10,65,28,350.0,0.5485079288482666,0.1990257203578949
10030961,8863621,6109153,15545,14173,2014,9007,2000,1372,6538,0.0,0.0,1,3.0,11,13,1372,5257.0,0.3038487434387207,0.4772329330444336
10034787,7303798,6749588,15552,11660,2007,10393,2004,3892,5159,0.3333333333333333,1.0,17,24.0,34,58,154,35.0,0.4614807665348053,0.208121657371521
10036163,5046294,4507080,15552,5731,1991,3372,1985,9821,12180,0.0,0.0,29,14.0,2,3,336,42.0,0.6392799019813538,0.32228121161460876
10038095,8796666,9737842,15552,14096,2014,15209,2017,1456,343,1.0,0.0,53,1.0,1,6,7,343.0,0.6561176776885986,0.2090708613395691
10035990,8343497,4064269,15552,13515,2013,719,1977,2037,14833,0.0,0.0,16,4.0,159,1,154,11872.0,0.5280599594116211,0.13109467923641205
10035282,6740279,8235909,15552,10372,2004,13368,2012,5180,2184,0.25,0.0,13,5.0,14,314,175,350.0,0.30618521571159363,0.06169382855296135
10036150,8469056,7337985,15552,13690,2013,11751,2008,1862,3801,1.0,0.0,9,10.0,536,18,91,301.0,0.43841901421546936,0.15946881473064423
10035029,6874596,5562740,15552,10687,2005,7586,1996,4865,7966,0.0,0.0,12,7.0,22,15,28,42.0,0.571800172328949,0.19725267589092255
10038346,7568127,9055554,15552,12262,2009,14404,2015,3290,1148,0.0,0.5,2,2.0,7,1,602,595.0,0.5349900722503662,0.2869299352169037
10045018,6717534,5541937,15559,10323,2004,7516,1996,5236,8043,0.5,0.5,54,8.0,3,9,14,980.0,0.49729281663894653,0.1870700716972351
10043393,5684473,5052873,15559,7978,1997,5752,1991,7581,9807,0.5,0.0,90,27.0,5,4,21,1554.0,0.5145286917686462,0.17112621665000916
10041005,4545892,7213539,15559,3568,1985,11450,2007,11991,4109,1.0,0.0,51,4.0,7,3,294,833.0,0.5135408043861389,0.10707046836614609
10043073,6741724,5368236,15559,10372,2004,6907,1994,5187,8652,0.3333333333333333,0.0,101,3.0,8,5,7,2758.0,0.4997461438179016,0.14059661328792572
10039545,5352238,4420051,15559,6851,1994,2903,1983,8708,12656,1.0,0.0,494,22.0,31,4,0,1386.0,0.48002156615257263,0.28597739338874817
10045288,6011980,4607644,15559,8769,2000,3890,1986,6790,11669,1.0,0.0,91,16.0,19,4,42,455.0,0.299642950296402,0.05108776316046715
10042512,5745112,5424129,15559,8153,1998,7103,1995,7406,8456,1.0,0.0,29,2.0,7,10,7,1162.0,0.47726452350616455,0.05716380849480629
10039636,6468660,4120604,15559,9791,2002,1020,1978,5768,14539,0.0,0.0,229,14.0,27,2,14,4998.0,0.2994951605796814,0.24771632254123688
10043779,9012263,8559270,15559,14355,2015,13802,2013,1204,1757,1.0,0.0,14,4.0,1,2,21,161.0,0.5050026774406433,0.12609326839447021
10044409,8264417,5579704,15559,13403,2012,7642,1996,2156,7917,0.0,0.0,131,14.0,16,1,14,77.0,0.393309623003006,0.2941157817840576
10044575,6658487,7738553,15559,10197,2003,12584,2010,5362,2975,0.5,0.5,35,2.0,5,64,28,1988.0,0.31971976161003113,0.4036834239959717
10040611,9889979,5143998,15559,15384,2018,6088,1992,175,9471,1.0,0.0,1,27.0,4,4,175,1764.0,0.8243453502655029,0.10887616872787476
10039531,6800090,5642656,15559,10505,2004,7852,1997,5054,7707,1.0,0.0,209,13.0,47,4,14,56.0,0.4682888984680176,0.2422511875629425
10042430,8112719,6771462,15559,13186,2012,10442,2004,2373,5117,1.0,0.0,30,9.0,1,44,56,588.0,0.4979330897331238,0.19284376502037048
10041440,8960156,4045561,15559,14299,2015,607,1977,1260,14952,0.5,0.0,1,5.0,5,1,1260,12285.0,0.6591073274612427,0.2085995376110077
10045640,5904256,7260447,15566,8538,1999,11555,2007,7028,4011,0.5,0.0,67,13.0,7,10,91,532.0,0.4382731318473816,0.28412365913391113
10045909,6985797,5403702,15566,10967,2006,7033,1995,4599,8533,0.3333333333333333,0.0,75,2.0,24,1,21,3367.0,0.3233828544616699,0.04355941712856293
10045715,5131103,6989675,15566,6046,1992,10981,2006,9520,4585,0.5,0.5,48,15.0,7,11,126,35.0,0.4919750690460205,0.17942379415035248
10049024,8958429,6613695,15566,14292,2015,10106,2003,1274,5460,0.0,0.0,1,21.0,9,20,1274,56.0,0.4601672887802124,0.06495291739702225
10046389,8813812,5392417,15566,14117,2014,6991,1995,1449,8575,0.16666666666666666,0.0,5,7.0,1,11,70,6720.0,0.6148560643196106,0.1944001317024231
10051754,6890203,4485058,15566,10722,2005,3253,1984,4844,12313,0.0,0.0,25,4.0,9,5,308,735.0,0.33839982748031616,0.19772231578826904
10049964,8237278,4550665,15566,13368,2012,3596,1985,2198,11970,1.0,0.0,8,4.0,18,1,217,4025.0,0.6815018057823181,0.28206247091293335
10057736,4862504,6177501,15573,4989,1989,9154,2001,10584,6419,0.0,0.0,128,4.0,1,6,7,2597.0,0.2406928986310959,0.10452008992433548
10052386,re42012,4167560,15573,12780,2010,1349,1979,2793,14224,1.0,1.0,16,19.0,16,1,140,84.0,0.5025520324707031,0.246692955493927
10052051,4647643,6506578,15573,4079,1987,9875,2003,11494,5698,0.3333333333333333,0.0,104,2.0,3,1,28,5474.0,0.41293638944625854,0.10311706364154816
10053987,6921014,7949063,15573,10799,2005,12927,2011,4774,2646,0.3333333333333333,0.0,46,2.0,9,1,56,2233.0,0.333151638507843,0.13680511713027954
10053808,7976111,5647708,15573,12976,2011,7866,1997,2597,7707,0.0,0.0,6,5.0,6,7,21,1799.0,0.5627596378326416,0.38302701711654663
10057724,7587276,6413690,15573,12304,2009,9679,2002,3269,5894,0.5,0.0,103,14.0,22,2,0,1421.0,0.3532896935939789,0.16672897338867188
10053467,6720343,7186261,15573,10330,2004,11387,2007,5243,4186,1.0,0.5,5,16.0,1,16,462,112.0,0.5275285840034485,0.15426930785179138
10053817,4464287,4950128,15573,3141,1984,5346,1990,12432,10227,0.0,0.0,7,3.0,1,5,1078,2002.0,0.47311317920684814,0.33244287967681885
10055853,6154559,5001167,15573,9098,2000,5556,1991,6475,10017,0.5,0.0,80,16.0,7,1,203,3850.0,0.4990677237510681,0.04293880611658096
10053239,7669799,5680793,15573,12479,2010,7971,1997,3094,7602,0.25,0.0,20,2.0,62,1,175,623.0,0.4882875382900238,0.255041241645813
10055249,9124639,7314423,15573,14488,2015,11688,2008,1085,3885,0.5,0.0,2,3.0,2,2,329,1932.0,0.6210229992866516,0.17614109814167023
10053158,7641234,4905494,15573,12423,2010,5178,1990,3150,10395,0.5,0.0,11,3.0,21,3,105,7399.0,0.5097277760505676,0.41913357377052307
10054481,7860663,4476830,15573,12780,2010,3211,1984,2793,12362,0.0,0.0,12,8.0,2,10,7,8211.0,0.7637938857078552,0.37741175293922424
10059564,7637355,9025021,15580,12416,2009,14369,2015,3164,1211,0.5,0.0,2,4.0,8,4,1085,364.0,0.5660892128944397,0.2862420976161957
10060280,5364543,8637800,15580,6893,1994,13907,2014,8687,1673,0.0,0.0,14,8.0,3,8,525,112.0,0.5619644522666931,0.07891424745321274
10063951,6370005,9596123,15580,9595,2002,15048,2017,5985,532,0.0,0.5,13,1.0,4,1,189,532.0,0.34072649478912354,0.1504472941160202
10060359,6367258,4751754,15580,9595,2002,4555,1988,5985,11025,0.0,0.0,74,5.0,8,3,14,7.0,0.3707493543624878,0.3314862847328186
10062834,8908422,9682371,15580,14222,2014,15146,2017,1358,434,1.0,0.0,1,1.0,5,7,1358,434.0,0.47768211364746094,0.22890885174274445
10058951,7867563,5302763,15580,12794,2011,6676,1994,2786,8904,0.0,0.0,7,7.0,4,9,1183,1323.0,0.3488507568836212,0.20672772824764252
10062570,7282782,8734205,15580,11611,2007,14026,2014,3969,1554,1.0,0.0,2820,2.0,7,11,0,147.0,0.6064716577529907,0.2983717918395996
10062709,6453454,9489547,15580,9756,2002,14922,2016,5824,658,0.5,0.5,37,1.0,3,4,70,658.0,0.4095032513141632,0.21869786083698273
10058370,5843075,4523454,15580,8370,1998,3456,1985,7210,12124,1.0,0.0,206,7.0,6,1,49,511.0,0.34291163086891174,0.0921141505241394
10064562,8418524,9676090,15587,13620,2013,15139,2017,1967,448,0.0,0.0,164,1.0,231,3,7,448.0,0.46800497174263,0.1383572369813919
10064621,5438302,6365213,15587,7152,1995,9588,2002,8435,5999,0.5,0.0,845,3.0,6,7,7,1015.0,0.23592157661914825,0.16024713218212128
10069773,6606596,7789124,15587,10085,2003,12668,2010,5502,2919,0.0,0.0,204,6.0,237,5,7,868.0,0.43407902121543884,0.24091178178787231
10065211,9818805,6852819,15587,15293,2017,10631,2005,294,4956,0.2,0.0,1,18.0,72,9,294,14.0,0.41015711426734924,0.24896477162837982
10065546,7229118,6150722,15587,11485,2007,9091,2000,4102,6496,1.0,0.0,81,18.0,13,3,14,588.0,0.599259614944458,0.16901199519634247
10068221,9264151,7934447,15587,14656,2016,12906,2011,931,2681,0.6666666666666666,0.0,10,18.0,17,21,49,168.0,0.42313188314437866,0.17727147042751312
10067829,8281227,6424886,15587,13424,2012,9700,2002,2163,5887,0.0,0.0,32,8.0,113,5,196,259.0,0.4434064030647278,0.14017342031002045
10070810,7379765,4513858,15594,11835,2008,3407,1985,3759,12187,0.3333333333333333,0.0,437,6.0,75,4,21,203.0,0.21271485090255737,0.26512330770492554
10075282,8711878,7188700,15594,13998,2014,11394,2007,1596,4200,1.0,0.0,5,3.0,15,6,721,1141.0,0.3049592077732086,0.10160664469003677
10071872,5246180,4167309,15594,6473,1993,1349,1979,9121,14245,0.3333333333333333,0.0,12,6.0,3,1,168,7770.0,0.26293879747390747,0.2095942497253418
10072510,8777793,4677080,15594,14075,2014,4198,1987,1519,11396,0.0,0.0,5,7.0,14,1,238,7056.0,0.5664896368980408,0.07653437554836273
10071575,8698949,4183816,15594,13984,2014,1475,1980,1610,14119,0.0,0.0,204,4.0,17,1,7,2940.0,0.2630014419555664,0.03013237752020359
10071452,5824333,5455835,15594,8328,1998,7215,1995,7266,8379,0.3333333333333333,0.0,275,13.0,9,15,0,1995.0,0.23316319286823273,0.11362674087285995
10073591,8943036,4703855,15594,14271,2015,4324,1987,1323,11270,0.3333333333333333,0.0,9,10.0,9,5,98,1064.0,0.3409566879272461,0.17427679896354675
10071138,5837533,5249273,15594,8356,1998,6480,1993,7238,9114,0.25,0.0,76,4.0,5,9,70,1239.0,0.18943393230438232,0.05911782756447792
10071676,8405726,7730318,15594,13599,2013,12570,2010,1995,3024,0.25,0.25,57,3.0,138,16,7,1106.0,0.49540725350379944,0.2636878192424774
10073871,7882120,6918491,15594,12815,2011,10792,2005,2779,4802,1.0,0.0,1,2.0,4,4,2779,1120.0,0.504936933517456,0.06339503079652786
10070861,8647258,6315082,15594,13921,2014,9448,2001,1673,6146,1.0,0.0,306,11.0,6,8,7,63.0,0.4671647548675537,0.21536363661289215
10076330,7591828,4431024,15601,12318,2009,2966,1984,3283,12635,1.0,0.0,16,14.0,6,1,217,1176.0,0.29721441864967346,0.1581907421350479
10076139,4938236,8265039,15601,5297,1990,13403,2012,10304,2198,0.3333333333333333,0.0,57,12.0,9,3,7,371.0,0.3699420392513275,0.26787158846855164
10077965,9354018,5619841,15601,14761,2016,7775,1997,840,7826,1.0,0.0,3,10.0,2,5,406,3220.0,0.5967140793800354,0.18398667871952057
10079515,8770482,7961000,15601,14068,2014,12948,2011,1533,2653,0.0,0.0,98,6.0,15,9,7,35.0,0.3505692780017853,0.2818765342235565
10076210,6786353,9497771,15601,10477,2004,14929,2016,5124,672,0.0,0.0,9,1.0,13,1,112,672.0,0.4411056935787201,0.1583499312400818
10080473,6840972,7445441,15608,10603,2005,11996,2008,5005,3612,0.0,0.0,41,3.0,2,5,301,112.0,0.42028486728668213,0.12913651764392853
10080649,5895422,9273666,15608,8510,1999,14670,2016,7098,938,1.0,0.0,64,1.0,31,13,0,938.0,0.408491313457489,0.012588875368237495
10083420,6508706,4767475,15608,9882,2003,4625,1988,5726,10983,0.0,0.0,92,9.0,4,1,154,5138.0,0.3216991722583771,-0.08008900284767151
10080428,7395110,5602734,15608,11870,2008,7712,1997,3738,7896,0.3333333333333333,0.0,3,18.0,16,28,1820,469.0,0.3827207684516907,0.1935432404279709
10080647,5197983,6081233,15608,6298,1993,8944,2000,9310,6664,1.0,0.0,64,5.0,29,4,21,301.0,0.5605300664901733,0.19300563633441925
10083046,8499299,4366962,15608,13725,2013,2560,1983,1883,13048,1.0,0.0,19,6.0,13,1,21,3563.0,0.7380121946334839,0.1361064612865448
10080754,7495002,6788105,15608,12108,2009,10477,2004,3500,5131,0.5,0.0,86,14.0,29,4,7,1323.0,0.3966762125492096,0.06618710607290268
10083690,7058888,5354745,15608,11114,2006,6858,1994,4494,8750,0.5,0.0,76,10.0,8,6,0,4256.0,0.2989521324634552,0.06687332689762115
10082937,8255793,4907435,15608,13389,2012,5185,1990,2219,10423,0.5,0.0,17,4.0,6,5,385,1253.0,0.3704819083213806,0.19376271963119507
10080618,4435120,4625962,15608,2987,1984,3988,1986,12621,11620,0.0,0.0,10,26.0,2,7,1134,21.0,0.4888240694999695,0.3745992183685303
10081030,5833145,4962291,15608,8349,1998,5395,1990,7259,10213,1.0,0.0,6,13.0,11,5,1218,945.0,0.37543344497680664,0.31839340925216675
10085753,5466241,9028247,15615,7257,1995,14376,2015,8358,1239,1.0,0.0,179,1.0,7,8,112,1239.0,0.36076977849006653,0.17399358749389648
10085792,5449370,6762363,15615,7194,1995,10421,2004,8421,5194,0.3333333333333333,0.3333333333333333,542,5.0,11,10,0,1064.0,0.3908699154853821,0.23607289791107178
10085441,5911728,4274234,15615,8566,1999,2000,1981,7049,13615,0.5,0.0,18,21.0,7,3,525,623.0,0.5153504610061646,0.28516125679016113
10091787,5873324,4109249,15615,8454,1999,964,1978,7161,14651,0.0,0.0,178,5.0,7,1,0,6426.0,0.2204001247882843,0.412830650806427
10087621,6928777,5439394,15615,10820,2005,7159,1995,4795,8456,1.0,0.0,33,11.0,12,3,0,2366.0,0.42090651392936707,0.24333083629608154
10086080,5523078,4394114,15615,7460,1996,2756,1983,8155,12859,0.5,0.0,75,2.0,12,1,70,5922.0,0.40114787220954895,0.2078372836112976
10085523,8471658,4380355,15615,13690,2013,2665,1983,1925,12950,0.0,0.25,8,15.0,61,2,28,343.0,0.2530553936958313,0.3405188024044037
10085799,8480663,4507155,15615,13704,2013,3372,1985,1911,12243,1.0,0.0,88,16.0,22,3,14,2219.0,0.3078291416168213,0.023973092436790466
10087984,8615775,7302965,15615,13872,2013,11660,2007,1743,3955,0.0,1.0,1,2.0,1,5,1743,3052.0,0.23647454380989075,0.2784585654735565
10085796,6949097,5100632,15615,10862,2005,5934,1992,4753,9681,1.0,0.0,214,17.0,3,3,7,112.0,0.5774856209754944,0.2365172803401947
10088431,5164995,4974735,15615,6165,1992,5451,1990,9450,10164,0.0,0.0,45,50.0,5,10,294,504.0,0.4297323524951935,0.24889878928661346
10092953,7958940,4452554,15622,12948,2011,3078,1984,2674,12544,0.0,0.0,48,17.0,8,2,91,224.0,0.20339582860469818,0.17843879759311676
10092082,6719467,7975892,15622,10330,2004,12976,2011,5292,2646,0.3333333333333333,0.0,36,3.0,18,3,63,371.0,0.22014330327510834,0.07365306466817856
10093026,8793882,5445299,15622,14096,2014,7180,1995,1526,8442,0.5,0.0,6,18.0,4,6,21,98.0,0.7614918947219849,0.40001583099365234
10097880,7784078,8333263,15622,12654,2010,13501,2012,2968,2121,0.3333333333333333,0.0,18,3.0,3,3,371,1029.0,0.4047509729862213,0.0688587948679924
10092065,6922917,7325519,15622,10806,2005,11723,2008,4816,3899,1.0,0.0,150,6.0,6,2,0,63.0,0.47037017345428467,0.2658948004245758
10096096,4576175,4014313,15622,3729,1986,453,1977,11893,15169,0.3333333333333333,0.0,41,16.0,9,1,140,497.0,0.3161197602748871,0.29281893372535706
10095521,7079147,4304190,15622,11156,2006,2168,1981,4466,13454,1.0,0.0,13,2.0,12,3,7,6853.0,0.504379391670227,0.04142720252275467
10098585,6306100,9161449,15629,9427,2001,14530,2015,6202,1099,1.0,0.0,178,3.0,38,1,7,651.0,0.690021812915802,0.26195648312568665
10102359,6957076,4146421,15629,10883,2005,1181,1979,4746,14448,0.3333333333333333,0.0,152,6.0,9,1,0,1428.0,0.33908239006996155,0.14548763632774353
10102883,6193339,4019519,15629,9189,2001,481,1977,6440,15148,0.0,0.0,84,20.0,4,1,378,189.0,0.5447409749031067,0.1650618314743042
10098642,5908402,9674054,15629,8552,1999,15132,2017,7077,497,1.0,0.0,378,1.0,15,2,0,497.0,0.2333996593952179,0.2020639032125473
10102394,6308274,4417448,15629,9427,2001,2889,1983,6202,12740,0.5,0.0,200,20.0,29,3,91,5565.0,0.3929511308670044,0.23838303983211517
10098733,5423886,5392502,15629,7103,1995,6998,1995,8526,8631,1.0,0.0,101,18.0,1,8,49,63.0,0.33653098344802856,0.23987853527069092
10102979,6174623,7997930,15629,9147,2001,13011,2011,6482,2618,1.0,1.0,41,13.0,4,9,1211,14.0,0.3589734733104706,0.21370582282543182
10100501,6658934,4170408,15629,10204,2003,1377,1979,5425,14252,0.0,0.0,16,8.0,5,1,70,4480.0,0.40244215726852417,0.3582717180252075
10105141,6475104,4377376,15636,9805,2002,2637,1983,5831,12999,0.0,0.0,70,9.0,11,4,7,427.0,0.13295342028141022,0.24385462701320648
10109174,6700533,4037313,15636,10288,2004,572,1977,5348,15064,0.25,0.0,191,3.0,8,1,42,13076.0,0.3402343988418579,0.05841818079352379
10104968,5950263,8356286,15636,8657,1999,13529,2013,6979,2107,1.0,0.0,11,4.0,7,48,287,1169.0,0.474703311920166,0.11590643227100372
10108676,8185558,4680517,15636,13291,2012,4212,1987,2345,11424,1.0,0.0,143,4.0,1,7,7,2555.0,0.4473358392715454,0.23794548213481903
10108612,5920327,9813541,15636,8587,1999,15286,2017,7049,350,0.3333333333333333,0.3333333333333333,99,1.0,10,71,7,350.0,0.28970298171043396,0.2507583200931549
10105374,6239120,4331365,15636,9280,2001,2336,1982,6356,13300,0.5,0.0,13,9.0,4,6,49,238.0,0.37925228476524353,0.13962383568286896
10105697,7917313,5794679,15636,12871,2011,8265,1998,2765,7371,0.5,0.0,8,14.0,4,12,322,49.0,0.4966700077056885,0.1430932581424713
10106986,7946084,5597487,15636,12927,2011,7698,1997,2709,7938,0.5,0.0,6,35.0,16,15,119,378.0,0.5306124687194824,0.21237751841545105
10105592,4608525,4469825,15636,3890,1986,3169,1984,11746,12467,0.0,0.0,19,11.0,6,1,14,91.0,0.34879064559936523,0.14104150235652924
10105141,6997931,7436501,15636,11002,2006,11975,2008,4634,3661,1.0,0.0,873,6.0,26,1,0,322.0,0.4018402397632599,0.06270110607147217
10111810,6419906,5144462,15643,9693,2002,6088,1992,5950,9555,0.3333333333333333,0.0,100,13.0,10,7,14,1491.0,0.36615681648254395,0.24815627932548523
10112779,6848569,8708734,15643,10624,2005,13998,2014,5019,1645,1.0,0.0,8,6.0,8,9,168,686.0,0.5183879137039185,0.194782555103302
10111608,7715893,6866792,15643,12549,2010,10666,2005,3094,4977,0.5,0.0,352,7.0,280,28,7,1407.0,0.4259752631187439,0.14627385139465332
10116089,8900006,6823117,15643,14215,2014,10554,2004,1428,5089,0.5,0.0,3,16.0,21,22,476,315.0,0.35322606563568115,0.1326611191034317
10112425,7234645,5794679,15643,11499,2007,8265,1998,4144,7378,0.5,0.0,210,14.0,3,12,63,56.0,0.24104052782058716,0.1737077832221985
10115078,6345260,4785333,15643,9532,2002,4702,1988,6111,10941,1.0,0.0,107,1.0,12,2,21,10941.0,0.5286118388175964,0.19437478482723236
10116583,7617222,5538756,15643,12367,2009,7509,1996,3276,8134,0.5,0.0,143,10.0,35,5,7,1365.0,0.3553226888179779,0.07231860607862473
10115400,9633660,7500610,15643,15090,2017,12122,2009,553,3521,0.3333333333333333,0.0,21,15.0,2065,136,7,203.0,0.593334972858429,0.41056153178215027
10117307,6340864,8578089,15643,9518,2002,13823,2013,6125,1820,1.0,0.0,129,4.0,12,1,21,952.0,0.5841354131698608,0.2517194449901581
10112897,8993627,4126992,15643,14334,2015,1062,1978,1309,14581,0.3333333333333333,0.0,2,4.0,9,3,553,4907.0,0.6978110074996948,0.023976679891347885
10120420,7728923,4785333,15650,12570,2010,4702,1988,3080,10948,0.0,0.0,54,1.0,1,2,70,10948.0,0.22541265189647675,0.1229800134897232
10119090,8492321,4150327,15650,13718,2013,1202,1979,1932,14448,1.0,0.0,1,10.0,6,3,1932,4753.0,0.38285696506500244,0.2012074887752533
10119134,6268152,5392502,15650,9343,2001,6998,1995,6307,8652,0.3333333333333333,0.0,60,18.0,19,8,70,84.0,0.3835414946079254,0.09269460290670395
10119124,7585657,6848950,15650,12304,2009,10624,2005,3346,5026,1.0,0.0,8,14.0,6,61,77,28.0,0.6202335357666016,0.1021229550242424
10119324,5551499,5994188,15650,7551,1996,8734,1999,8099,6916,0.5,0.0,8,19.0,2,11,504,294.0,0.44623124599456787,0.250488817691803
10117667,7972329,7861267,15650,12969,2011,12780,2010,2681,2870,1.0,0.0,67,3.0,35,3,14,1176.0,0.15210309624671936,0.16218255460262299
10118146,4676886,6322007,15650,4198,1987,9462,2001,11452,6188,0.5,0.0,12,2.0,3,5,175,749.0,0.4881551265716553,0.3569659888744354
10117650,6398797,5740895,15650,9651,2002,8146,1998,5999,7504,1.0,0.0,664,9.0,48,14,0,553.0,0.2733171880245209,0.40305396914482117
10119634,7140396,6157804,15650,11289,2006,9105,2000,4361,6545,0.3333333333333333,0.0,2,11.0,17,9,2352,1162.0,0.5128122568130493,0.23750776052474976
10127816,5491800,4633581,15657,7348,1996,4023,1987,8309,11634,0.25,0.0,376,4.0,18,4,28,3234.0,0.12980735301971436,0.21399781107902527
10127220,7634732,4912928,15657,12402,2009,5206,1990,3255,10451,0.5,0.0,63,15.0,11,4,21,637.0,0.3837948441505432,0.0907488763332367
10124125,4195730,4072198,15657,1552,1980,768,1978,14105,14889,0.0,0.0,50,4.0,1,1,28,5096.0,0.44692671298980713,0.25142014026641846
10123802,6607539,5895360,15657,10092,2003,8510,1999,5565,7147,1.0,1.0,54,37.0,69,22,70,21.0,0.5067946910858154,0.26043587923049927
10127872,5896117,5062357,15657,8510,1999,5787,1991,7147,9870,0.3333333333333333,0.0,52,6.0,2,2,21,7329.0,0.5795885324478149,0.18822744488716125
10127220,6141644,4328641,15657,9070,2000,2322,1982,6587,13335,0.5,0.0,113,11.0,7,3,21,77.0,0.34718000888824463,0.23626336455345154
10128678,6362598,6843829,15657,9581,2002,10610,2005,6076,5047,1.0,0.0,85,8.0,1,14,49,364.0,0.5389580130577087,0.010381054133176804
10125927,7325956,6917247,15657,11723,2008,10785,2005,3934,4872,0.5,0.0,78,6.0,10,11,252,2541.0,0.4676571488380432,0.07392407953739166
10123920,5411497,4674343,15657,7061,1995,4191,1987,8596,11466,1.0,0.0,119,10.0,32,2,7,1603.0,0.7424762845039368,0.16652263700962067
10125052,7932492,4466940,15657,12899,2011,3155,1984,2758,12502,0.2,0.0,12,11.0,1,1,259,3500.0,0.3020133674144745,0.06770908832550049
10128001,4495478,9405725,15657,3309,1985,14824,2016,12348,833,0.0,0.3333333333333333,26,3.0,1,14,35,252.0,0.2695908546447754,0.37568533420562744
10124967,6952977,4533707,15657,10876,2005,3505,1985,4781,12152,0.5,0.0,4,5.0,4,8,651,3325.0,0.40888532996177673,0.24689851701259613
10125388,5922604,8558770,15657,8594,1999,13802,2013,7063,1855,0.3333333333333333,0.0,148,2.0,5,8,14,1008.0,0.4628538191318512,0.21068979799747467
10129207,7058973,8119056,15657,11114,2006,13200,2012,4543,2457,0.0,0.0,67,2.0,2,19,21,532.0,0.5328415036201477,0.21762806177139282
10127220,8179370,5700564,15657,13284,2012,8027,1997,2373,7630,0.3333333333333333,0.0,82,19.0,10,71,21,3717.0,0.45276954770088196,0.04461105912923813
10129518,7423821,4264182,15657,11940,2008,1944,1981,3717,13713,0.3333333333333333,0.0,97,10.0,2,1,7,2800.0,0.2815283536911011,0.31176722049713135
10134247,8868803,5794582,15664,14173,2014,8265,1998,1491,7399,0.0,0.0,177,21.0,214,7,0,427.0,0.2715573310852051,0.07102908939123154
10132031,9469738,5552035,15664,14901,2016,7551,1996,763,8113,0.2,0.0,1,10.0,15,18,763,217.0,0.7893771529197693,0.40671011805534363
10130762,5891128,5260459,15664,8496,1999,6522,1993,7168,9142,1.0,0.0,105,4.0,11,3,0,476.0,0.3199436664581299,0.09655023366212845
10134233,6764397,4510937,15664,10428,2004,3393,1985,5236,12271,0.0,0.0,243,5.0,19,3,7,6384.0,0.5523955225944519,0.25045251846313477
10130176,7238751,7321847,15664,11506,2007,11709,2008,4158,3955,0.0,0.0,58,10.0,106,3,119,70.0,0.16634078323841095,-0.02137731947004795
10130527,4773905,4699701,15664,4653,1988,4303,1987,11011,11361,0.5,0.0,81,3.0,2,4,0,8820.0,0.2524626553058624,0.16714860498905182
10134539,7391555,6297070,15664,11863,2008,9406,2001,3801,6258,0.0,0.5,103,25.0,174,33,7,693.0,0.3580494821071625,0.10130234807729721
10130366,5713128,5943764,15664,8069,1998,8643,1999,7595,7021,0.0,0.0,367,5.0,10,41,0,3395.0,0.3421913981437683,0.1767078936100006
10131279,5818625,6371125,15664,8314,1998,9602,2002,7350,6062,0.0,0.0,295,5.0,6,5,7,511.0,0.4632328748703003,0.24134868383407593
10135533,6850510,5227242,15664,10624,2005,6403,1993,5040,9261,1.0,0.0,165,39.0,6,24,7,553.0,0.3398291766643524,0.1218043714761734
10137018,5653743,3994638,15671,7887,1997,334,1976,7784,15337,1.0,0.0,362,6.0,13,1,14,203.0,0.4612894654273987,0.327511727809906
10137843,6891563,4132003,15671,10722,2005,1097,1979,4949,14574,0.5,0.0,311,6.0,69,4,7,8232.0,0.5599988102912903,0.037214308977127075
10139561,4114980,6725196,15671,992,1978,10337,2004,14679,5334,1.0,0.0,34,6.0,4,10,406,1064.0,0.5362406373023987,0.18953625857830048
10141463,7985919,4518762,15671,12990,2011,3428,1985,2681,12243,0.5,0.0,14,3.0,12,1,91,6636.0,0.6142916679382324,-0.02140611596405506
10138076,5132897,7484073,15671,6046,1992,12080,2009,9625,3591,0.0,0.0,49,6.0,3,2,0,763.0,0.2095804363489151,0.19329619407653809
10142560,9733486,7603548,15671,15202,2017,12339,2009,469,3332,0.5,0.6666666666666666,9,22.0,233,226,14,14.0,0.6758439540863037,0.13030950725078583
10136819,5368224,9252800,15671,6907,1994,14642,2016,8764,1029,0.3333333333333333,0.0,435,2.0,7,4,14,595.0,0.20604512095451355,0.19291886687278748
10147480,8042082,5279609,15678,13074,2011,6592,1994,2604,9086,0.0,0.0,121,36.0,6,6,0,651.0,0.42952027916908264,0.08879616856575012
10149092,7280822,6214747,15678,11604,2007,9231,2001,4074,6447,0.5,0.0,131,8.0,5,3,91,2933.0,0.5105432868003845,0.09840412437915802
10146548,5509130,5118700,15678,7411,1996,5997,1992,8267,9681,1.0,0.0,69,2.0,5,1,7,9233.0,0.3512551486492157,0.04139017313718796
10145090,8402984,4282748,15678,13599,2013,2049,1981,2079,13629,0.0,0.0,3,4.0,8,6,791,133.0,0.45689788460731506,0.14997904002666473
10148016,7355560,8525264,15678,11786,2008,13760,2013,3892,1918,0.5,0.5,158,3.0,5,5,0,616.0,0.35104116797447205,0.2720177173614502
10143409,6212416,4152576,15678,9224,2001,1216,1979,6454,14462,0.3333333333333333,0.0,747,2.0,38,2,7,5152.0,0.38859766721725464,0.18526817858219147
10145251,6203025,6826938,15678,9210,2001,10568,2004,6468,5110,0.0,0.0,24,1.0,1,9,35,5110.0,0.3953137695789337,0.31836551427841187
10143757,6248334,5430090,15678,9301,2001,7124,1995,6377,8554,0.3333333333333333,0.0,25,3.0,7,4,350,4788.0,0.5298219323158264,0.1559274047613144
10148774,8918839,5471383,15678,14236,2014,7271,1995,1442,8407,0.3333333333333333,0.3333333333333333,6,4.0,469,8,133,56.0,0.5268110632896423,0.3422623574733734
10145107,4536997,5146781,15678,3526,1985,6102,1992,12152,9576,0.14285714285714285,0.0,8,3.0,1,3,1386,4396.0,0.47509127855300903,0.4844611883163452
10149679,7963432,9721435,15685,12955,2011,15188,2017,2730,497,1.0,0.0,416,2.0,267,77,7,378.0,0.5552056431770325,0.18269595503807068
10150546,8944866,8514085,15685,14278,2015,13746,2013,1407,1939,0.5,0.0,11,9.0,42,21,0,196.0,0.4381517767906189,0.227812722325325
10149679,7252660,7687277,15685,11541,2007,12507,2010,4144,3178,1.0,0.0,474,3.0,11,18,14,196.0,0.622789740562439,0.24089542031288147
10149683,5350400,7411651,15685,6844,1994,11912,2008,8841,3773,0.5,0.0,698,5.0,3,3,0,798.0,0.28950434923171997,0.18849723041057587
10149537,9004274,6523276,15685,14348,2015,9917,2003,1337,5768,0.3333333333333333,0.0,1,6.0,18,5,1337,329.0,0.7102835774421692,0.17905330657958984
10149761,8579966,4736989,15685,13830,2013,4485,1988,1855,11200,1.0,0.0,54,9.0,283,2,7,8435.0,0.5971784591674805,0.30597826838493347
10149680,7591818,9850225,15685,12318,2009,15335,2017,3367,350,1.0,0.5,161,2.0,5,2,0,7.0,0.27686429023742676,0.18621604144573212
10149549,7841031,4667865,15685,12752,2010,4163,1987,2933,11522,0.5,0.0,35,11.0,35,2,63,6104.0,0.3624054789543152,0.09314464777708054
10149680,8287561,5556240,15685,13438,2012,7565,1996,2247,8120,1.0,0.0,320,23.0,12,3,0,28.0,0.3878641724586487,0.3003665804862976
10154500,9391824,7872916,15685,14803,2016,12801,2011,882,2884,1.0,0.0,26,1.0,8,1,28,2884.0,0.6215615272521973,0.11162491142749786
10152423,8443150,7925075,15685,13648,2013,12885,2011,2037,2800,1.0,1.0,2,2.0,19,30,1260,1575.0,0.4682563543319702,0.2231595814228058
10149683,5693051,7988044,15685,8006,1997,12997,2011,7679,2688,0.5,0.5,838,2.0,30,29,0,1785.0,0.3951546251773834,0.22793196141719818
10154837,7083638,5142556,15692,11170,2006,6081,1992,4522,9611,1.0,0.0,275,9.0,49,3,14,2709.0,0.3596183955669403,0.14534960687160492
10155368,7122445,9136782,15692,11247,2006,14502,2015,4445,1190,0.0,0.0,94,2.0,29,5,35,581.0,0.35863617062568665,0.30653849244117737
10157155,7761720,5538938,15692,12619,2010,7509,1996,3073,8183,1.0,0.0,4,5.0,11,3,847,1064.0,0.619807779788971,0.2170426994562149
10154777,6131386,6680853,15692,9056,2000,10246,2004,6636,5446,0.0,0.0,39,2.0,12,12,42,91.0,0.18785029649734497,0.3247319161891937
10157179,9606987,6478807,15692,15062,2017,9812,2002,630,5880,1.0,0.0,1,15.0,21,21,630,42.0,0.642600953578949,0.2992192506790161
10158105,6500581,5223406,15692,9861,2002,6389,1993,5831,9303,0.5,0.0,18,6.0,2,1,56,567.0,0.6325185298919678,0.0004816353612113744
10155785,8106022,9855369,15692,13179,2012,15342,2018,2513,350,0.0,0.1111111111111111,46,1.0,4,31,7,350.0,0.3111519515514374,0.23983068764209747
10155071,6345623,6450374,15692,9539,2002,9756,2002,6153,5936,1.0,0.0,731,3.0,2,5,0,1967.0,0.3164844512939453,0.37058889865875244
10154871,7276063,4389304,15692,11597,2007,2728,1983,4095,12964,1.0,0.0,155,19.0,223,6,49,2751.0,0.2580752372741699,0.21355433762073517
10160639,9187317,9858923,15699,14565,2015,15342,2018,1134,357,0.5,0.0,19,1.0,2,10,28,357.0,0.6820061206817627,0.17871958017349243
10161669,5586680,9684218,15699,7663,1996,15146,2017,8036,553,0.0,0.0,22,1.0,3,12,63,553.0,0.4291571378707886,0.08482305705547333
10165059,5835376,5653139,15699,8349,1998,7887,1997,7350,7812,0.0,0.0,75,6.0,23,1,14,378.0,0.4419947564601898,0.2762477695941925
10159888,9502018,7393509,15699,14936,2016,11870,2008,763,3829,0.16666666666666666,0.0,5,3.0,64,2,280,532.0,0.410734623670578,8.201413584174588e-05
10161197,7210409,4620273,15699,11443,2007,3953,1986,4256,11746,0.0,0.0,8,14.0,10,6,56,2625.0,0.31578344106674194,0.2704842686653137
10166104,6887488,5041000,15706,10715,2005,5710,1991,4991,9996,0.5,0.0,19,8.0,3,5,91,819.0,0.5716300010681152,0.11997164040803909
10166357,7018362,5801377,15706,11044,2006,8279,1998,4662,7427,1.0,0.0,121,3.0,94,2,35,2310.0,0.3169911801815033,0.14214448630809784
10167061,4933917,6952789,15706,5276,1990,10869,2005,10430,4837,0.0,0.0,4,10.0,3,5,357,1036.0,0.5120039582252502,0.04168230667710304
10169301,5157737,7379547,15706,6137,1992,11835,2008,9569,3871,1.0,0.0,88,4.0,61,14,42,2240.0,0.5598354935646057,0.37507307529449463
10166664,5813109,4696066,15706,8307,1998,4289,1987,7399,11417,0.25,0.0,11,30.0,10,4,2051,154.0,0.5036256313323975,0.3654766082763672
10170904,5412526,4583374,15706,7061,1995,3764,1986,8645,11942,0.5,0.0,63,3.0,4,5,42,476.0,0.5272942781448364,0.35988330841064453
10171995,5283904,4156845,15706,6606,1994,1244,1979,9100,14462,0.0,0.0,271,7.0,15,1,0,1463.0,0.18319042026996613,0.2014465481042862
10166197,6045829,4361313,15706,8860,2000,2525,1982,6846,13181,1.0,0.0,115,6.0,6,2,224,6503.0,0.5301286578178406,0.0982130765914917
10166014,4056854,8276458,15706,677,1977,13424,2012,15029,2282,1.0,0.0,729,5.0,1,17,7,126.0,0.3707782030105591,0.07333051413297653
10170108,9129094,5523637,15706,14495,2015,7460,1996,1211,8246,0.4,0.0,2,30.0,9,10,119,63.0,0.4599452018737793,0.1027565523982048
10168934,6212635,6716666,15706,9224,2001,10323,2004,6482,5383,0.5,0.0,267,5.0,18,6,147,2737.0,0.4958287477493286,0.2529515027999878
10165950,5181521,7217078,15706,6235,1993,11457,2007,9471,4249,0.25,0.0,31,8.0,14,11,1449,35.0,0.4697772264480591,0.24016545712947845
10166167,7435889,8610012,15706,11975,2008,13865,2013,3731,1841,0.0,0.0,16,1.0,31,6,126,1841.0,0.2468457967042923,0.30495381355285645
10167417,7645397,4382160,15706,12430,2010,2679,1983,3276,13027,0.25,0.0,62,11.0,66,1,7,8099.0,0.28695839643478394,0.2482771873474121
10168418,7280674,7875094,15706,11604,2007,12808,2011,4102,2898,0.0,0.0,4,2.0,13,11,343,336.0,0.4608088433742523,0.15027685463428497
10167447,6504079,6358596,15706,9868,2003,9574,2002,5838,6132,0.25,0.0,48,16.0,37,37,105,623.0,0.3203374445438385,0.1231764405965805
10169771,8400299,5213056,15706,13592,2013,6354,1993,2114,9352,0.0,0.0,19,8.0,4,8,7,4949.0,0.3869711458683014,0.3093796670436859
10173132,6109939,8992689,15713,9007,2000,14334,2015,6706,1379,0.0,0.0,53,1.0,8,41,259,1379.0,0.16327999532222748,0.05460149049758911
10173702,7518489,4687027,15713,12157,2009,4247,1987,3556,11466,0.0,0.0,19,3.0,39,6,35,3500.0,0.40068578720092773,0.15927305817604065
10176666,7909699,5075429,15713,12864,2011,5836,1991,2849,9877,0.0,0.0,38,2.0,57,5,42,4459.0,0.38782674074172974,0.010447371751070023
10172620,7799965,4254784,15713,12682,2010,1895,1981,3031,13818,1.0,0.0,265,8.0,16,4,0,3948.0,0.13372738659381866,0.2912687063217163
10172616,8967443,6703464,15713,14306,2015,10295,2004,1407,5418,1.0,0.0,300,7.0,96,13,7,1757.0,0.4315539598464966,0.1459394246339798
10176521,8628015,5295120,15713,13893,2014,6648,1994,1820,9065,1.0,0.0,239,10.0,277,7,14,2254.0,0.2304241955280304,0.059746358543634415
10182319,6060995,6775107,15720,8895,2000,10449,2004,6825,5271,0.0,0.0,50,5.0,16,6,588,4151.0,0.282151997089386,0.29525479674339294
10179360,7117708,7512487,15720,11240,2006,12143,2009,4480,3577,0.5,0.0,9,21.0,10,13,63,28.0,0.604083240032196,0.03132603317499161
10181042,6523079,4146032,15720,9910,2003,1181,1979,5810,14539,1.0,0.0,78,16.0,50,2,0,2030.0,0.41911470890045166,0.1734614372253418
10180125,8192161,6501766,15720,13305,2012,9861,2002,2415,5859,1.0,0.0,7,4.0,24,11,294,2744.0,0.5840581059455872,0.1560083031654358
10182010,7102998,4178382,15720,11205,2006,1440,1979,4515,14280,0.5,0.0,15,4.0,11,2,28,6034.0,0.2701931893825531,0.15326330065727234
10179022,5520704,3987870,15720,7453,1996,299,1976,8267,15421,1.0,0.0,64,7.0,17,1,7,42.0,0.25120264291763306,0.2579161822795868
10182210,8611594,4324464,15720,13865,2013,2294,1982,1855,13426,0.0,0.0,2,3.0,1,1,0,7343.0,0.3813023269176483,0.30463463068008423
10180929,7392249,4384671,15720,11863,2008,2700,1983,3857,13020,1.0,0.0,74,7.0,67,3,329,658.0,0.3020460307598114,0.1417919248342514
10179051,6344059,4436255,15720,9532,2002,2994,1984,6188,12726,1.0,0.0,166,15.0,11,3,105,5859.0,0.6740165948867798,0.22295674681663513
10179305,5378253,9047790,15720,6942,1995,14397,2015,8778,1323,0.3333333333333333,0.0,10,1.0,14,22,224,1323.0,0.5460954904556274,0.17740409076213837
10179219,8636010,4939062,15720,13907,2014,5297,1990,1813,10423,0.5,0.0,5,2.0,224,2,119,8617.0,0.5269891619682312,0.0380825512111187
10182927,5476508,5471383,15727,7292,1995,7271,1995,8435,8456,1.0,0.0,157,4.0,10,8,189,105.0,0.6561300158500671,0.21778592467308044
10184928,7117161,5187718,15727,11233,2006,6256,1993,4494,9471,0.0,0.3333333333333333,24,7.0,26,4,161,2457.0,0.29731306433677673,0.3668048083782196
10185542,7177798,5353588,15727,11366,2007,6858,1994,4361,8869,1.0,0.0,228,16.0,68,4,14,1750.0,0.36694249510765076,0.19801582396030426
10184784,8217377,8984423,15727,13340,2012,14320,2015,2387,1407,1.0,0.0,1,2.0,3,4,2387,301.0,0.6751113533973694,0.2621784806251526
10182930,5938696,9533530,15727,8629,1999,14978,2017,7098,749,1.0,0.0,251,1.0,102,15,91,749.0,0.4352560043334961,0.3923499882221222
10186254,6222347,4693156,15727,9245,2001,4275,1987,6482,11452,0.0,0.0,126,16.0,15,7,0,1183.0,0.15694193542003632,0.06715080142021179
10184897,8774270,5826692,15727,14068,2014,8335,1998,1659,7392,0.0,0.3333333333333333,2,9.0,3,10,273,2751.0,0.29847240447998047,0.3207291066646576
10184519,6971802,9680924,15727,10932,2005,15139,2017,4795,588,0.3333333333333333,0.0,22,2.0,8,10,42,70.0,0.7282164692878723,0.19690261781215668
10184706,5996369,4583782,15727,8741,1999,3764,1986,6986,11963,1.0,0.0,7,15.0,5,1,1043,315.0,0.6270752549171448,0.11720988154411316
10185995,6131087,7272646,15727,9049,2000,11583,2007,6678,4144,1.0,0.5,555,26.0,23,10,0,7.0,0.3393721282482147,0.31499290466308594
10184489,5107755,9121330,15727,5962,1992,14488,2015,9765,1239,0.3333333333333333,0.0,16,1.0,1,3,189,1239.0,0.4271714389324188,0.29824331402778625
10188095,4802552,6339069,15734,4786,1989,9511,2002,10948,6223,0.0,0.0,33,9.0,15,3,147,70.0,0.6905333995819092,-0.09985631704330444
10188550,7468057,7796366,15734,12045,2008,12675,2010,3689,3059,1.0,0.0,20,5.0,46,4,119,637.0,0.3698468804359436,0.06602155417203903
10191746,7877582,6454990,15734,12808,2011,9763,2002,2926,5971,1.0,0.0,43,2.0,39,2,28,1323.0,0.3709886372089386,0.18759891390800476
10189728,6136201,6755759,15734,9063,2000,10407,2004,6671,5327,0.5,0.0,77,12.0,10,15,0,119.0,0.35216274857521057,0.10096215456724167
10188387,5246450,7837235,15734,6473,1993,12745,2010,9261,2989,1.0,0.0,147,17.0,12,20,28,63.0,0.30136093497276306,0.3578791618347168
10190965,7439062,8095748,15734,11982,2008,13158,2012,3752,2576,0.3333333333333333,0.0,19,4.0,16,67,308,623.0,0.2713029384613037,0.2699883282184601
10193329,5495627,7422041,15734,7369,1996,11940,2008,8365,3794,0.0,0.0,30,6.0,6,9,77,182.0,0.35492950677871704,0.3078598976135254
10188394,4331277,5342062,15734,2336,1982,6816,1994,13398,8918,0.5,0.0,778,13.0,6,3,0,63.0,0.552981436252594,0.19819940626621246
10188890,5857939,4535877,15734,8412,1999,3519,1985,7322,12215,1.0,0.0,158,19.0,11,3,28,161.0,0.42087095975875854,0.2810790240764618
10190213,7143897,4104415,15734,11296,2006,943,1978,4438,14791,0.0,0.0,55,6.0,6,1,14,12691.0,0.07489947229623795,0.21017204225063324
10192063,8707459,4753557,15734,13991,2014,4562,1988,1743,11172,0.6666666666666666,0.0,17,3.0,23,6,35,2492.0,0.21381495893001556,0.11139027774333954
10190362,4793397,6566095,15734,4744,1988,10001,2003,10990,5733,0.0,0.0,24,5.0,2,9,21,63.0,0.5164057612419128,0.03318265080451965
10189599,5564599,6344235,15734,7593,1996,9532,2002,8141,6202,1.0,0.0,103,2.0,7,3,14,658.0,0.5333139896392822,0.19180895388126373
10189445,8272096,5012622,15734,13417,2012,5605,1991,2317,10129,1.0,0.0,13,18.0,1,4,28,119.0,0.7272939085960388,0.19175897538661957
10192277,7298964,6746219,15734,11646,2007,10386,2004,4088,5348,0.5,0.0,11,5.0,8,3,28,728.0,0.4270513653755188,0.09958037734031677
10193429,5610463,4439598,15734,7740,1997,3008,1984,7994,12726,1.0,0.0,22,6.0,3,4,392,5726.0,0.22582605481147766,0.02304363064467907
10194848,9717425,9223900,15741,15188,2017,14607,2015,553,1134,1.0,0.0,18,1.0,599,19,0,1134.0,0.5674074292182922,0.18444040417671204
10198619,7694555,7652845,15741,12521,2010,12444,2010,3220,3297,0.0,0.0,34,6.0,3,21,7,805.0,0.2496711015701294,0.1985512524843216
10197335,6875293,8700821,15741,10687,2005,13984,2014,5054,1757,0.25,0.0,47,2.0,15,27,196,966.0,0.3155171573162079,0.23289062082767487
10195020,9610155,4843945,15741,15069,2017,4933,1989,672,10808,1.0,0.0,1,33.0,335,5,672,70.0,0.8216993808746338,0.17726507782936096
10194848,8718737,7219972,15741,14005,2014,11464,2007,1736,4277,1.0,0.0,132,3.0,374,9,0,1421.0,0.39942190051078796,0.21366770565509796
10195419,5741321,8516644,15741,8146,1998,13753,2013,7595,1988,1.0,0.0,69,2.0,5,3,133,112.0,0.5107433199882507,0.1667439043521881
10194910,6492785,5597487,15741,9840,2002,7698,1997,5901,8043,0.0,0.0,484,35.0,20,15,7,483.0,0.2022843062877655,0.15301910042762756
10200083,8179947,4602362,15741,13284,2012,3855,1986,2457,11886,1.0,0.5,1,3.0,8,2,2457,11319.0,0.7400227785110474,0.4445062279701233
10197081,5934486,6629517,15741,8622,1999,10141,2003,7119,5600,0.5,0.0,21,4.0,11,10,7,2975.0,0.3200416564941406,0.2734089493751526
10194976,8764747,4889310,15741,14061,2014,5108,1989,1680,10633,0.5,0.0,44,11.0,192,13,0,147.0,0.6380693912506104,0.22005023062229156
10195621,6561767,5577942,15741,9994,2003,7635,1996,5747,8106,0.25,0.0,34,38.0,4,1,161,56.0,0.39577674865722656,0.2091134637594223
10196208,4934507,5993226,15741,5283,1990,8734,1999,10458,7007,1.0,0.0,10,8.0,4,2,21,1085.0,0.6208347678184509,0.12512749433517456
10195333,6386202,7252696,15741,9630,2002,11541,2007,6111,4200,1.0,0.0,33,7.0,6,5,140,1463.0,0.5306826233863831,0.2538479268550873
10198610,8095328,6427144,15741,13158,2012,9707,2002,2583,6034,0.5,0.5,12,2.0,3,13,77,2737.0,0.2883419096469879,0.2766394019126892
10201134,8984807,4277907,15748,14327,2015,2021,1981,1421,13727,1.0,1.0,4,30.0,8,1,140,441.0,0.4471224546432495,0.13346506655216217
10203300,7226734,4732818,15748,11478,2007,4464,1988,4270,11284,0.6666666666666666,0.0,131,2.0,193,17,70,1834.0,0.2672187089920044,0.04032140225172043
10201349,8317074,9821455,15748,13480,2012,15300,2017,2268,448,0.5,0.0,369,1.0,155,3,7,448.0,0.33804741501808167,0.28700071573257446
10206113,8326682,4389304,15748,13487,2012,2728,1983,2261,13020,0.0,0.0,40,19.0,18,6,0,2807.0,0.2653418183326721,0.03915399685502052
10205161,5871863,4015208,15748,8447,1999,453,1977,7301,15295,1.0,0.0,48,25.0,5,1,91,4522.0,0.7083352208137512,0.27108311653137207
10209535,6142625,5577134,15755,9077,2000,7628,1996,6678,8127,1.0,0.0,75,13.0,9,6,7,1687.0,0.3432186245918274,0.24521833658218384
10206507,4725095,5149075,15755,4429,1988,6109,1992,11326,9646,0.5,0.0,40,28.0,7,7,336,700.0,0.6386643052101135,0.28789812326431274
10211586,4127227,5981682,15755,1062,1978,8713,1999,14693,7042,0.0,0.0,166,4.0,1,6,0,154.0,0.32902342081069946,0.25915032625198364
10210041,9158621,7498791,15755,14530,2015,12115,2009,1225,3640,1.0,0.0,1,13.0,5,8,1225,609.0,0.6297441124916077,0.25102877616882324
10207710,4454789,7002612,15755,3092,1984,11009,2006,12663,4746,0.6666666666666666,0.0,8,3.0,1,3,301,1561.0,0.5693073272705078,0.1941908597946167
10212055,5282127,4784333,15755,6599,1994,4702,1988,9156,11053,0.5,0.0,194,22.0,7,1,35,3367.0,0.5037911534309387,0.1663544923067093
10206744,5567471,4699063,15755,7600,1996,4303,1987,8155,11452,0.0,0.0,19,10.0,9,1,469,910.0,0.4978790581226349,0.1522156447172165
10207870,4505630,4157325,15755,3365,1985,1251,1979,12390,14504,0.0,0.0,30,24.0,1,5,119,511.0,0.43211162090301514,0.13257890939712524
10208095,4632761,6437782,15755,4016,1986,9728,2002,11739,6027,0.25,0.0,109,3.0,3,3,28,119.0,0.2420714646577835,0.06836425513029099
10211586,9492146,4826788,15755,14929,2016,4870,1989,826,10885,0.5,0.0,23,27.0,249,4,0,273.0,0.43347519636154175,0.15578694641590118
10211586,6010520,8832868,15755,8769,2000,14138,2014,6986,1617,0.5,0.0,109,2.0,4,12,0,189.0,0.21887846291065216,0.19293862581253052
10206540,5363755,4891978,15755,6893,1994,5122,1990,8862,10633,0.0,0.0,26,4.0,4,2,84,6580.0,0.5838525295257568,0.40814468264579773
10207164,5265883,5333291,15755,6543,1993,6781,1994,9212,8974,1.0,0.0,2,11.0,5,5,5782,6489.0,0.4510153830051422,0.026591641828417778
10206676,4747820,5076406,15755,4534,1988,5843,1991,11221,9912,1.0,0.0,368,11.0,4,6,0,1834.0,0.46652334928512573,0.4296647310256958
10216927,8528086,6303881,15762,13760,2013,9420,2001,2002,6342,1.0,0.0,153,10.0,61,27,7,161.0,0.3636980354785919,0.2526158094406128
10217817,6759730,7509544,15762,10414,2004,12136,2009,5348,3626,1.0,0.0,19,3.0,22,7,0,490.0,0.5611566305160522,0.13679490983486176
10218848,5826269,7888823,15762,8328,1998,12829,2011,7434,2933,0.5,0.0,357,3.0,7,6,14,42.0,0.5342011451721191,0.35273343324661255
10213204,5632432,6200427,15762,7817,1997,9203,2001,7945,6559,1.0,0.0,1157,3.0,73,4,0,6139.0,0.4240013360977173,0.3706820607185364
10216410,6278384,4186635,15762,9364,2001,1496,1980,6398,14266,1.0,0.0,14,3.0,8,2,63,12957.0,0.4674164056777954,0.43104442954063416
10214583,9745363,8649048,15762,15216,2017,13921,2014,546,1841,0.6666666666666666,0.0,2,2.0,1,1,189,1484.0,0.34615451097488403,0.07022031396627426
10219110,8788680,4266282,15762,14082,2014,1951,1981,1680,13811,0.5,0.0,46,18.0,9,3,14,196.0,0.45029765367507935,0.18438641726970673
10217838,5426328,6962726,15762,7110,1995,10904,2005,8652,4858,1.0,0.0,120,4.0,15,6,0,1946.0,0.5573984384536743,0.32756567001342773
10223684,7260557,4716810,15769,11555,2007,4387,1988,4214,11382,0.5,0.0,25,26.0,66,4,14,490.0,0.36410924792289734,0.17372146248817444
10222892,7932893,8002606,15769,12899,2011,13018,2011,2870,2751,0.5,0.0,30,2.0,20,38,0,980.0,0.42989829182624817,0.2809097170829773
10224566,7045990,4462056,15769,11093,2006,3127,1984,4676,12642,0.25,0.0,12,22.0,2,3,259,5516.0,0.5659552216529846,0.2466527819633484
10221770,6663530,6167047,15769,10211,2003,9126,2000,5558,6643,0.0,0.0,31,17.0,20,8,119,1379.0,0.44642549753189087,0.1527472585439682
10224460,6392340,6102421,15769,9637,2002,8993,2000,6132,6776,0.2,0.0,152,42.0,11,24,0,469.0,0.4508693218231201,0.19491878151893616
10221637,7559357,3979550,15769,12248,2009,250,1976,3521,15519,0.5,0.0,52,20.0,1,1,147,4221.0,0.18463096022605896,0.2966424524784088
10219857,5893847,5644885,15769,8503,1999,7859,1997,7266,7910,1.0,0.0,132,11.0,24,1,42,1190.0,0.22693125903606415,-0.03262580931186676
10220456,5361659,4885615,15769,6886,1994,5087,1989,8883,10682,0.5,0.0,11,6.0,9,3,140,5873.0,0.5608713030815125,0.27656832337379456
10219742,5375603,4761273,15769,6935,1994,4597,1988,8834,11172,1.0,1.0,28,3.0,2,9,49,21.0,0.4031418263912201,0.1824517399072647
10219880,4970032,7424244,15769,5430,1990,11940,2008,10339,3829,0.5,0.0,33,7.0,1,10,168,294.0,0.5329394340515137,0.2279232293367386
10225025,8903214,4632640,15769,14215,2014,4016,1986,1554,11753,0.0,0.0,167,26.0,22,5,0,5971.0,0.23853851854801178,0.2317574918270111
10225588,7689510,7481832,15769,12507,2010,12080,2009,3262,3689,0.0,0.0,200,8.0,296,20,0,14.0,0.41331249475479126,0.09734949469566345
10225816,8666388,5754889,15769,13942,2014,8174,1998,1827,7595,0.5,0.0,57,3.0,6,17,21,3311.0,0.604163646697998,0.09265211224555969
10222510,8691351,5657634,15769,13977,2014,7901,1997,1792,7868,0.16666666666666666,0.0,2,11.0,1,1,434,665.0,0.6785481572151184,0.16329489648342133
10220209,8886326,4971742,15769,14194,2014,5437,1990,1575,10332,1.0,0.0,37,5.0,113,9,0,21.0,0.814568042755127,0.29367595911026
10225377,6769129,6897462,15769,10435,2004,10736,2005,5334,5033,0.5,0.0,5,10.0,5,5,896,343.0,0.3971680998802185,0.21061483025550842
10229988,4823172,4721003,15776,4856,1989,4408,1988,10920,11368,1.0,0.0,73,9.0,5,1,7,791.0,0.5762243866920471,0.32815131545066833
10227832,4892337,5045545,15776,5122,1990,5724,1991,10654,10052,0.5,0.0,130,8.0,7,2,336,3122.0,0.27303460240364075,-0.04446708410978317
10229697,7254420,7286639,15776,11541,2007,11618,2007,4235,4158,0.5,0.0,14,4.0,8,30,245,861.0,0.3599318861961365,0.24929781258106232
10226576,8315683,5642232,15776,13473,2012,7845,1997,2303,7931,1.0,0.0,211,4.0,179,18,0,4774.0,0.44533059000968933,0.09642055630683899
10228007,8763332,9571132,15776,14061,2014,15020,2017,1715,756,1.0,0.0,2,1.0,23,1,322,756.0,0.6191580891609192,0.12455318868160248
10226345,5162626,6556519,15776,6158,1992,9980,2003,9618,5796,0.0,0.0,27,4.0,5,12,70,4032.0,0.25458675622940063,0.28822216391563416
10226335,8784478,4680665,15776,14082,2014,4212,1987,1694,11564,1.0,0.0,34,9.0,274,7,56,707.0,0.45891904830932617,0.13801206648349762
10229230,6751219,4296164,15776,10393,2004,2119,1981,5383,13657,0.0,0.0,61,24.0,18,1,14,3633.0,0.29641982913017273,-0.024710683152079582
10228556,7805034,4492345,15776,12689,2010,3295,1985,3087,12481,0.3333333333333333,0.0,88,4.0,4,1,126,9247.0,0.353204607963562,0.11042943596839905
10226339,5403305,4933854,15776,7033,1995,5276,1990,8743,10500,1.0,0.0,84,9.0,19,10,0,1953.0,0.4741932451725006,-0.023097004741430283
10227357,7476746,5353310,15776,12066,2009,6851,1994,3710,8925,0.5,0.0,27,24.0,20,3,42,2100.0,0.3085539638996124,0.04549052566289902
10226187,6014346,7648170,15776,8776,2000,12437,2010,7000,3339,0.25,0.0,123,4.0,13,10,7,28.0,0.5818132162094116,0.14099907875061035
10226266,5944728,8809212,15776,8643,1999,14110,2014,7133,1666,0.3333333333333333,0.0,199,1.0,61,2,7,1666.0,0.43254804611206055,-0.012380918487906456
10226190,6714814,4447644,15776,10316,2004,3050,1984,5460,12726,1.0,0.0,38,4.0,8,2,112,10437.0,0.474282443523407,0.09900374710559845
10234934,6940062,4785901,15783,10841,2005,4709,1988,4942,11074,0.0,0.0,9,17.0,5,2,21,105.0,0.41314253211021423,0.2464066594839096
10231643,6377857,9259834,15783,9609,2002,14656,2016,6174,1127,0.5,0.0,42,3.0,17,46,77,406.0,0.3920976221561432,0.1511821746826172
10237146,6928280,5324847,15783,10813,2005,6753,1994,4970,9030,0.5,0.0,257,2.0,22,4,42,7287.0,0.34517839550971985,0.03631863743066788
10232567,4768725,7769992,15783,4632,1988,12633,2010,11151,3150,0.0,0.0,6,5.0,1,35,700,560.0,0.40955424308776855,0.10217121243476868
10236731,4620120,5397820,15783,3953,1986,7012,1995,11830,8771,0.3333333333333333,0.0,10,2.0,4,7,1715,6846.0,0.4703070819377899,0.19854465126991272
10233814,8123159,5548532,15783,13207,2012,7537,1996,2576,8246,0.0,0.0,2,55.0,4,10,721,119.0,0.5133156180381775,0.23268504440784454
10241572,6972734,4006637,15790,10932,2005,404,1977,4858,15386,0.0,0.3333333333333333,82,22.0,10,1,14,224.0,0.24058088660240173,0.11860142648220062
10241560,7437586,6898725,15790,11975,2008,10736,2005,3815,5054,1.0,0.5,5,3.0,10,10,980,3836.0,0.6042240858078003,0.35580912232398987
10238821,7793660,4772657,15790,12675,2010,4646,1988,3115,11144,1.0,0.0,14,16.0,36,6,336,126.0,0.33674779534339905,0.2430035024881363
10240412,7909170,5260459,15790,12864,2011,6522,1993,2926,9268,0.0,0.0,2,4.0,13,3,1421,602.0,0.24117405712604523,0.09197647124528885
10238427,5480437,4959703,15790,7306,1996,5381,1990,8484,10409,1.0,0.0,38,11.0,4,8,231,3773.0,0.2377270609140396,0.3425421714782715
10239400,8167356,5227787,15790,13270,2012,6403,1993,2520,9387,1.0,0.0,3,11.0,34,3,812,6370.0,0.8852143287658691,0.24966181814670563
10240602,5489166,4648055,15790,7341,1996,4079,1987,8449,11711,0.0,0.0,15,34.0,4,10,700,413.0,0.28822004795074463,0.2890198528766632
10239147,4484059,4729641,15790,3246,1984,4450,1988,12544,11340,1.0,0.0,41,38.0,4,3,35,1764.0,0.5186827182769775,0.15575210750102997
10240935,5286054,8939524,15790,6620,1994,14271,2015,9170,1519,0.0,0.0,38,5.0,13,9,140,28.0,0.296540230512619,0.18376316130161285
10238391,9186137,4411008,15790,14565,2015,2847,1983,1225,12943,0.5,0.0,20,20.0,6,10,0,287.0,0.39684373140335083,0.1855102777481079
10238306,6884221,4136383,15790,10708,2005,1118,1979,5082,14672,0.5,0.0,6,17.0,12,2,616,1897.0,0.40703102946281433,0.14256949722766876
10238861,8489189,7088649,15790,13711,2013,11177,2006,2079,4613,0.5,0.0,20,2.0,27,11,35,2898.0,0.45952707529067993,0.2536059319972992
10242040,6925472,4285601,15790,10806,2005,2063,1981,4984,13727,0.5,0.0,33,9.0,10,1,0,4788.0,0.47705352306365967,0.14261439442634583
10238390,9615826,8255872,15790,15076,2017,13389,2012,714,2401,1.0,0.0,35,3.0,2306,8,0,1484.0,0.6866697072982788,0.11399233341217041
10241343,6184856,9353598,15790,9168,2001,14761,2016,6622,1029,0.5,0.0,330,3.0,23,47,28,126.0,0.33156877756118774,0.17814940214157104
10238427,8968406,7849487,15790,14306,2015,12759,2010,1484,3031,1.0,0.0,25,12.0,35,8,14,98.0,0.5625171065330505,0.18562638759613037
10243270,8907222,4585967,15790,14222,2014,3771,1986,1568,12019,0.5,0.0,170,18.0,4,2,21,35.0,0.2921457886695862,0.2841191291809082
10248308,5793360,7193550,15797,8258,1998,11401,2007,7539,4396,0.0,0.0,116,3.0,13,1,0,1134.0,0.38263633847236633,0.34751763939857483
10249109,8040247,7732098,15797,13074,2011,12577,2010,2723,3220,0.0,0.0,57,6.0,6,14,0,749.0,0.33894333243370056,0.03348283842206001
10245013,6402765,4250104,15797,9658,2002,1867,1981,6139,13930,1.0,0.0,144,6.0,6,1,49,9212.0,0.33677536249160767,0.1370191127061844
10245035,6488196,5907586,15797,9833,2002,8545,1999,5964,7252,1.0,0.0,791,14.0,8,9,0,1120.0,0.600659966468811,0.18054606020450592
10248414,8756651,5383425,15797,14047,2014,6963,1995,1750,8834,0.5,0.0,10,11.0,5,3,70,294.0,0.2655734717845917,0.20596221089363098
10247338,4408943,9845332,15797,2840,1983,15328,2017,12957,469,0.2,0.0,41,1.0,3,35,175,469.0,0.2535237669944763,0.06064934656023979
10245030,10010322,5099232,15797,15524,2018,5927,1992,273,9870,1.0,0.0,27,22.0,2313,1,0,49.0,0.5011297464370728,0.11881068348884583
10250931,6574793,4812518,15797,10015,2003,4821,1989,5782,10976,0.5,0.0,159,32.0,17,3,91,917.0,0.268704354763031,0.12658561766147614
10249756,5923184,5371529,15797,8594,1999,6914,1994,7203,8883,0.0,0.0,22,24.0,2,11,98,1526.0,0.5146386027336121,0.039369259029626846
10245567,5005364,8731440,15797,5577,1991,14019,2014,10220,1778,0.0,0.0,36,2.0,12,5,406,322.0,0.5375423431396484,0.3004682660102844
10245433,8892209,4778671,15797,14201,2014,4674,1988,1596,11123,1.0,0.0,47,48.0,114,3,7,7.0,0.7709414958953857,0.09672635048627853
10244922,6139491,6242890,15797,9070,2000,9287,2001,6727,6510,0.5,0.0,13,17.0,7,7,714,588.0,0.5081647038459778,0.11275629699230194
10245029,5797637,5865564,15797,8272,1998,8433,1999,7525,7364,0.0,0.0,30,27.0,6,11,0,42.0,0.4156741499900818,0.24763168394565582
10247235,6394657,4590464,15797,9644,2002,3792,1986,6153,12005,1.0,0.0,10,3.0,5,9,28,3374.0,0.718384325504303,0.1804322749376297
10252027,6955657,4621732,15804,10883,2005,3967,1986,4921,11837,0.5,0.0,101,17.0,29,2,49,133.0,0.5645785331726074,0.16010712087154388
10254745,5557537,8259083,15804,7565,1996,13396,2012,8239,2408,0.0,0.0,46,3.0,11,3,126,1309.0,0.4439152479171753,-0.014494150876998901
10251392,5695777,9505473,15804,8013,1997,14943,2016,7791,861,0.5,0.0,34,1.0,19,3,35,861.0,0.2878631055355072,0.14367033541202545
10253510,5641110,7465610,15804,7845,1997,12038,2008,7959,3766,0.5,0.0,5,2.0,6,4,623,2744.0,0.5548284649848938,0.09050040692090988
10256405,9202693,4658379,15804,14579,2015,4121,1987,1225,11683,0.5,0.0,2,12.0,3,1,651,1897.0,0.5979676842689514,0.3886026442050934
10253555,6820385,5023806,15804,10554,2004,5640,1991,5250,10164,0.5,0.0,6,28.0,44,11,1806,1708.0,0.3762614130973816,0.11147855222225189
10251637,5356413,6035988,15804,6865,1994,8839,2000,8939,6965,1.0,0.0,344,8.0,4,4,7,273.0,0.4773778021335602,0.23005813360214233
10258333,5782859,4423019,15811,8237,1998,2917,1983,7574,12894,1.0,0.0,702,3.0,23,3,0,3234.0,0.573881983757019,0.07532060891389847
10258330,5312023,6574153,15811,6711,1994,10015,2003,9100,5796,1.0,0.0,1281,3.0,41,4,7,2324.0,0.4535878598690033,0.25105345249176025
10258203,5839368,4523454,15811,8363,1998,3456,1985,7448,12355,0.0,0.0,7,7.0,3,1,1519,742.0,0.3982168436050415,0.19889065623283386
10258336,5628745,4867810,15811,7803,1997,5010,1989,8008,10801,1.0,0.0,456,4.0,11,2,0,1428.0,0.21160537004470825,0.2777078151702881
10259194,4454183,4201734,15811,3085,1984,1587,1980,12726,14224,0.0,0.0,108,4.0,2,2,70,6888.0,0.14724589884281158,0.15844160318374634
10261069,8306766,8001141,15811,13459,2012,13011,2011,2352,2800,0.3333333333333333,0.0,5,8.0,44,3,329,483.0,0.28770923614501953,0.1838289201259613
10262603,7486854,6384755,15811,12087,2009,9623,2002,3724,6188,0.3333333333333333,0.0,44,32.0,142,6,28,231.0,0.34962838888168335,0.21262478828430176
10258317,4997435,4608976,15811,5542,1991,3897,1986,10269,11914,1.0,0.0,285,15.0,2,8,42,315.0,0.4742433726787567,0.33067426085472107
10262374,6665685,4747659,15811,10211,2003,4534,1988,5600,11277,1.0,0.0,28,10.0,11,4,63,2975.0,0.14066343009471893,0.16063424944877625
10258844,8376878,5039587,15811,13564,2013,5703,1991,2247,10108,1.0,0.0,38,6.0,20,7,28,2520.0,0.7403063178062439,0.19842475652694702
10261513,9849784,7873928,15811,15335,2017,12801,2011,476,3010,0.25,0.0,1,8.0,14,3,476,434.0,0.5623244047164917,0.20786210894584656
10258333,9687237,8583749,15811,15153,2017,13830,2013,658,1981,1.0,0.0,40,4.0,2578,2,0,357.0,0.559011697769165,0.11689042299985886
10263171,6077285,8520461,15811,8937,2000,13753,2013,6874,2058,0.5,0.0,227,3.0,12,4,0,203.0,0.44225865602493286,0.06346071511507034
10267081,5598793,4170826,15818,7705,1997,1384,1979,8113,14434,0.5,0.0,26,28.0,12,1,315,35.0,0.289076030254364,0.41813692450523376
10265162,4676792,8376760,15818,4198,1987,13564,2013,11620,2254,0.5,0.0,123,5.0,6,3,63,14.0,0.6342177987098694,0.10753978788852692
10265072,7063671,4559447,15818,11128,2006,3638,1985,4690,12180,1.0,0.0,317,3.0,15,1,0,2849.0,0.3577895760536194,0.21463672816753387
10270490,8344829,4287847,15818,13515,2013,2077,1981,2303,13741,0.0,0.0,252,7.0,3,1,0,3297.0,0.379891961812973,0.246893972158432
10266981,5669250,6740447,15818,7936,1997,10372,2004,7882,5446,0.3333333333333333,0.0,27,7.0,22,7,224,294.0,0.39729049801826477,0.07786104083061218
10268247,7043405,8279310,15818,11086,2006,13424,2012,4732,2394,1.0,0.0,63,2.0,7,2,217,1701.0,0.542573094367981,0.22321216762065887
10265074,6023641,7975892,15818,8804,2000,12976,2011,7014,2842,1.0,0.0,131,4.0,10,3,0,196.0,0.13530024886131287,0.528849184513092
10265072,5520678,4498169,15818,7453,1996,3323,1985,8365,12495,1.0,0.0,566,23.0,3,3,0,2653.0,0.50010746717453,0.2394794225692749
10265162,4734095,5381239,15818,4471,1988,6949,1995,11347,8869,0.5,0.0,35,3.0,1,5,98,5327.0,0.5256331562995911,0.24978069961071014
10269370,5680337,6084836,15818,7964,1997,8951,2000,7854,6867,0.0,0.0,18,7.0,24,3,357,3430.0,0.5348115563392639,0.41374021768569946
10268772,6732111,4600444,15818,10351,2004,3848,1986,5467,11970,0.5,0.0,1053,22.0,17,5,0,763.0,0.21154269576072693,0.009348923340439796
10266883,10095832,5095511,15818,15622,2018,5913,1992,196,9905,0.3333333333333333,0.0,1,2.0,23,6,196,4431.0,0.5435468554496765,0.2253149151802063
10265503,6572587,4882087,15818,10015,2003,5073,1989,5803,10745,1.0,0.0,45,4.0,21,6,98,5341.0,0.4169277250766754,0.14298240840435028
10268480,4679140,9301623,15818,4205,1987,14705,2016,11613,1113,1.0,0.0,33,3.0,3,9,21,399.0,0.253012090921402,0.140155628323555
10267417,8613236,4434458,15818,13872,2013,2980,1984,1946,12838,0.5,0.0,2,3.0,1,1,581,7070.0,0.591801106929779,0.2653822898864746
10268011,7264402,8509359,15818,11569,2007,13739,2013,4249,2079,1.0,0.0,128,2.0,24,3,7,1505.0,0.5548789501190186,0.2489835023880005
10274539,7513253,9963276,15825,12150,2009,15468,2018,3675,357,0.0,0.0,70,1.0,9,46,14,357.0,0.2916490435600281,0.19279679656028748
10275128,4732764,6900342,15825,4464,1988,10743,2005,11361,5082,0.0,0.0,21,3.0,4,10,84,1694.0,0.20128509402275085,0.08336298167705536
10276021,5823278,4984738,15825,8328,1998,5493,1991,7497,10332,0.0,0.0,40,7.0,48,8,252,2233.0,0.30112385749816895,0.22319550812244415
10273816,6435830,7949292,15825,9728,2002,12927,2011,6097,2898,1.0,0.0,16,17.0,12,18,182,196.0,0.5416133403778076,0.19819417595863342
10271591,7650648,9963871,15825,12444,2010,15468,2018,3381,357,0.0,0.0,17,1.0,14,20,84,357.0,0.42154020071029663,0.18679969012737274
10275994,8425300,5349343,15825,13627,2013,6837,1994,2198,8988,0.5,0.0,19,43.0,187,17,7,1981.0,0.5515393018722534,0.27633368968963623
10271915,4815450,9055157,15825,4835,1989,14404,2015,10990,1421,0.5,0.0,242,3.0,6,4,0,14.0,0.3677532374858856,0.35778144001960754
10271929,5885078,8634883,15825,8482,1999,13900,2014,7343,1925,1.0,0.0,53,4.0,9,1,21,462.0,0.49400457739830017,0.2068723738193512
10276021,6924441,9898742,15825,10806,2005,15391,2018,5019,434,0.0,0.0,33,2.0,43,4,14,217.0,0.5843973159790039,0.4354363679885864
10272333,9426207,4054164,15825,14845,2016,656,1977,980,15169,0.6666666666666666,0.0,1,12.0,46,1,980,35.0,0.2391151338815689,0.1590607762336731
10272224,6412481,6120577,15825,9679,2002,9028,2000,6146,6797,1.0,0.0,63,11.0,21,21,14,2499.0,0.4935615360736847,0.27630752325057983
10271762,7519424,4608702,15825,12157,2009,3890,1986,3668,11935,1.0,0.0,54,24.0,21,1,35,1155.0,0.42391231656074524,0.14613233506679535
10278247,6121875,7837931,15825,9028,2000,12745,2010,6797,3080,0.0,0.0,158,2.0,8,7,14,203.0,0.4210880398750305,0.14750394225120544
10284261,7009471,5015718,15832,11023,2006,5612,1991,4809,10220,0.5,0.0,253,3.0,1,9,0,1106.0,0.36183643341064453,-0.03491181880235672
10281656,7839902,6285403,15832,12745,2010,9378,2001,3087,6454,0.0,0.0,10,7.0,4,5,504,2842.0,0.5686821937561035,0.15264686942100525
10278702,8322590,5108262,15832,13487,2012,5962,1992,2345,9870,1.0,0.0,349,26.0,293,5,0,98.0,0.6845459342002869,0.20737791061401367
10278776,5779698,5668697,15832,8230,1998,7929,1997,7602,7903,1.0,0.0,293,4.0,24,4,0,175.0,0.5862192511558533,0.3540041446685791
10282564,5890156,7253858,15832,8489,1999,11541,2007,7343,4291,0.5,0.0,752,2.0,9,2,0,3458.0,0.42178136110305786,0.17676439881324768
10280806,6461127,6987446,15832,9777,2002,10974,2006,6055,4858,1.0,0.0,5,8.0,1,3,2499,84.0,0.48621755838394165,0.13310235738754272
10278809,9223148,5986965,15832,14607,2015,8720,1999,1225,7112,0.5,0.0,1,5.0,5,4,1225,294.0,0.796466052532196,0.22522865235805511
10285695,7828189,3981795,15839,12731,2010,264,1976,3108,15575,1.0,0.0,556,4.0,38,1,7,12593.0,0.4351027309894562,-0.043906331062316895
10287230,9663417,4045109,15839,15125,2017,607,1977,714,15232,1.0,0.0,3,21.0,22,1,168,4599.0,0.6004228591918945,0.35769593715667725
10286139,5496294,5558667,15839,7369,1996,7572,1996,8470,8267,1.0,0.5,170,24.0,36,10,21,42.0,0.48874276876449585,0.4045349061489105
10289184,9870773,5574455,15839,15356,2018,7621,1996,483,8218,0.3333333333333333,0.0,3,22.0,9,10,140,1351.0,0.09337083250284195,0.07620058208703995
10285701,4592354,8350469,15839,3806,1986,13522,2013,12033,2317,1.0,0.0,301,2.0,5,11,14,812.0,0.49786436557769775,0.108949676156044
10290503,6495401,6463737,15839,9847,2002,9784,2002,5992,6055,1.0,0.0,3,4.0,13,6,1043,3052.0,0.6065483093261719,0.1137048527598381
10291295,4759051,3974528,15839,4583,1988,229,1976,11256,15610,1.0,0.0,105,16.0,15,1,399,833.0,0.5021793246269226,0.11892524361610413
10291334,6211837,5008306,15839,9224,2001,5584,1991,6615,10255,0.0,0.0,249,6.0,3,2,0,2156.0,0.2671547830104828,0.15137675404548645
10291537,8731542,7571387,15839,14019,2014,12269,2009,1820,3570,0.5,0.5,12,2.0,77,5,119,1036.0,0.5518858432769775,0.24796216189861298
10285819,6001130,7373061,15839,8748,1999,11821,2008,7091,4018,1.0,0.0,758,6.0,27,5,0,903.0,0.5032217502593994,0.17855627834796906
10290277,9305522,5417137,15839,14705,2016,7082,1995,1134,8757,1.0,0.5,1,4.0,2,8,1134,1358.0,0.6825847029685974,0.15809090435504913
10291334,6163296,7814664,15839,9119,2000,12710,2010,6720,3129,0.5,0.0,330,4.0,3,65,0,119.0,0.3833169639110565,0.1923692524433136
10290972,7344403,4286495,15839,11765,2008,2070,1981,4074,13769,1.0,0.0,4,32.0,2,2,413,196.0,0.5221714973449707,0.2819012999534607
10287050,6378588,8953335,15839,9616,2002,14285,2015,6223,1554,0.3333333333333333,0.0,7,9.0,7,22,168,35.0,0.46822959184646606,0.18367999792099
10286294,9440141,5577286,15839,14866,2016,7635,1996,973,8204,1.0,0.0,1,11.0,4,1,973,98.0,0.9999998807907104,0.38294604420661926
10285724,8118276,6549153,15839,13200,2012,9966,2003,2639,5873,0.0,0.0,23,5.0,20,15,7,1330.0,0.3222637176513672,0.04114137589931488
10292704,5094247,7384498,15846,5913,1992,11849,2008,9933,3997,0.3333333333333333,0.0,452,5.0,5,7,7,182.0,0.4124516248703003,0.28233757615089417
10299189,5850442,4709113,15846,8384,1998,4345,1987,7462,11501,0.5,0.0,786,2.0,3,6,28,413.0,0.3516329526901245,0.20974408090114594
10297509,9166050,4911547,15846,14537,2015,5199,1990,1309,10647,1.0,0.0,2,3.0,1,11,287,4746.0,0.6617836952209473,0.25736743211746216
10299189,5265916,5502469,15846,6543,1993,7390,1996,9303,8456,0.0,0.0,50,8.0,7,15,217,4606.0,0.2051912546157837,0.2466214895248413
10293703,4937528,4161223,15846,5290,1990,1293,1979,10556,14553,0.0,0.0,244,18.0,4,1,77,2324.0,0.4428887665271759,0.1510120928287506
10297253,7058569,5119904,15846,11114,2006,6004,1992,4732,9842,0.5,0.0,159,9.0,15,1,0,798.0,0.21295589208602905,0.12972702085971832
10292770,7674293,4496599,15846,12486,2010,3316,1985,3360,12530,0.5,0.0,60,5.0,249,4,35,1512.0,0.38086482882499695,0.06501621007919312
10293119,5480387,4575916,15846,7306,1996,3729,1986,8540,12117,1.0,0.0,392,5.0,15,5,0,889.0,0.3279429078102112,0.1326867938041687
10298638,6438123,5206635,15846,9728,2002,6326,1993,6118,9520,0.5,0.0,139,6.0,1,4,315,2919.0,0.42815399169921875,0.27774176001548767
10293455,6872130,4006107,15846,10680,2005,397,1977,5166,15449,1.0,0.0,29,4.0,23,1,91,10136.0,0.5774096250534058,0.19923782348632812
10294592,4838045,9833697,15846,4912,1989,15314,2017,10934,532,0.5,0.0,5,3.0,7,1,1232,70.0,0.6193501353263855,0.215674489736557
10299071,7117088,6627551,15846,11233,2006,10134,2003,4613,5712,0.0,0.0,38,3.0,25,4,105,2184.0,0.3055233657360077,-0.0706072598695755
10299039,7769183,4859362,15846,12633,2010,4982,1989,3213,10864,0.5,0.0,74,7.0,24,9,0,2877.0,0.5550800561904907,0.16979683935642242
10294016,8204561,4839011,15846,13319,2012,4912,1989,2527,10934,0.0,0.0,113,23.0,22,5,56,1267.0,0.6190130710601807,0.33008167147636414
10297249,6199043,5178176,15846,9196,2001,6221,1993,6650,9625,0.5,0.0,48,13.0,11,1,56,1190.0,0.4223337173461914,0.20289145410060883
10295347,8484187,4225976,15846,13704,2013,1734,1980,2142,14112,0.5,0.0,11,4.0,7,1,56,406.0,0.3840857744216919,0.175756573677063
10296445,8060864,4184001,15846,13102,2011,1475,1980,2744,14371,1.0,0.0,28,24.0,13,2,35,105.0,0.43352705240249634,0.1381092667579651
10299922,7507199,6017449,15853,12136,2009,8790,2000,3717,7063,1.0,0.0,7,8.0,183,6,35,308.0,0.42020338773727417,0.2477627396583557
10301198,4832115,4052251,15853,4891,1989,642,1977,10962,15211,0.3333333333333333,0.0,52,9.0,5,1,7,3794.0,0.2808377742767334,0.20757590234279633
10302807,8674706,8784246,15853,13956,2014,14082,2014,1897,1771,0.5,0.0,10,6.0,145,4,49,203.0,0.30088725686073303,0.023362169042229652
10299792,7708181,4171102,15853,12542,2010,1384,1979,3311,14469,1.0,0.0,464,2.0,129,2,0,12523.0,0.3260197341442108,0.22078227996826172
10299792,6697048,6720964,15853,10281,2004,10330,2004,5572,5523,0.0,0.0,246,15.0,136,20,0,336.0,0.16589438915252686,0.2507195770740509
10302295,5709458,4410301,15853,8055,1998,2847,1983,7798,13006,0.3333333333333333,0.3333333333333333,24,5.0,5,1,49,6972.0,0.5583385825157166,0.2396288812160492
10306419,7970537,5589425,15853,12962,2011,7670,1996,2891,8183,0.5,0.0,69,10.0,1,2,0,4746.0,0.3948841392993927,0.06237231194972992
10301909,5665289,6530474,15853,7922,1997,9931,2003,7931,5922,0.0,0.0,52,5.0,4,8,84,3920.0,0.13526704907417297,0.32303133606910706
10303189,8504318,4651764,15853,13732,2013,4100,1987,2121,11753,0.25,0.2,15,4.0,4,2,280,560.0,0.3655973970890045,0.31368395686149597
10313030,6801767,9018522,15860,10505,2004,14362,2015,5355,1498,1.0,0.0,238,2.0,8,43,21,371.0,0.3289019763469696,0.0393984392285347
10309287,7188637,4525438,15860,11394,2007,3463,1985,4466,12397,0.0,0.0,22,9.0,4,5,0,5551.0,0.47908785939216614,0.18896602094173431
10311144,8285551,5616461,15860,13431,2012,7761,1997,2429,8099,0.0,0.0,173,12.0,55,4,7,2506.0,0.15365760028362274,0.026094237342476845
10307581,6475516,4392656,15860,9805,2002,2749,1983,6055,13111,1.0,0.0,66,9.0,9,1,42,119.0,0.2644732594490051,0.30041688680648804
10311433,5809160,5140694,15860,8293,1998,6074,1992,7567,9786,0.5,0.5,265,6.0,145,7,77,4865.0,0.26724880933761597,0.1599978506565094
10313035,8370887,7217495,15860,13550,2013,11457,2007,2310,4403,1.0,0.0,10,6.0,271,10,7,2366.0,0.5660109519958496,0.08182156085968018
10307535,6544173,5842018,15860,9959,2003,8363,1998,5901,7497,0.5,0.5,412,6.0,4,12,0,917.0,0.34648993611335754,0.0880090743303299
10312907,4618823,7272787,15860,3946,1986,11583,2007,11914,4277,1.0,0.0,27,10.0,2,12,210,490.0,0.6757854223251343,0.19628693163394928
10313184,7581207,5570152,15860,12290,2009,7607,1996,3570,8253,0.5,0.0,8,9.0,6,8,546,2401.0,0.4598115384578705,0.05165048688650131
10311610,5557684,4731497,15860,7565,1996,4457,1988,8295,11403,1.0,0.0,212,23.0,1,2,28,581.0,0.2886402904987335,-0.08472870290279388
10307159,9848873,9368799,15860,15335,2017,14775,2016,525,1085,0.5,0.0,65,1.0,2550,1,7,1085.0,0.5020889043807983,0.055910058319568634
10311410,5484988,5447000,15860,7320,1996,7187,1995,8540,8673,0.5,0.0,322,25.0,15,11,7,336.0,0.5484371781349182,0.10602940618991852
10314592,4964558,5440601,15867,5409,1990,7159,1995,10458,8708,0.0,0.0,55,3.0,8,2,0,2695.0,0.255201518535614,0.22629328072071075
10319742,7742116,4833668,15867,12591,2010,4891,1989,3276,10976,0.5,0.0,1,9.0,4,3,3276,2128.0,0.647283136844635,0.13778841495513916
10314589,6277114,7399500,15867,9364,2001,11884,2008,6503,3983,0.5,0.0,530,10.0,311,8,0,119.0,0.514508068561554,0.1249450072646141
10315096,5769434,9670293,15867,8209,1998,15132,2017,7658,735,1.0,0.0,30,2.0,7,45,126,238.0,0.5777530670166016,0.10183839499950409
10316463,5247740,5358146,15867,6480,1993,6872,1994,9387,8995,0.0,0.0,7,13.0,5,15,903,882.0,0.3270559310913086,0.27246177196502686
10314950,6638917,6932318,15867,10162,2003,10827,2005,5705,5040,0.5,0.0,28,6.0,10,9,35,7.0,0.5642722249031067,0.13799501955509186
10316834,4273121,6340236,15867,1993,1981,9518,2002,13874,6349,0.2,0.0,181,5.0,2,2,28,2982.0,0.37904515862464905,0.12085392326116562
10314603,7547310,6235283,15867,12220,2009,9273,2001,3647,6594,0.5,0.3333333333333333,49,2.0,90,1,35,4417.0,0.1660122275352478,0.17672191560268402
10320262,7327123,6072505,15867,11723,2008,8923,2000,4144,6944,1.0,0.0,20,20.0,21,4,679,315.0,0.39374059438705444,0.19749169051647186
10317136,6183720,8609253,15867,9168,2001,13865,2013,6699,2002,0.0,0.0,13,3.0,7,1,1267,378.0,0.5772143006324768,0.14006684720516205
10315252,5534104,5173953,15867,7495,1996,6200,1992,8372,9667,0.0,0.0,54,13.0,8,10,28,42.0,0.44843560457229614,0.12306910753250122
10319739,9064816,9968266,15867,14418,2015,15475,2018,1449,392,0.5,0.0,100,1.0,419,41,0,392.0,0.3747556507587433,-0.03570207580924034
10319649,5319247,5893350,15867,6732,1994,8503,1999,9135,7364,0.5,0.0,206,8.0,7,4,0,189.0,0.1562565118074417,-0.016287662088871002
10322218,5017103,4624431,15874,5619,1991,3981,1986,10255,11893,0.0,0.0,88,6.0,16,6,21,756.0,0.47165900468826294,0.2759972810745239
10321906,5964767,8425849,15874,8685,1999,13627,2013,7189,2247,1.0,0.0,220,3.0,7,2,14,1225.0,0.2653957009315491,0.0662638321518898
10321907,9226751,5851587,15874,14614,2016,8391,1998,1260,7483,0.2,0.0,330,8.0,1993,14,7,924.0,0.4219624102115631,0.07866394519805908
10326689,8561104,4028869,15874,13802,2013,530,1977,2072,15344,0.5,0.0,189,9.0,5,1,0,5425.0,0.3957430422306061,0.27055928111076355
10323442,5783994,7146922,15874,8237,1998,11303,2006,7637,4571,0.0,0.0,21,5.0,3,4,7,343.0,0.573593020439148,0.2889290452003479
10327115,7321774,7604310,15874,11709,2008,12346,2009,4165,3528,1.0,0.0,72,4.0,143,4,77,1799.0,0.5876691937446594,0.24042068421840668
10326623,5856935,5651324,15874,8405,1999,7880,1997,7469,7994,0.0,0.0,63,7.0,8,3,0,889.0,0.3597734570503235,0.2882847189903259
10324487,5643087,5720139,15874,7852,1997,8090,1998,8022,7784,0.0,0.0,406,15.0,15,7,7,133.0,0.3915518522262573,0.279306560754776
10321937,5034011,5064992,15874,5682,1991,5794,1991,10192,10080,1.0,0.0,215,7.0,10,16,7,3633.0,0.529318630695343,0.2457568645477295
10326675,8626115,8576700,15874,13886,2014,13823,2013,1988,2051,1.0,1.0,70,3.0,425,4,14,917.0,0.24211560189723969,0.3172697126865387
10326790,9225737,3983569,15874,14607,2015,271,1976,1267,15603,1.0,0.0,22,4.0,22,1,28,12635.0,0.5544816851615906,0.1160912960767746
10326245,7860398,4250196,15874,12780,2010,1867,1981,3094,14007,0.0,0.0,28,10.0,79,1,14,35.0,0.355241984128952,-0.006312699988484383
10324951,9020830,7527891,15874,14362,2015,12178,2009,1512,3696,1.0,0.0,4,3.0,44,6,56,1645.0,0.4520237445831299,0.1883368045091629
10328239,9352119,9998719,15881,14761,2016,15503,2018,1120,378,1.0,0.0,1,1.0,66,7,1120,378.0,0.2754230499267578,0.09383158385753632
10333768,8082289,4318361,15881,13137,2011,2259,1982,2744,13622,0.5,0.0,7,38.0,8,1,1477,322.0,0.973342776298523,0.18500354886054993
10333562,6914950,5998226,15881,10778,2005,8741,1999,5103,7140,0.5,0.0,25,10.0,50,4,49,294.0,0.5623817443847656,0.060132935643196106
10327764,5903117,6086637,15881,8531,1999,8958,2000,7350,6923,0.0,0.0,232,3.0,4,4,7,1106.0,0.10915637016296387,0.10724139213562012
10327777,8372094,6528687,15881,13557,2013,9924,2003,2324,5957,1.0,0.0,478,5.0,92,2,0,1967.0,0.18998567759990692,0.09821224212646484
10331763,5680511,7716857,15881,7964,1997,12556,2010,7917,3325,0.0,0.0,237,4.0,10,26,14,238.0,0.4189830720424652,0.10957759618759155
10329764,5010690,6028613,15881,5598,1991,8818,2000,10283,7063,0.0,0.0,45,7.0,8,27,7,2919.0,0.3938663601875305,0.21168391406536102
10327765,8801735,9813512,15881,14103,2014,15286,2017,1778,595,1.0,0.0,405,1.0,330,1,0,595.0,0.5018664598464966,0.2705885171890259
10327876,4333197,7082712,15881,2350,1982,11170,2006,13531,4711,0.5,0.0,83,7.0,2,20,28,700.0,0.49916329979896545,0.1026117354631424
10342126,5679444,4412594,15888,7964,1997,2861,1983,7924,13027,0.3333333333333333,0.0,16,15.0,11,3,3752,1120.0,0.6616634726524353,0.10563161969184875
10341790,6546108,5317947,15888,9959,2003,6732,1994,5929,9156,1.0,0.0,35,8.0,6,4,98,3346.0,0.48313891887664795,0.35930246114730835
10335029,7404640,4811378,15888,11898,2008,4814,1989,3990,11074,1.0,0.0,37,27.0,4,4,112,1099.0,0.4711839556694031,0.23304422199726105
10335194,7033365,6084589,15888,11072,2006,8951,2000,4816,6937,0.5,0.0,31,14.0,15,5,238,511.0,0.44939517974853516,0.25194570422172546
10336470,8602348,6611347,15888,13858,2013,10099,2003,2030,5789,1.0,0.0,38,27.0,6,12,7,245.0,0.37116384506225586,0.1258675754070282
10336045,4997716,7986582,15888,5542,1991,12990,2011,10346,2898,0.3333333333333333,0.0,15,4.0,5,5,462,1120.0,0.2054559886455536,0.1403123289346695
10335597,6950706,4056850,15888,10862,2005,670,1977,5026,15218,1.0,0.0,98,9.0,10,2,70,8050.0,0.5221397876739502,0.17186665534973145
10341855,7990926,5151489,15888,12997,2011,6116,1992,2891,9772,1.0,0.0,1,5.0,5,9,2891,7637.0,0.3626960515975952,0.13729333877563477
10339966,7130159,4767748,15888,11261,2006,4594,1988,4627,11294,1.0,0.0,50,9.0,12,2,49,6272.0,0.4457315504550934,0.1926308274269104
10341164,6813248,6847347,15888,10533,2004,10617,2005,5355,5271,0.5,0.0,18,8.0,8,220,1330,1407.0,0.4788864254951477,0.0798063799738884
10335150,6843793,4387745,15888,10610,2005,2721,1983,5278,13167,1.0,0.0,447,2.0,56,8,0,4081.0,0.24949757754802704,0.31013980507850647
10338545,5009076,4734632,15888,5591,1991,4471,1988,10297,11417,0.0,1.0,81,15.0,8,2,0,203.0,0.4141196012496948,0.24453556537628174
10335858,5836396,6192470,15888,8356,1998,9182,2001,7532,6706,0.25,0.0,52,11.0,13,9,35,91.0,0.47266528010368347,0.1539950966835022
10335076,6248093,8128437,15888,9301,2001,13214,2012,6587,2674,0.5,0.0,735,4.0,32,10,7,616.0,-0.07246179133653641,0.1956530213356018
10340900,6271700,7761457,15888,9350,2001,12619,2010,6538,3269,0.5,0.0,10,5.0,2,29,399,1729.0,0.41317570209503174,0.31959855556488037
10339791,5604493,8801037,15888,7719,1997,14103,2014,8169,1785,0.0,0.0,47,1.0,8,5,7,1785.0,0.18080554902553558,0.08615116029977798
10341341,6842106,7805791,15888,10603,2005,12696,2010,5285,3192,0.0,0.0,104,3.0,24,13,238,322.0,0.7689074873924255,0.036166876554489136
10341808,7436785,9172259,15888,11975,2008,14544,2015,3913,1344,0.3333333333333333,0.0,113,1.0,5,2,28,1344.0,0.44250768423080444,0.24685713648796082
10339496,6161629,5137251,15888,9119,2000,6067,1992,6769,9821,0.0,0.0,39,15.0,9,2,42,490.0,0.4284704625606537,0.09787216037511826
10335150,8453906,3998250,15888,13669,2013,355,1976,2219,15533,1.0,0.0,432,5.0,172,1,0,7819.0,0.4895370304584503,0.18047356605529785
10336412,8919701,4013412,15888,14243,2014,446,1977,1645,15442,0.5,0.0,1,9.0,7,1,1645,5152.0,0.5006410479545593,0.20842920243740082
10338162,7221164,6241490,15888,11464,2007,9287,2001,4424,6601,1.0,0.0,39,2.0,2,7,7,5537.0,0.27489468455314636,0.18225468695163727
10347682,4663188,7770983,15895,4142,1987,12640,2010,11753,3255,1.0,0.0,36,11.0,11,8,77,259.0,0.6027135848999023,0.1921331137418747
10347145,6551104,6311061,15895,9973,2003,9434,2001,5922,6461,0.3333333333333333,0.3333333333333333,5,1.0,14,4,14,6461.0,0.2952525317668915,0.4355044662952423
10342886,7959689,6017394,15895,12948,2011,8790,2000,2947,7105,0.3333333333333333,0.0,6,13.0,4,13,336,161.0,0.5254572629928589,0.11662047356367111
10342541,9086875,8808495,15895,14446,2015,14110,2014,1449,1785,0.0,0.0,247,1.0,5,6,7,1785.0,0.14644667506217957,0.12291356176137924
10347547,5505008,7350789,15895,7404,1996,11779,2008,8491,4116,0.0,0.0,6,7.0,10,11,581,581.0,0.38787996768951416,0.30111196637153625
10345661,8451244,6392464,15895,13662,2013,9637,2002,2233,6258,0.5,0.0,19,2.0,359,5,14,4599.0,0.7333753705024719,0.2925843894481659
10342580,4745913,5436422,15895,4527,1988,7145,1995,11368,8750,1.0,0.0,38,16.0,2,2,371,511.0,0.5530330538749695,0.1548798829317093
10346853,5970479,5391057,15895,8692,1999,6991,1995,7203,8904,1.0,0.0,391,2.0,19,2,28,3059.0,0.29541170597076416,0.08939462900161743
10346377,4589081,5016450,15895,3785,1986,5619,1991,12110,10276,0.0,0.0,31,9.0,7,2,0,2639.0,0.5465579628944397,0.06070319935679436
10350556,6932914,6066291,15902,10827,2005,8909,2000,5075,6993,0.0,0.0,11,4.0,3,3,469,2856.0,0.28691428899765015,0.21017669141292572
10350423,7289855,5355575,15902,11625,2007,6865,1994,4277,9037,1.0,0.0,142,13.0,16,7,21,658.0,0.4068973660469055,0.21031036972999573
10356589,9185535,4202902,15902,14558,2015,1594,1980,1344,14308,0.5,0.0,1,7.0,4,2,1344,1722.0,0.7327527403831482,-0.008571010082960129
10349880,5501675,4409715,15902,7390,1996,2847,1983,8512,13055,1.0,0.0,162,8.0,14,1,21,3563.0,0.42952558398246765,0.3056517541408539
10352995,9748626,7100899,15902,15216,2017,11205,2006,686,4697,0.0,0.0,88,2.0,1563,2,7,1631.0,0.174716979265213,0.25464046001434326
10349999,8848808,5152154,15902,14152,2014,6123,1992,1750,9779,0.0,0.0,23,4.0,16,3,7,693.0,0.34577926993370056,0.028874706476926804
10355402,5606237,7421803,15902,7726,1997,11940,2008,8176,3962,1.0,0.0,18,6.0,7,5,245,966.0,0.41163116693496704,0.3174196183681488
10357246,7784663,4225571,15909,12661,2010,1734,1980,3248,14175,1.0,0.0,614,4.0,138,2,7,532.0,0.43843311071395874,0.25117868185043335
10360641,8622661,4218748,15909,13886,2014,1692,1980,2023,14217,0.0,1.0,7,6.0,28,4,392,11676.0,0.24293814599514008,0.3249829411506653
10357279,6854187,8606106,15909,10638,2005,13858,2013,5271,2051,0.0,0.0,25,5.0,9,4,7,630.0,0.4401021897792816,0.182233065366745
10362715,6058445,4641980,15909,8888,2000,4058,1987,7021,11851,0.3333333333333333,0.0,34,28.0,66,4,70,630.0,0.4769614338874817,0.17687641084194183
10357201,6433401,5056049,15909,9721,2002,5759,1991,6188,10150,0.25,0.0,123,22.0,50,5,7,784.0,0.5146480202674866,0.1819954663515091
10361201,6732006,4715477,15909,10351,2004,4380,1987,5558,11529,0.0,0.0,35,11.0,4,2,14,308.0,0.2531181573867798,0.2571695148944855
10361201,8349083,6382420,15909,13522,2013,9623,2002,2387,6286,0.5,0.0,20,24.0,28,8,14,1239.0,0.24850089848041534,0.3182973265647888
10361721,6362757,7391329,15909,9581,2002,11863,2008,6328,4046,0.5,0.0,36,15.0,7,36,105,224.0,0.4574616253376007,0.22583356499671936
10357257,7194120,7551768,15909,11401,2007,12227,2009,4508,3682,0.0,0.0,17,2.0,16,8,0,1176.0,0.39797109365463257,0.2921845316886902
10361489,8941912,6189536,15909,14271,2015,9182,2001,1638,6727,0.25,0.0,190,18.0,6,16,0,7.0,0.27027347683906555,0.2819313108921051
10361083,6818535,4356433,15909,10547,2004,2490,1982,5362,13419,0.3333333333333333,0.0,21,39.0,11,3,14,2436.0,0.4291556179523468,0.17631062865257263
10361783,7359408,8630940,15909,11793,2008,13893,2014,4116,2016,1.0,0.0,92,2.0,3,1,0,1386.0,0.3306739330291748,0.15087834000587463
10360567,7090128,5530991,15909,11184,2006,7488,1996,4725,8421,0.5,0.0,74,5.0,12,5,14,14.0,0.44108814001083374,0.1304168403148651
10359697,8215946,7944553,15909,13340,2012,12920,2011,2569,2989,0.0,0.0,11,9.0,146,1,21,154.0,0.7279657125473022,0.20366321504116058
10357246,5779130,9065371,15909,8230,1998,14418,2015,7679,1491,1.0,0.0,1178,1.0,42,55,0,1491.0,0.5898907780647278,0.22614064812660217
10364598,8624844,4734632,15916,13886,2014,4471,1988,2030,11445,0.3333333333333333,0.0,38,15.0,66,2,21,231.0,0.350818395614624,0.2129293531179428
10362967,6848444,6103082,15916,10624,2005,8993,2000,5292,6923,1.0,0.0,40,2.0,34,1,7,2618.0,0.4674544334411621,0.18653100728988647
10365047,5899265,5217607,15916,8524,1999,6368,1993,7392,9548,0.3333333333333333,0.0,28,24.0,12,18,280,567.0,0.5035723447799683,0.2887578308582306
10367384,8922083,8691935,15916,14243,2014,13977,2014,1673,1939,1.0,0.0,8,2.0,8,3,21,840.0,0.6920792460441589,0.1460990011692047
10363033,6893435,4328489,15916,10729,2005,2315,1982,5187,13601,1.0,0.0,657,12.0,19,3,0,5971.0,0.3388000428676605,0.12111710011959076
10363036,7067038,5541931,15916,11135,2006,7516,1996,4781,8400,0.0,0.0,391,7.0,37,10,0,1554.0,0.17937301099300385,0.040728408843278885
10366231,7448084,5289724,15916,11996,2008,6634,1994,3920,9282,0.5,0.0,216,7.0,8,3,28,1232.0,0.43874669075012207,0.17652589082717896
10363766,6629916,5191244,15916,10141,2003,6270,1993,5775,9646,0.0,0.0,16,18.0,22,2,700,721.0,0.45189613103866577,0.16688868403434753
10363197,4686439,4619849,15916,4240,1987,3953,1986,11676,11963,0.09090909090909091,0.0,59,19.0,13,3,70,77.0,0.36047402024269104,-0.065760537981987
10363133,8932349,5536169,15916,14257,2015,7502,1996,1659,8414,1.0,1.0,20,16.0,209,15,49,287.0,0.6167110204696655,0.30688607692718506
10365810,6956477,4682349,15916,10883,2005,4219,1987,5033,11697,0.3333333333333333,0.3333333333333333,57,7.0,10,5,21,6636.0,0.40325555205345154,0.2886483073234558
10366338,6694337,4404141,15916,10274,2004,2812,1983,5642,13104,1.0,0.0,48,9.0,28,3,0,161.0,0.25279808044433594,-0.03935599699616432
10368386,6498838,8588601,15916,9854,2002,13837,2013,6062,2079,1.0,0.0,6,2.0,4,3,2590,1239.0,0.3343181610107422,0.22870789468288422
10369629,9700908,6375277,15923,15167,2017,9609,2002,756,6314,0.0,0.0,19,11.0,95,3,14,343.0,0.4616592526435852,0.17524562776088715
10371721,6774803,6266339,15923,10449,2004,9336,2001,5474,6587,0.0,0.5,17,35.0,24,33,98,434.0,0.2868645489215851,0.15826396644115448
10368658,5664395,5076555,15923,7922,1997,5843,1991,8001,10080,0.2,0.0,117,27.0,4,2,14,1505.0,0.5053804516792297,0.405362993478775
10373457,9805564,5180500,15923,15279,2017,6228,1993,644,9695,1.0,0.0,6,5.0,15,2,84,4494.0,0.6020153164863586,0.02473088726401329
10373136,10013605,8533214,15923,15524,2018,13767,2013,399,2156,0.5,1.0,4,2.0,434,17,21,1589.0,0.47130876779556274,0.21743394434452057
10369015,8241328,6599986,15923,13375,2012,10071,2003,2548,5852,1.0,0.0,33,2.0,8,6,28,2639.0,0.4494381546974182,0.13577836751937866
10368539,7044085,4781014,15923,11093,2006,4688,1988,4830,11235,0.3333333333333333,0.3333333333333333,3,4.0,12,5,378,5845.0,0.5213629007339478,0.1013149693608284
10372612,6950898,3999303,15923,10862,2005,362,1976,5061,15561,0.25,0.0,153,9.0,11,2,7,4088.0,0.42717885971069336,0.1809554547071457
10371850,6418788,7598936,15923,9693,2002,12332,2009,6230,3591,1.0,0.0,19,2.0,19,4,154,2135.0,0.4151614010334015,0.29923146963119507
10368867,5693042,5352454,15923,8006,1997,6851,1994,7917,9072,1.0,0.0,726,2.0,5,2,0,3388.0,0.544091522693634,0.16791659593582153
10370957,6778720,6353836,15923,10456,2004,9560,2002,5467,6363,0.0,0.0,8,3.0,15,12,35,126.0,0.24445641040802002,0.07596635073423386
10369829,7300044,4610948,15923,11653,2007,3904,1986,4270,12019,0.0,0.0,13,10.0,6,2,259,5236.0,0.4303605854511261,0.12833137810230255
10368864,6629988,5120300,15923,10141,2003,6004,1992,5782,9919,0.5,0.3333333333333333,773,16.0,26,2,0,49.0,0.2770577669143677,0.2772263288497925
10370661,5166315,8325007,15923,6172,1992,13487,2012,9751,2436,0.0,0.0,386,3.0,1,10,0,315.0,0.27865761518478394,-0.03331351652741432
10368865,5111987,5571325,15923,5976,1992,7614,1996,9947,8309,1.0,0.0,867,10.0,3,7,0,63.0,0.5527783036231995,0.28069186210632324
10369429,8206241,6384755,15923,13326,2012,9623,2002,2597,6300,1.0,0.0,82,32.0,35,6,28,343.0,0.2970864474773407,0.07941208779811859
10371748,5852617,5429576,15923,8391,1998,7124,1995,7532,8799,0.3333333333333333,0.0,93,63.0,8,5,406,35.0,0.1753600686788559,0.2656688690185547
10373535,6065854,9195686,15923,8909,2000,14572,2015,7014,1351,0.16666666666666666,0.16666666666666666,76,1.0,1,9,126,1351.0,0.6957934498786926,0.2540065348148346
10370150,6652571,4439767,15923,10190,2003,3008,1984,5733,12915,0.5,0.0,296,11.0,27,4,0,1218.0,0.35110530257225037,0.14434319734573364
10380071,7444381,6417008,15930,11989,2008,9686,2002,3941,6244,0.5,0.0,30,6.0,31,32,7,476.0,0.4375324845314026,0.21342630684375763
10378049,5656493,4917882,15930,7894,1997,5220,1990,8036,10710,0.2,0.0,357,18.0,42,12,7,483.0,0.40730834007263184,0.2135854959487915
10376395,6110198,7933132,15930,9007,2000,12899,2011,6923,3031,1.0,0.0,270,7.0,41,5,21,378.0,0.47855669260025024,0.07175927609205246
10376644,5859531,7194848,15930,8412,1999,11408,2007,7518,4522,0.0,0.0,10,5.0,12,182,168,896.0,0.5870312452316284,0.10647819191217422
10380720,9040574,6120942,15930,14390,2015,9028,2000,1540,6902,0.0,0.0,123,12.0,2,5,0,2247.0,0.07427212595939636,0.3968999683856964
10379745,7707362,4015208,15930,12535,2010,453,1977,3395,15477,1.0,0.0,3,25.0,12,1,1456,4704.0,0.48408111929893494,0.29734230041503906
10376677,5135504,7500055,15930,6060,1992,12115,2009,9870,3815,1.0,0.0,208,8.0,16,13,21,1092.0,0.4691073000431061,0.1055489107966423
10380719,6157747,6083216,15930,9105,2000,8951,2000,6825,6979,1.0,0.0,252,27.0,5,22,7,707.0,0.5524464249610901,0.16757509112358093
10382976,8578076,7336775,15930,13823,2013,11744,2008,2107,4186,0.0,0.5,258,31.0,61,3,7,147.0,0.19094200432300568,0.28397899866104126
10380679,7497369,4945326,15930,12115,2009,5325,1990,3815,10605,1.0,0.0,13,5.0,33,3,224,4214.0,0.382633239030838,0.20700344443321228
10381483,8076749,9035354,15930,13130,2011,14383,2015,2800,1547,0.3333333333333333,0.3333333333333333,14,1.0,17,81,252,1547.0,0.432037353515625,0.3014511168003082
10389134,6369461,7279905,15937,9595,2002,11604,2007,6342,4333,1.0,0.5,159,6.0,4,12,0,1862.0,0.34626466035842896,0.40512755513191223
10389625,7983174,4670057,15937,12983,2011,4170,1987,2954,11767,0.0,0.0,77,12.0,27,1,0,266.0,0.2736026644706726,0.03488677740097046
10383309,8468973,4170852,15937,13690,2013,1384,1979,2247,14553,1.0,0.0,4,24.0,3,2,7,231.0,0.5698525309562683,0.27637147903442383
10387868,6814282,5611247,15937,10540,2004,7747,1997,5397,8190,0.5,0.0,155,2.0,32,6,77,5866.0,0.4486768841743469,0.14498168230056763
10387719,9292973,4941393,15937,14691,2016,5311,1990,1246,10626,0.5,0.0,9,2.0,23,5,49,6587.0,0.14053674042224884,0.06571859866380692
10383630,8177797,6744014,15937,13284,2012,10379,2004,2653,5558,1.0,0.0,423,2.0,17,5,7,4865.0,0.27495744824409485,0.25933608412742615
10384422,6924037,5645565,15937,10806,2005,7859,1997,5131,8078,0.5,0.0,53,32.0,3,21,7,35.0,0.5171393156051636,0.1293194591999054
10384203,6472166,5264241,15937,9798,2002,6536,1993,6139,9401,0.0,0.0,25,9.0,17,1,112,1204.0,0.3074657917022705,0.17517006397247314
10389136,7454253,7391329,15937,12010,2008,11863,2008,3927,4074,0.5,0.0,29,15.0,11,36,0,252.0,0.21027782559394836,0.1644473671913147
10387073,5212772,6089376,15937,6347,1993,8965,2000,9590,6972,0.5,0.0,741,2.0,13,8,0,6006.0,0.3807602524757385,0.18033480644226074
10385623,5377773,4340999,15937,6942,1995,2399,1982,8995,13538,0.25,0.0,53,5.0,10,1,49,5075.0,0.5481250286102295,0.15953904390335083
10394550,7003768,5111170,15944,11009,2006,5969,1992,4935,9975,1.0,0.0,14,4.0,2,3,77,4403.0,0.27558717131614685,0.19853976368904114
10396450,9263836,7564913,15944,14656,2016,12255,2009,1288,3689,0.5,0.5,3,5.0,5,9,735,1561.0,0.5260319709777832,0.2893734574317932
10390846,6063123,8334373,15944,8902,2000,13501,2012,7042,2443,1.0,0.0,42,1.0,5,1,98,2443.0,0.49505674839019775,0.10075332224369049
10392935,8596354,4371334,15944,13851,2013,2588,1983,2093,13356,1.0,0.0,10,4.0,35,1,308,1099.0,0.5009123086929321,0.1755230873823166
10391116,6678548,7404851,15944,10239,2004,11898,2008,5705,4046,0.5,0.0,83,2.0,27,6,21,2219.0,-0.0006766663864254951,0.09049602597951889
10396173,6590346,5342425,15944,10050,2003,6816,1994,5894,9128,0.0,0.0,183,2.0,6,5,0,2450.0,0.4015699028968811,0.2018490731716156
10397450,8321849,4756366,15944,13480,2012,4576,1988,2464,11368,0.5,0.0,42,7.0,12,6,7,301.0,0.47216230630874634,0.30990007519721985
10390841,9687230,4185504,15944,15153,2017,1489,1980,791,14455,1.0,0.0,143,15.0,2361,2,0,350.0,0.6429450511932373,0.2902873754501343
10395310,7330834,6855304,15944,11730,2008,10638,2005,4214,5306,1.0,0.0,24,2.0,22,11,91,2751.0,0.3819296956062317,0.14266318082809448
10395951,9048269,4651779,15944,14397,2015,4100,1987,1547,11844,0.5,0.0,2,9.0,4,2,7,1645.0,0.5330027937889099,0.15636710822582245
10395823,5527504,7960733,15944,7474,1996,12948,2011,8470,2996,0.3333333333333333,0.3333333333333333,10,5.0,6,26,812,28.0,0.5789909362792969,0.22402691841125488
10390817,4566138,4453594,15944,3680,1986,3085,1984,12264,12859,1.0,0.0,159,11.0,9,1,7,1890.0,0.4147487282752991,0.2534380257129669
10391423,9599594,9319704,15944,15055,2017,14719,2016,889,1225,1.0,0.0,1,2.0,5,3,889,336.0,0.23159442842006683,0.13276627659797668
10393508,8194097,8738113,15944,13305,2012,14026,2014,2639,1918,0.0,0.0,61,2.0,14,31,0,483.0,0.16910454630851746,0.10329219698905945
10395944,9972504,9553701,15944,15475,2018,14999,2017,469,945,0.5,0.0,4,6.0,105,3,21,56.0,0.5768121480941772,0.2576179504394531
10401126,8701544,7153942,15951,13991,2014,11317,2006,1960,4634,0.5,0.0,8,13.0,6,27,70,1008.0,0.41844606399536133,0.1200350970029831
10400450,5163493,8150183,15951,6165,1992,13242,2012,9786,2709,0.0,0.0,14,2.0,3,1,203,217.0,0.25002408027648926,0.016853636130690575
10398966,5118114,4407087,15951,5997,1992,2833,1983,9954,13118,0.5,0.0,91,6.0,1,3,56,6734.0,0.365111768245697,0.33319926261901855
10404085,9350839,4656554,15951,14754,2016,4114,1987,1197,11837,0.0,0.5,2,9.0,5,7,693,161.0,0.26614463329315186,0.2743178606033325
10400425,9227478,4555524,15951,14614,2016,3617,1985,1337,12334,0.5,0.0,2,17.0,6,2,854,6076.0,0.42709580063819885,0.2013567090034485
10398563,8303663,6429653,15951,13459,2012,9714,2002,2492,6237,1.0,0.0,129,36.0,61,10,7,42.0,0.49108853936195374,0.29971155524253845
10398566,8632595,9666035,15951,13900,2014,15125,2017,2051,826,1.0,0.0,71,3.0,21,10,0,35.0,0.6652100682258606,0.2008362114429474
10398436,5531305,5430255,15951,7488,1996,7124,1995,8463,8827,0.0,0.0,385,13.0,13,5,0,427.0,0.21010412275791168,0.11680237948894501
10403394,6677976,5272257,15951,10239,2004,6564,1993,5712,9387,0.3333333333333333,0.0,136,24.0,9,6,28,126.0,0.3761749863624573,0.10772436112165451
10398434,6155473,7356235,15951,9105,2000,11786,2008,6846,4165,1.0,0.0,712,4.0,2,1,0,1736.0,0.384601354598999,0.23375721275806427
10405901,7341589,4376606,15958,11758,2008,2630,1983,4200,13328,1.0,0.0,115,7.0,39,1,14,6272.0,0.5297961235046387,0.3808712363243103
10411978,7609630,4235556,15958,12353,2009,1790,1980,3605,14168,1.0,0.0,14,5.0,1,1,21,5922.0,0.4462839961051941,0.18069735169410706
10410943,8721791,5097974,15958,14012,2014,5927,1992,1946,10031,1.0,0.0,52,17.0,3,22,7,1596.0,0.32492324709892273,0.30535709857940674
10411999,7697528,4258426,15958,12521,2010,1909,1981,3437,14049,1.0,0.0,20,5.0,6,10,154,7581.0,0.39075928926467896,0.21932312846183777
10407920,5413840,3990096,15958,7068,1995,306,1976,8890,15652,0.5,0.0,97,10.0,4,2,175,1148.0,0.4340985417366028,0.35664308071136475
10406871,5915714,4115819,15958,8580,1999,992,1978,7378,14966,1.0,0.0,33,9.0,7,2,329,7476.0,0.5196532607078552,0.31604868173599243
10408884,8847775,8614900,15958,14152,2014,13872,2013,1806,2086,0.25,0.0,5,4.0,10,23,266,252.0,0.5611538290977478,0.17114312946796417
10410967,5096852,4717615,15958,5920,1992,4387,1988,10038,11571,1.0,0.0,221,26.0,3,5,343,2982.0,0.37847787141799927,0.2719115614891052
10407296,8593290,6656874,15958,13844,2013,10197,2003,2114,5761,0.0,0.0,2,3.0,22,12,658,105.0,0.45224729180336,0.1589328944683075
10412487,9113052,3999130,15958,14474,2015,355,1976,1484,15603,0.5,0.0,46,4.0,47,1,7,7511.0,0.32915550470352173,0.3049803674221039
10417946,7137964,5922914,15965,11282,2006,8594,1999,4683,7371,0.0,0.0,409,35.0,146,1,0,1785.0,0.33341822028160095,0.1811886578798294
10415396,6746755,5706305,15965,10386,2004,8041,1998,5579,7924,0.0,0.0,62,8.0,25,2,154,182.0,0.47017043828964233,0.12644603848457336
10419170,7000021,8845521,15965,11002,2006,14152,2014,4963,1813,0.0,0.0,39,2.0,6,9,427,805.0,0.6587705016136169,0.4031234085559845
10413324,8226553,4414129,15965,13354,2012,2868,1983,2611,13097,1.0,0.0,132,6.0,172,3,0,7294.0,0.6792852282524109,0.07029782980680466
10416517,7453065,4832537,15965,12010,2008,4891,1989,3955,11074,0.0,0.0,3088,8.0,5,4,0,385.0,0.14961765706539154,0.11204303801059723
10413356,7742795,5207897,15965,12591,2010,6333,1993,3374,9632,1.0,0.0,259,15.0,161,11,0,1379.0,0.7056787610054016,0.28809258341789246
10413297,6866671,5089716,15965,10666,2005,5892,1992,5299,10073,1.0,0.0,707,8.0,72,9,0,175.0,0.3842225968837738,0.10127381980419159
10415302,5950379,9746688,15965,8657,1999,15216,2017,7308,749,1.0,0.0,7,11.0,8,10,84,7.0,0.7153692245483398,0.2763059437274933
10416313,7912422,7277531,15965,12864,2011,11597,2007,3101,4368,0.0,0.0,2,2.0,10,35,1638,2905.0,0.6402373909950256,0.2317582219839096
10420560,4807628,5428535,15972,4807,1989,7117,1995,11165,8855,0.3333333333333333,0.0,221,31.0,6,11,0,14.0,0.6917827129364014,0.14270207285881042
10423813,6437563,4542744,15972,9728,2002,3554,1985,6244,12418,0.0,0.0,62,23.0,24,2,0,133.0,0.3572981059551239,0.16614069044589996
10420551,8006885,8024173,15972,13025,2011,13046,2011,2947,2926,0.5,0.0,560,10.0,37,13,0,42.0,0.5148963928222656,0.2418607622385025
10425501,8676895,9245278,15972,13956,2014,14635,2016,2016,1337,0.5,0.5,5,9.0,13,56,315,7.0,0.31526896357536316,0.15014763176441193
10424145,6330978,4634437,15972,9483,2001,4023,1987,6489,11949,0.5,0.0,44,10.0,9,4,105,1316.0,0.4324759840965271,0.2348097413778305
10423176,6518737,7299557,15972,9903,2003,11653,2007,6069,4319,1.0,0.0,68,2.0,16,15,168,357.0,0.4863782823085785,0.16057811677455902
10420715,6132790,4241910,15972,9056,2000,1825,1980,6916,14147,0.5,0.0,29,8.0,7,1,434,427.0,0.1877354383468628,0.10739109665155411
10420550,7067038,9666330,15972,11135,2006,15125,2017,4837,847,0.0,0.0,414,1.0,37,2,0,847.0,0.20167867839336395,0.09467245638370514
10425149,7519014,6110019,15972,12157,2009,9007,2000,3815,6965,1.0,0.0,22,6.0,3,3,539,5495.0,0.6706822514533997,-0.035476867109537125
10425675,6009409,7473041,15972,8762,1999,12059,2009,7210,3913,0.3333333333333333,0.0,294,5.0,7,21,7,1064.0,0.47011443972587585,0.2407909482717514
10430757,6881247,6954593,15979,10701,2005,10876,2005,5278,5103,0.0,0.0,25,3.0,9,5,49,1904.0,0.4767202138900757,0.14172659814357758
10431445,5828062,4917269,15979,8335,1998,5220,1990,7644,10759,0.5,0.0,78,38.0,12,2,217,1484.0,0.5463880300521851,0.26408594846725464
10427028,5288068,4206469,15979,6627,1994,1615,1980,9352,14364,1.0,0.0,7,14.0,2,1,2156,1442.0,0.5073500275611877,0.17199988663196564
10431215,9196248,4049504,15979,14572,2015,628,1977,1407,15351,0.25,0.0,1,4.0,2,1,1407,5222.0,0.5180354714393616,0.07245431840419769
10426476,8028883,5653139,15979,13060,2011,7887,1997,2919,8092,1.0,0.0,732,6.0,103,1,0,658.0,0.38744476437568665,0.3544852137565613
10428821,9970442,7024348,15979,15475,2018,11051,2006,504,4928,0.5,0.0,13,18.0,6,9,77,91.0,0.6839470267295837,0.2607268989086151
10429925,5613048,5148255,15979,7747,1997,6102,1992,8232,9877,0.5,0.0,114,34.0,10,1,28,490.0,0.3529511094093323,0.19362127780914307
10427822,4380299,4538239,15979,2665,1983,3526,1985,13314,12453,1.0,0.0,15,37.0,7,2,1435,161.0,0.5058140158653259,0.1136479377746582
10429911,5724803,5539542,15979,8104,1998,7509,1996,7875,8470,0.0,0.0,23,15.0,12,4,56,5740.0,0.30500438809394836,0.3154086172580719
10431894,9461706,4254050,15979,14887,2016,1888,1981,1092,14091,0.0,0.0,238,12.0,784,2,7,1967.0,0.7979263663291931,0.19392094016075134
10426181,5554402,4389589,15979,7558,1996,2728,1983,8421,13251,0.0,0.0,9,10.0,9,3,357,6139.0,0.5508114099502563,0.019567158073186874
10426761,6663902,8693271,15979,10211,2003,13977,2014,5768,2002,0.4,0.0,24,5.0,56,2,28,777.0,0.32185572385787964,0.05097508803009987
10427604,6867510,6149228,15979,10666,2005,9091,2000,5313,6888,0.3333333333333333,0.3333333333333333,38,4.0,46,20,399,301.0,0.5711348056793213,0.3885544538497925
10426449,4411654,5508269,15979,2854,1983,7411,1996,13125,8568,1.0,1.0,333,22.0,11,2,14,28.0,0.35443246364593506,0.16249439120292664
10430340,5809336,8543033,15979,8293,1998,13781,2013,7686,2198,1.0,0.0,101,1.0,18,5,133,2198.0,0.194648876786232,0.22458551824092865
10433849,7966799,7692195,15986,12962,2011,12514,2010,3024,3472,0.0,0.0,580,3.0,582,4,0,35.0,0.31575074791908264,0.18683882057666779
10435827,5955177,5864138,15986,8664,1999,8426,1999,7322,7560,0.0,0.0,54,9.0,18,3,0,7.0,0.33377552032470703,0.20834963023662567
10435790,6713824,4161373,15986,10316,2004,1293,1979,5670,14693,0.0,0.0,85,14.0,16,4,28,9779.0,0.3758937120437622,0.19683648645877838
10439675,8131125,6053682,15986,13214,2012,8881,2000,2772,7105,0.0,0.0,208,9.0,149,2,28,427.0,0.12274537980556488,0.030016932636499405
10438922,8436671,7195084,15986,13641,2013,11408,2007,2345,4578,0.0,0.0,19,43.0,6,73,35,77.0,0.21765440702438354,0.35276681184768677
10437333,8717305,4945292,15986,14005,2014,5325,1990,1981,10661,1.0,0.0,70,11.0,90,2,21,2163.0,0.5304679274559021,0.254815012216568
10434242,8453838,4791683,15986,13669,2013,4737,1988,2317,11249,0.3333333333333333,0.0,8,9.0,16,5,126,336.0,0.5129765868186951,0.1374344825744629
10434692,5356029,5947405,15986,6865,1994,8650,1999,9121,7336,0.0,0.0,40,2.0,4,5,42,2919.0,0.36114898324012756,0.13435211777687073
10437130,5593549,4481989,15986,7684,1997,3239,1984,8302,12747,0.0,0.0,24,13.0,13,3,70,315.0,0.48832106590270996,0.14690274000167847
10433746,6507756,6490212,15986,9875,2003,9833,2002,6111,6153,1.0,0.0,122,19.0,13,6,63,994.0,0.3615390658378601,0.2044447958469391
10438965,8616765,8543281,15986,13879,2013,13781,2013,2107,2205,0.0,0.0,33,1.0,93,10,0,2205.0,0.4129682183265686,0.08187708258628845
10434318,8200332,4761648,15986,13312,2012,4597,1988,2674,11389,1.0,0.0,15,18.0,110,4,168,406.0,0.37975621223449707,0.2332908660173416
10436553,9791240,8551646,15986,15265,2017,13795,2013,721,2191,1.0,0.0,8,3.0,54,4,0,273.0,0.44013601541519165,0.24835512042045593
10437945,8914279,6963601,15986,14229,2014,10904,2005,1757,5082,1.0,0.0,4,4.0,3,9,168,105.0,0.16242152452468872,0.17055419087409973
10433846,4169990,6864824,15986,1370,1979,10659,2005,14616,5327,0.0,0.0,582,4.0,8,5,0,1456.0,0.18735741078853607,0.1970158815383911
10439675,7797367,4852341,15986,12675,2010,4961,1989,3311,11025,0.0,0.0,230,4.0,156,5,0,2198.0,0.09807070344686508,0.22350823879241943
10433977,5452748,3989027,15986,7208,1995,306,1976,8778,15680,0.0,0.0,56,27.0,3,1,21,2548.0,0.2809533178806305,0.1454518437385559
10442399,4532418,4902101,15993,3498,1985,5164,1990,12495,10829,0.16666666666666666,0.0,214,27.0,9,2,21,280.0,0.41681164503097534,0.21848544478416443
10444836,8239413,4343022,15993,13368,2012,2406,1982,2625,13587,0.5,0.0,46,3.0,100,4,35,7273.0,0.1452965885400772,0.23423466086387634
10442756,8663700,6118742,15993,13942,2014,9021,2000,2051,6972,0.3333333333333333,0.0,54,14.0,33,6,49,2765.0,0.5140379071235657,-0.06923525780439377
10447373,7986742,6780059,15993,12990,2011,10463,2004,3003,5530,1.0,0.0,85,26.0,192,5,14,840.0,0.3331459164619446,0.29519152641296387
10441285,8079950,5660224,15993,13137,2011,7908,1997,2856,8085,0.5,0.0,324,16.0,22,1,0,35.0,0.14835402369499207,0.2698323428630829
10442613,4520925,8608582,15993,3442,1985,13865,2013,12551,2128,0.5,0.0,53,5.0,6,7,1008,14.0,0.4505857825279236,0.11910535395145416
10448494,7718538,4079274,15993,12556,2010,803,1978,3437,15190,0.3333333333333333,0.0,28,6.0,9,1,112,4606.0,0.3434644937515259,0.1424930989742279
10441844,7082703,4889549,15993,11170,2006,5108,1989,4823,10885,0.0,0.0,54,3.0,7,1,7,8932.0,0.22061200439929962,0.2864295244216919
10446744,9594683,5523637,15993,15048,2017,7460,1996,945,8533,0.0,0.0,12,30.0,1,10,7,350.0,0.20862729847431183,0.14829203486442566
10441481,4690680,9505473,15993,4261,1987,14943,2016,11732,1050,1.0,0.0,108,1.0,3,3,105,1050.0,0.508522093296051,0.21228981018066406
10442280,5087093,9903262,15993,5885,1992,15398,2018,10108,595,0.5,0.0,31,1.0,2,2,35,595.0,0.4132443368434906,0.14600928127765656
10442399,7869576,10034356,15993,12794,2011,15545,2018,3199,448,0.2,0.0,86,1.0,33,1,21,448.0,0.43266209959983826,0.37377870082855225
10441844,6705977,7358922,15993,10302,2004,11793,2008,5691,4200,1.0,0.0,36,15.0,19,27,7,154.0,0.31630778312683105,0.10683295875787735
10441356,5810802,5075429,15993,8300,1998,5836,1991,7693,10157,1.0,0.0,548,2.0,11,5,7,4739.0,0.37573543190956116,0.03423824906349182
10446086,9171491,5797844,15993,14544,2015,8272,1998,1449,7721,0.3333333333333333,0.0,6,16.0,5,3,231,35.0,0.48332932591438293,0.039111994206905365
10445054,4530091,4138135,15993,3484,1985,1132,1979,12509,14861,0.2,0.0,109,7.0,3,2,7,2597.0,0.5697968006134033,0.21100972592830658
10446471,7480992,4442910,15993,12080,2009,3029,1984,3913,12964,0.0,0.0,8,10.0,15,3,91,441.0,0.2837170660495758,0.18052764236927032
10443690,8529394,5630212,15993,13767,2013,7803,1997,2226,8190,1.0,0.0,65,5.0,14,3,42,3465.0,0.6115615963935852,0.11309368163347244
10445678,8473278,5894457,15993,13690,2013,8503,1999,2303,7490,0.5,0.0,26,6.0,6,2,28,77.0,0.1796969324350357,0.18120676279067993
10441840,7207930,8704769,15993,11436,2007,13991,2014,4557,2002,1.0,0.0,21,7.0,26,179,7,56.0,0.352463960647583,0.13756562769412994
10451716,9170333,4298988,16000,14544,2015,2133,1981,1456,13867,0.3333333333333333,0.0,42,13.0,2,5,35,3283.0,0.3796975016593933,0.2296859472990036
10449558,5340064,7276698,16000,6809,1994,11597,2007,9191,4403,0.25,0.0,37,4.0,3,3,7,2170.0,0.2844496965408325,0.015965331345796585
10448938,9192362,9130224,16000,14572,2015,14495,2015,1428,1505,1.0,0.0,1,2.0,22,2,1428,364.0,0.5763658881187439,0.26340577006340027
10450308,7777036,7871221,16000,12647,2010,12801,2011,3353,3199,0.5,0.0,7,4.0,43,15,910,483.0,0.5621179342269897,0.1291416883468628
10450755,8701367,6146138,16000,13991,2014,9084,2000,2009,6916,0.25,0.0,3,15.0,91,11,1211,441.0,0.45407193899154663,0.16423264145851135
10451966,8202468,6179964,16000,13319,2012,9161,2001,2681,6839,0.0,0.0,5,16.0,3,6,133,189.0,0.713979184627533,0.2962668538093567
10448980,6436100,4725114,16000,9728,2002,4429,1988,6272,11571,1.0,0.0,136,6.0,16,8,0,434.0,0.4654224216938019,0.40607333183288574
10448964,7909221,7946734,16000,12864,2011,12927,2011,3136,3073,1.0,0.0,711,6.0,336,74,0,420.0,0.45705491304397583,0.24627378582954407
10448964,8574263,5094419,16000,13823,2013,5913,1992,2177,10087,1.0,0.0,287,4.0,52,7,0,560.0,0.6220617890357971,0.3309836685657501
10451454,7570125,6520502,16000,12269,2009,9910,2003,3731,6090,0.5,0.0,5,7.0,9,4,294,1624.0,0.40070459246635437,0.07061728835105896
10454950,10169585,5433519,16000,15706,2019,7138,1995,294,8862,0.0,0.0,3,13.0,309,1,7,301.0,0.4797068238258362,0.20056743919849396
10452653,9892099,4850218,16000,15384,2018,4954,1989,616,11046,0.5,0.0,1,6.0,1,2,616,1876.0,0.5385427474975586,0.0830283910036087
10456133,7886951,5868610,16007,12829,2011,8440,1999,3178,7567,0.5,0.0,515,3.0,55,1,7,6762.0,0.34626835584640503,0.27890241146087646
10459251,4796988,5610073,16007,4758,1989,7740,1997,11249,8267,1.0,0.0,8,6.0,5,4,56,1218.0,0.7680763006210327,0.18619558215141296
10458778,8302301,5604542,16007,13459,2012,7719,1997,2548,8288,0.0,0.0,28,38.0,4,8,77,77.0,0.2047453224658966,0.26219597458839417
10461930,5363448,4905308,16007,6886,1994,5171,1990,9121,10836,0.5,0.0,173,9.0,10,3,21,2037.0,0.34283116459846497,0.20808282494544983
10459184,5353367,7630870,16007,6851,1994,12395,2009,9156,3612,1.0,0.0,284,5.0,7,2,14,1757.0,0.4990825057029724,0.1102883368730545
10459611,8462921,6327002,16007,13676,2013,9469,2001,2331,6538,0.6666666666666666,0.3333333333333333,13,37.0,8,9,42,980.0,0.3278733491897583,0.21815481781959534
10460762,9007707,4857016,16007,14348,2015,4975,1989,1659,11032,1.0,0.0,8,13.0,4,3,49,2912.0,0.3283747732639313,0.23647479712963104
10462627,8955038,4702586,16007,14285,2015,4317,1987,1722,11690,1.0,0.0,29,3.0,33,1,28,10332.0,0.23306526243686676,0.2526811361312866
10456133,5749893,4729641,16007,8167,1998,4450,1988,7840,11557,0.5,0.0,1016,38.0,55,3,7,1981.0,0.60395348072052,0.23505495488643646
10456934,7013522,4471572,16007,11037,2006,3183,1984,4970,12824,0.0,0.0,28,6.0,2,3,7,2275.0,0.2957797348499298,0.1937803328037262
10462304,8085912,7116297,16007,13144,2011,11233,2006,2863,4774,1.0,0.0,3,10.0,20,5,672,7.0,0.5959407091140747,0.07892747968435287
10460381,9159101,6668305,16007,14530,2015,10218,2003,1477,5789,1.0,1.0,15,9.0,196,10,0,2618.0,1.0,0.20725120604038239
10456140,5497933,6724597,16007,7376,1996,10337,2004,8631,5670,1.0,0.0,1304,5.0,112,7,0,2506.0,0.6482559442520142,0.2045844942331314
10461514,8585019,5975256,16007,13837,2013,8706,1999,2170,7301,0.0,0.0,10,2.0,23,8,161,728.0,0.25688114762306213,0.22961248457431793
10460215,8265252,4042764,16007,13403,2012,593,1977,2604,15414,0.14285714285714285,0.0,3,6.0,31,1,35,1603.0,0.48156091570854187,0.13850606977939606
10460379,5933816,7102105,16007,8615,1999,11205,2006,7392,4802,1.0,0.0,514,14.0,12,1,0,49.0,0.5714821815490723,0.314887136220932
10460295,6614930,4668456,16007,10106,2003,4163,1987,5901,11844,1.0,0.0,152,2.0,11,1,35,5138.0,0.22065198421478271,0.039280522614717484
10458942,8552771,7020287,16007,13795,2013,11044,2006,2212,4963,0.0,0.0,49,2.0,234,5,7,784.0,0.34512126445770264,0.24216854572296143
10463384,4526174,9484376,16014,3470,1985,14915,2016,12544,1099,1.0,0.0,772,3.0,2,5,0,84.0,0.5186906456947327,0.11577605456113815
10465871,7111957,4695771,16014,11226,2006,4282,1987,4788,11732,0.0,0.0,25,21.0,12,2,35,2037.0,0.27606815099716187,0.35024407505989075
10467610,6587525,6767326,16014,10043,2003,10435,2004,5971,5579,0.0,0.0,26,10.0,5,14,112,56.0,0.3016922175884247,0.15173645317554474
10466313,7028548,6390438,16014,11065,2006,9637,2002,4949,6377,0.5,0.0,4,9.0,5,7,301,742.0,0.34909993410110474,0.04021930694580078
10464757,7530455,8950036,16014,12185,2009,14285,2015,3829,1729,0.3333333333333333,0.0,8,2.0,5,7,147,1036.0,0.6250265836715698,0.2419000267982483
10467649,8756000,4277078,16014,14047,2014,2014,1981,1967,14000,0.0,0.0,3,16.0,3,3,840,280.0,0.35624194145202637,0.2499333918094635
10467288,6757517,5283947,16014,10407,2004,6613,1994,5607,9401,0.5,0.0,754,14.0,5,6,0,4298.0,0.3514314293861389,0.13010823726654053
10468267,5567243,4741879,16014,7600,1996,4506,1988,8414,11508,0.0,0.0,193,11.0,118,3,0,1085.0,0.4635245203971863,0.2528640031814575
10463350,5575293,4231557,16014,7628,1996,1769,1980,8386,14245,1.0,0.0,214,15.0,9,2,7,1708.0,0.5288609862327576,0.32382580637931824
10463742,5578315,6078103,16014,7635,1996,8937,2000,8379,7077,0.5,0.0,100,4.0,9,11,63,3500.0,0.42483246326446533,0.1586393564939499
10467979,9196239,5381966,16014,14572,2015,6956,1995,1442,9058,0.0,0.0,15,5.0,7,10,77,910.0,0.5416161417961121,0.054688990116119385
10466565,8482835,4030723,16014,13704,2013,537,1977,2310,15477,0.3333333333333333,0.0,17,29.0,175,2,0,42.0,0.6344993710517883,0.2616797387599945
10467286,8229159,8207849,16014,13354,2012,13326,2012,2660,2688,0.25,0.0,8,4.0,25,89,350,560.0,0.3144248127937317,0.17494626343250275
10463372,5163598,6230808,16014,6165,1992,9266,2001,9849,6748,1.0,0.0,571,9.0,7,7,0,189.0,0.5855178236961365,0.2653522789478302
10476053,5372395,7147895,16021,6921,1994,11303,2006,9100,4718,0.3333333333333333,0.0,18,7.0,6,18,1561,483.0,0.7083800435066223,0.12852510809898376
10470770,7207472,4797828,16021,11436,2007,4758,1989,4585,11263,0.5,0.0,732,22.0,5,4,0,938.0,0.640602707862854,0.2149469405412674
10471160,8840865,7414628,16021,14145,2014,11919,2008,1876,4102,1.0,0.0,5,4.0,4,7,63,798.0,0.5429880023002625,0.12048772722482681
10474723,7698267,5336494,16021,12521,2010,6795,1994,3500,9226,1.0,0.0,11,9.0,4,9,119,1057.0,0.17531368136405945,0.05797300487756729
10471828,4280151,4429406,16021,2028,1981,2952,1984,13993,13069,0.0,0.0,55,9.0,4,4,70,2128.0,0.409606397151947,0.27323514223098755
10470762,5626595,6525786,16021,7796,1997,9917,2003,8225,6104,1.0,0.0,737,20.0,43,3,7,119.0,0.2657613158226013,0.07489015907049179
10476706,9191245,4311290,16021,14565,2015,2210,1982,1456,13811,1.0,0.0,5,42.0,5,1,266,14.0,0.10495061427354813,0.19661827385425568
10474482,9971767,4347602,16021,15475,2018,2434,1982,546,13587,1.0,0.0,3,8.0,11,4,154,826.0,0.619625449180603,0.14556550979614258
10476984,6415323,4370027,16021,9679,2002,2581,1983,6342,13440,0.0,0.0,358,7.0,18,2,14,308.0,0.5620416402816772,0.1838352382183075
10474753,8015006,4615687,16021,13032,2011,3932,1986,2989,12089,1.0,0.0,309,2.0,242,2,7,7630.0,0.3576645255088806,0.0780196264386177
10471236,8235948,6504323,16021,13368,2012,9868,2003,2653,6153,1.0,0.0,24,18.0,75,5,21,1197.0,0.9991388320922852,0.07158403843641281
10474653,6816907,5347406,16021,10540,2004,6830,1994,5481,9191,1.0,0.0,87,5.0,10,2,35,7301.0,0.4404017925262451,0.1088203638792038
10470770,7150748,6958162,16021,11310,2006,10890,2005,4711,5131,0.5,0.5,562,4.0,9,2,0,2408.0,0.4868359863758087,0.019626559689641
10478157,5797898,5893683,16028,8272,1998,8503,1999,7756,7525,0.5,0.0,496,13.0,22,9,7,14.0,0.3980291485786438,0.0810258537530899
10478181,9030169,4783003,16028,14376,2015,4695,1988,1652,11333,0.0,0.0,100,14.0,9,16,7,2219.0,0.1187589019536972,0.2629653811454773
10478364,5775334,6925127,16028,8223,1998,10806,2005,7805,5222,1.0,0.0,28,8.0,10,14,105,1960.0,0.6162890195846558,0.15722419321537018
10482532,6615193,6747001,16028,10106,2003,10386,2004,5922,5642,1.0,0.0,76,4.0,7,1,28,1134.0,0.337923139333725,0.19403541088104248
10478719,6356867,6237077,16028,9567,2002,9273,2001,6461,6755,0.0,0.5,137,24.0,10,12,84,1281.0,0.21397195756435394,0.13431867957115173
10478241,4586923,6100906,16028,3778,1986,8986,2000,12250,7042,1.0,0.0,281,45.0,3,1,7,14.0,0.31896281242370605,0.03152196481823921
10481826,7831795,6322007,16028,12731,2010,9462,2001,3297,6566,1.0,0.0,106,3.0,139,5,0,112.0,0.39008593559265137,0.09137378633022308
10481963,6799195,4305164,16028,10498,2004,2175,1981,5530,13853,0.5,0.0,86,31.0,225,2,119,567.0,0.42861324548721313,0.18352122604846954
10479834,6960178,7314468,16028,10897,2005,11688,2008,5131,4340,0.25,0.3333333333333333,18,13.0,12,26,28,973.0,0.28419026732444763,0.012207239866256714
10478232,7194297,7045159,16028,11401,2007,11093,2006,4627,4935,1.0,1.0,41,9.0,43,7,70,182.0,0.3992026448249817,0.24223476648330688
10482398,7644859,4239051,16028,12430,2010,1811,1980,3598,14217,1.0,0.0,60,3.0,5,2,42,6692.0,0.426928848028183,0.2276734709739685
10481976,7476919,4246386,16028,12066,2009,1846,1981,3962,14182,0.0,0.0,53,13.0,7,1,14,1218.0,0.4209933280944824,0.12033253163099289
10485401,6475226,8789611,16035,9805,2002,14089,2014,6230,1946,1.0,0.0,203,1.0,20,8,35,1946.0,0.39555680751800537,0.34173089265823364
10486345,6113379,4157824,16035,9014,2000,1258,1979,7021,14777,0.3333333333333333,0.0,34,4.0,29,2,203,6909.0,0.5784537196159363,0.3064305782318115
10485757,6509323,4303960,16035,9882,2003,2161,1981,6153,13874,0.5,0.0,110,5.0,17,3,14,644.0,0.37360066175460815,0.06567463278770447
10488187,6398870,4458078,16035,9651,2002,3106,1984,6384,12929,0.5,0.0,4,3.0,5,2,4179,10689.0,0.5343143939971924,0.05720683932304382
10488398,7641611,4615812,16035,12423,2010,3932,1986,3612,12103,0.0,0.0,17,34.0,7,2,616,497.0,0.4508073329925537,0.3825572729110718
10485681,7423193,4984315,16035,11940,2008,5493,1991,4095,10542,0.3333333333333333,0.0,41,10.0,98,8,77,1568.0,0.3376084268093109,0.2451017051935196
10485443,9080918,7567167,16035,14439,2015,12262,2009,1596,3773,0.0,0.0,6,5.0,6,16,168,938.0,0.39225339889526367,0.3175569474697113
10491710,9030355,6103107,16035,14376,2015,8993,2000,1659,7042,0.0,0.0,15,5.0,23,2,182,4410.0,0.353485107421875,0.11001772433519363
10485539,7699844,4207719,16035,12528,2010,1629,1980,3507,14406,1.0,0.0,509,15.0,27,1,0,553.0,0.4134391248226166,0.3225601017475128
10487843,6280550,6588101,16035,9371,2001,10050,2003,6664,5985,0.0,0.0,31,4.0,24,12,35,3353.0,0.24718424677848816,0.20345167815685272
10486230,4375233,9279564,16035,2616,1983,14677,2016,13419,1358,0.5,0.0,32,1.0,2,10,28,1358.0,0.5947344303131104,0.3222370743751526
10485176,5636504,8807099,16035,7831,1997,14110,2014,8204,1925,0.5,0.0,17,1.0,3,5,0,1925.0,0.6802559494972229,0.14944882690906525
10486067,5527239,6394739,16035,7474,1996,9644,2002,8561,6391,0.0,0.0,193,7.0,35,7,49,700.0,0.5951391458511353,0.31469783186912537
10485597,6214012,4683344,16035,9231,2001,4226,1987,6804,11809,1.0,0.0,479,3.0,6,3,0,10682.0,0.49609053134918213,0.24801898002624512
10492782,4428376,5074759,16042,2952,1984,5836,1991,13090,10206,1.0,0.0,817,10.0,5,3,0,28.0,0.4498688280582428,0.16453871130943298
10495031,9074561,4533481,16042,14432,2015,3505,1985,1610,12537,0.6666666666666666,0.0,1,16.0,33,5,1610,2604.0,0.5472185611724854,0.10841377079486847
10492898,6582447,8353946,16042,10036,2003,13529,2013,6006,2513,1.0,1.0,172,5.0,9,257,21,273.0,0.5110824704170227,0.33562517166137695
10492880,6749609,5550232,16042,10393,2004,7544,1996,5649,8498,1.0,0.0,96,6.0,42,22,14,7196.0,0.6816600561141968,0.2041233479976654
10495379,6240744,4299982,16042,9287,2001,2140,1981,6755,13902,1.0,0.0,43,3.0,4,1,84,6713.0,0.6210877895355225,0.2105180025100708
10495792,6652954,6384558,16042,10190,2003,9623,2002,5852,6419,0.3333333333333333,0.0,28,14.0,13,6,203,742.0,0.6563846468925476,0.1409519761800766
10496797,5660176,5953020,16042,7908,1997,8657,1999,8134,7385,0.6666666666666666,0.0,457,25.0,29,5,14,707.0,0.21292585134506226,0.24247030913829803
10496815,9081958,10085437,16042,14439,2015,15615,2018,1603,427,0.5,0.0,6,1.0,1,3,21,427.0,0.36257287859916687,0.14401714503765106
10493469,4193538,7642808,16042,1538,1980,12423,2010,14504,3619,1.0,0.0,10,6.0,1,7,7,1057.0,0.5613188743591309,0.08496126532554626
10496803,9348802,4547458,16042,14754,2016,3575,1985,1288,12467,1.0,0.0,60,11.0,5,6,28,8827.0,0.372629314661026,0.2135474979877472
10498721,10063542,7145479,16042,15580,2018,11296,2006,462,4746,0.6666666666666666,0.0,1,5.0,3,5,462,21.0,0.5587224364280701,0.1843695193529129
10500990,8210610,4557544,16049,13333,2012,3631,1985,2716,12418,0.0,0.0,7,30.0,14,2,280,1358.0,0.43085408210754395,0.1811087429523468
10502639,9343346,4841831,16049,14747,2016,4926,1989,1302,11123,0.6666666666666666,0.0,3,8.0,4,3,140,182.0,0.687874436378479,0.21817529201507568
10501225,7137520,6831573,16049,11282,2006,10575,2004,4767,5474,0.5,0.0,77,5.0,13,17,147,210.0,0.5691688656806946,0.13740412890911102
10506298,5469431,5884425,16049,7264,1995,8482,1999,8785,7567,1.0,0.0,64,14.0,5,12,91,539.0,0.3732542395591736,0.14244911074638367
10503483,7882490,6104898,16049,12815,2011,8993,2000,3234,7056,0.5,0.0,15,7.0,23,3,112,2261.0,0.31982681155204773,0.19478058815002441
10504185,8065307,5945958,16049,13109,2011,8643,1999,2940,7406,1.0,0.0,47,16.0,48,5,21,21.0,0.21006964147090912,0.07672587037086487
10500633,6238183,9668811,16049,9280,2001,15132,2017,6769,917,0.2,0.0,21,1.0,4,1037,56,917.0,0.336538702249527,0.18782992660999298
10499914,8663245,9996697,16049,13942,2014,15503,2018,2107,546,1.0,0.0,153,2.0,323,101,7,77.0,0.29621344804763794,0.11402145028114319
10505961,7065587,4164000,16049,11128,2006,1314,1979,4921,14735,0.0,0.0,215,8.0,9,3,0,7602.0,0.4657163619995117,0.14997684955596924
10502203,8756991,4909476,16049,14054,2014,5192,1990,1995,10857,0.0,0.0,21,4.0,17,3,21,98.0,0.26221367716789246,0.3021894097328186
10503718,10135734,4185631,16049,15664,2018,1489,1980,385,14560,0.0,0.0,1,17.0,5,2,385,112.0,0.4135201573371887,0.21954740583896637
10502867,5385996,4335216,16049,6970,1995,2357,1982,9079,13692,0.3333333333333333,0.0,32,11.0,5,3,112,1267.0,0.32163676619529724,0.10116103291511536
10505969,10068095,7349702,16049,15587,2018,11772,2008,462,4277,1.0,0.5,8,10.0,20,4,35,112.0,0.7979744672775269,0.15686661005020142
10510485,7459817,4788100,16056,12024,2008,4716,1988,4032,11340,0.0,0.0,25,11.0,12,3,7,1988.0,0.44353538751602173,0.23953792452812195
10512118,re42536,7061963,16056,12976,2011,11121,2006,3080,4935,1.0,0.0,28,2.0,26,3,126,4536.0,0.5087855458259583,0.17618945240974426
10509972,7339149,7334550,16056,11751,2008,11744,2008,4305,4312,0.0,0.0,241,3.0,161,5,14,945.0,0.5665435791015625,0.38654008507728577
10507970,8657163,3978319,16056,13935,2014,243,1976,2121,15813,0.0,0.0,3,9.0,8,1,28,2093.0,0.46545469760894775,0.015090251341462135
10511913,5066091,8618772,16056,5801,1991,13879,2013,10255,2177,0.0,0.0,50,2.0,17,11,21,784.0,0.26511064171791077,0.27403387427330017
10507545,9358091,4136357,16056,14768,2016,1118,1979,1288,14938,0.25,0.0,2,16.0,17,2,462,5313.0,0.43214163184165955,0.34198498725891113
10514520,5645519,5604674,16063,7859,1997,7719,1997,8204,8344,0.0,0.0,145,4.0,2,4,21,210.0,0.3062684237957001,0.20385834574699402
10514754,8310656,5675785,16063,13466,2012,7950,1997,2597,8113,0.0,0.25,105,9.0,346,10,49,21.0,0.5293470025062561,0.20385493338108063
10513571,5567665,6104436,16063,7600,1996,8993,2000,8463,7070,1.0,0.0,16,12.0,4,1,497,280.0,0.6060045957565308,0.0844755470752716
10517194,8706315,6327002,16063,13991,2014,9469,2001,2072,6594,0.0,0.0,3,37.0,7,9,630,1036.0,0.6647645235061646,0.2638598680496216
10512476,4368040,5627020,16063,2567,1983,7796,1997,13496,8267,1.0,0.0,168,5.0,3,8,7,4599.0,0.3509046733379364,0.0979909598827362
10512548,5348788,5659078,16063,6837,1994,7901,1997,9226,8162,0.0,0.0,334,3.0,6,1,7,532.0,0.1455509513616562,0.012024465017020702
10515628,6678680,7012035,16063,10239,2004,11030,2006,5824,5033,0.6666666666666666,0.0,127,3.0,15,8,7,217.0,0.20466925203800201,0.13733433187007904
10516979,9294428,4713609,16063,14691,2016,4366,1987,1372,11697,1.0,0.0,8,25.0,16,7,126,168.0,0.9999998807907104,0.28499656915664673
10513437,6922455,7166081,16063,10799,2005,11345,2007,5264,4718,0.0,0.0,65,2.0,40,29,196,490.0,0.48923712968826294,0.08397256582975388
10517507,7640802,4172297,16070,12423,2010,1398,1979,3647,14672,0.0,0.5,99,13.0,9,3,0,126.0,0.23293933272361755,0.11767693608999252
10523726,6625750,6200309,16070,10127,2003,9203,2001,5943,6867,0.0,0.0,183,6.0,19,19,14,21.0,0.38001367449760437,0.22989150881767273
10518579,6609721,6956447,16070,10099,2003,10883,2005,5971,5187,0.5,0.0,6,3.0,6,5,56,1673.0,0.536710798740387,0.2149181365966797
10517577,5455766,5177344,16070,7215,1995,6214,1993,8855,9856,0.0,0.0,136,13.0,34,28,154,175.0,0.3565451204776764,0.3402400314807892
10517773,4795454,6939639,16070,4751,1989,10841,2005,11319,5229,1.0,0.0,489,2.0,21,2,14,2317.0,0.2655470669269562,0.1094280332326889
10517599,7308998,4916451,16070,11674,2007,5213,1990,4396,10857,1.0,0.0,796,7.0,252,9,0,987.0,0.4891819953918457,0.22676348686218262
10523087,7391134,5355314,16070,11863,2008,6858,1994,4207,9212,0.0,0.0,1,17.0,21,4,4207,1169.0,0.47647616267204285,0.15819156169891357
10518262,4304257,4277428,16070,2168,1981,2014,1981,13902,14056,0.5,0.0,71,8.0,3,1,84,161.0,0.35601672530174255,0.16310299932956696
10522934,6811436,5645565,16070,10533,2004,7859,1997,5537,8211,1.0,0.0,3,32.0,3,21,784,28.0,0.5970780253410339,0.4298402965068817
10517757,7082040,4811790,16070,11163,2006,4821,1989,4907,11249,0.5,0.0,11,21.0,21,4,273,3927.0,0.35409027338027954,0.20339104533195496
10521868,6850557,7064397,16070,10624,2005,11128,2006,5446,4942,0.14285714285714285,0.0,81,3.0,4,7,7,2639.0,0.1265072375535965,0.20339620113372803
10520559,9753097,5454447,16070,15223,2017,7215,1995,847,8855,0.5,0.0,4,11.0,46,2,266,1771.0,0.4006146788597107,0.1666218489408493
10518102,7994489,6458202,16070,13004,2011,9770,2002,3066,6300,1.0,0.0,3,8.0,8,7,224,343.0,0.46790727972984314,0.1939975470304489
10523903,8707414,5269269,16070,13991,2014,6557,1993,2079,9513,0.3333333333333333,0.0,2,21.0,167,3,518,2128.0,0.25586551427841187,0.2171197086572647
10521348,7693813,5863315,16070,12514,2010,8426,1999,3556,7644,0.5,0.0,183,7.0,108,11,7,4487.0,0.4427105188369751,0.21818006038665771
10525194,6382923,7939841,16077,9623,2002,12913,2011,6454,3164,0.5,0.0,247,8.0,31,3,0,329.0,0.40269580483436584,0.19417089223861694
10524691,6152933,6224546,16077,9098,2000,9252,2001,6979,6825,1.0,1.0,139,3.0,18,10,21,224.0,0.3456414043903351,0.4071904718875885
10526907,9897005,3993194,16077,15391,2018,327,1976,686,15750,0.3333333333333333,0.0,1,10.0,7,1,686,1575.0,0.3240622580051422,0.11671222746372223
10530839,5924069,4438009,16077,8594,1999,3001,1984,7483,13076,0.0,0.0,55,42.0,16,7,7,742.0,0.2656879127025604,0.037553571164608
10525469,7959877,8686940,16077,12948,2011,13970,2014,3129,2107,1.0,0.0,9,1.0,20,7,70,2107.0,0.38376379013061523,0.1704547107219696
10526758,6868641,6498991,16077,10673,2005,9854,2002,5404,6223,0.3333333333333333,0.0,30,27.0,14,7,182,28.0,0.4831056296825409,0.09562437981367111
10529387,4977542,8049300,16077,5458,1990,13088,2011,10619,2989,1.0,0.0,216,2.0,1,10,7,1323.0,0.3128495514392853,0.21474994719028473
10526484,6303533,4081707,16077,9420,2001,817,1978,6657,15260,0.5,0.0,15,17.0,5,1,49,147.0,0.36442726850509644,0.1564096212387085
10528275,6574709,5407727,16077,10015,2003,7047,1995,6062,9030,1.0,0.0,87,14.0,12,3,35,1960.0,0.5663474798202515,0.2912970185279846
10527516,7049976,5659078,16077,11100,2006,7901,1997,4977,8176,0.0,0.0,76,3.0,12,1,14,546.0,0.3640754818916321,0.12776713073253632
10525194,6077248,5286903,16077,8937,2000,6620,1994,7140,9457,0.5,0.0,28,3.0,8,1,35,7259.0,0.3587580621242523,0.22103111445903778
10524787,10314589,5869315,16077,15867,2019,8440,1999,210,7637,0.5,0.0,5,7.0,3991,2,28,2072.0,0.8075388073921204,0.1316758245229721
10535413,8179711,5112843,16084,13284,2012,5976,1992,2800,10108,1.0,0.0,88,5.0,23,2,42,84.0,0.5228497982025146,0.04461042582988739
10533946,4981977,4267830,16084,5479,1991,1965,1981,10605,14119,0.0,0.0,118,23.0,3,1,7,847.0,0.1786355972290039,0.05170080065727234
10531722,5778479,5571325,16084,8230,1998,7614,1996,7854,8470,0.5,0.0,16,10.0,1,7,28,224.0,0.31367358565330505,0.3449702858924866
10532177,4715915,5739286,16084,4380,1987,8139,1998,11704,7945,0.0,0.25,10,24.0,2,4,952,91.0,0.09586146473884583,0.11578400433063507
10534286,8135315,5910176,16084,13221,2012,8559,1999,2863,7525,1.0,0.0,1,16.0,20,3,2863,2926.0,0.4297701418399811,0.24533741176128387
10539923,6397029,4680760,16091,9644,2002,4212,1987,6447,11879,1.0,0.0,49,28.0,14,3,21,3430.0,0.5980691909790039,0.11701824516057968
10540530,8289183,4892707,16091,13438,2012,5122,1990,2653,10969,0.3333333333333333,0.0,43,22.0,43,2,21,252.0,0.6322048306465149,0.2327885925769806
10540159,6990666,5059229,16091,10981,2006,5773,1991,5110,10318,1.0,0.0,87,27.0,23,6,7,2961.0,0.4307035803794861,0.1190805584192276
10538111,6550997,4879907,16091,9973,2003,5066,1989,6118,11025,0.0,0.0,27,5.0,5,2,322,8575.0,0.4169218838214874,0.1606762856245041
10539589,5312510,6427144,16091,6711,1994,9707,2002,9380,6384,0.3333333333333333,0.0,10,2.0,5,13,707,3087.0,0.441331684589386,0.22884590923786163
10537451,6733513,5771240,16091,10358,2004,8209,1998,5733,7882,1.0,0.0,179,7.0,130,13,14,882.0,0.3809438645839691,0.08769313246011734
10537351,5603773,6059369,16091,7719,1997,8895,2000,8372,7196,0.0,0.0,152,29.0,3,4,7,42.0,0.18395908176898956,0.10072178393602371
10537423,5167628,5261015,16091,6179,1992,6522,1993,9912,9569,1.0,0.0,547,10.0,8,20,7,231.0,0.4645920991897583,0.2954689860343933
10538202,5822023,6194651,16091,8321,1998,9189,2001,7770,6902,0.0,0.0,193,11.0,12,3,91,231.0,0.530210018157959,0.24370360374450684
10540656,7624041,5971122,16091,12381,2009,8699,1999,3710,7392,1.0,0.0,35,13.0,7,8,14,182.0,0.3928926885128021,0.13452225923538208
10540391,6326982,9657102,16091,9469,2001,15118,2017,6622,973,0.5,0.0,252,6.0,14,21,21,42.0,0.5206381678581238,0.0762948989868164
10542974,7063671,4143811,16098,11128,2006,1167,1979,4970,14931,1.0,0.0,451,7.0,15,2,7,308.0,0.41563451290130615,0.28232160210609436
10548221,6921975,4749031,16098,10799,2005,4541,1988,5299,11557,0.3333333333333333,0.0,167,9.0,16,3,0,1680.0,0.3527551591396332,0.31765690445899963
10542992,7588174,3998250,16098,12311,2009,355,1976,3787,15743,1.0,0.0,764,5.0,53,1,0,8029.0,0.44152507185935974,0.20901280641555786
10543647,5599472,5180688,16098,7705,1997,6228,1993,8393,9870,0.5,0.0,22,10.0,72,12,84,4116.0,0.4945734739303589,0.2828560769557953
10542974,5713896,7204434,16098,8069,1998,11429,2007,8029,4669,1.0,0.0,1077,5.0,26,7,7,623.0,0.3798416554927826,0.36164620518684387
10546262,6047264,5275432,16098,8860,2000,6578,1994,7238,9520,1.0,0.0,533,32.0,1,6,7,1820.0,0.3680821657180786,0.07995584607124329
10543130,4639390,5402132,16098,4044,1987,7026,1995,12054,9072,0.0,0.0,42,16.0,2,4,7,805.0,0.24001508951187134,0.12385547906160355
10545582,5374942,7146546,16098,6928,1994,11296,2006,9170,4802,0.0,0.0,169,3.0,2,10,203,1785.0,0.3112718164920807,0.26559558510780334
10547738,8050389,9308984,16098,13088,2011,14712,2016,3010,1386,1.0,0.0,2,1.0,4,16,1701,1386.0,0.4201729893684387,0.2354060411453247
10542974,4429695,8447710,16098,2959,1984,13655,2013,13139,2443,1.0,0.0,1344,3.0,2,1,7,119.0,0.6442665457725525,0.1440970003604889
10544953,9546795,4068011,16098,14992,2017,740,1978,1106,15358,0.25,0.0,3,6.0,4,1,161,3010.0,0.5043284893035889,0.0502743273973465
10555091,5591679,4517091,16105,7677,1997,3421,1985,8428,12684,0.3333333333333333,0.0,67,13.0,6,8,112,952.0,0.35136693716049194,0.25531575083732605
10552271,8561065,7644726,16105,13802,2013,12430,2010,2303,3675,1.0,0.0,25,9.0,11,11,140,308.0,0.20661884546279907,0.14908847212791443
10548504,5244462,5873613,16105,6466,1993,8454,1999,9639,7651,1.0,0.0,935,2.0,4,2,7,4165.0,0.4696921408176422,0.22036957740783691
10548463,4464316,5854235,16105,3141,1984,8398,1998,12964,7707,0.0,0.3333333333333333,29,2.0,5,3,98,1645.0,0.26792415976524353,0.11365726590156555
10555077,9368105,7801650,16105,14775,2016,12682,2010,1330,3423,0.3333333333333333,0.3333333333333333,27,3.0,6,5,49,1001.0,0.3478187918663025,0.22724515199661255
10553214,7370275,4870641,16105,11814,2008,5017,1989,4291,11088,0.5,0.0,45,17.0,15,5,245,329.0,0.4021640717983246,0.1650211215019226
10548740,6645207,6849803,16105,10176,2003,10624,2005,5929,5481,1.0,0.0,426,16.0,15,8,7,189.0,0.6016108393669128,0.25343841314315796
10553102,8117676,4830209,16105,13200,2012,4884,1989,2905,11221,0.0,0.0,14,6.0,33,10,35,6790.0,0.26325723528862,0.026125825941562653
10552722,6378774,4831904,16105,9616,2002,4891,1989,6489,11214,0.3333333333333333,0.0,256,8.0,7,5,7,4459.0,0.7045117616653442,0.0937725305557251
10548741,6113637,4929482,16105,9014,2000,5262,1990,7091,10843,1.0,0.0,618,12.0,34,5,7,2002.0,0.5791138410568237,-0.006820923648774624
10550970,4815360,9687630,16105,4835,1989,15153,2017,11270,952,1.0,0.0,17,1.0,1,235,315,952.0,0.45374760031700134,0.2677742838859558
10549720,5895436,5573181,16105,8510,1999,7621,1996,7595,8484,0.3333333333333333,0.0,132,44.0,15,5,14,119.0,0.41187551617622375,0.2624860405921936
10552824,5991749,6965761,16105,8727,1999,10911,2005,7378,5194,0.6666666666666666,0.0,517,5.0,13,83,14,1183.0,0.23142822086811066,0.16903580725193024
10554748,7010598,6518015,16105,11023,2006,9903,2003,5082,6202,0.3333333333333333,0.0,230,3.0,5,7,14,700.0,0.4782900810241699,0.14842231571674347
10548467,5329935,8578953,16105,6774,1994,13830,2013,9331,2275,1.0,0.0,94,5.0,15,14,49,42.0,0.2998422086238861,0.169406920671463
10559010,7231651,4959247,16112,11485,2007,5381,1990,4627,10731,0.5,0.0,48,24.0,12,8,126,21.0,0.3266219198703766,0.11158300936222076
10560461,6922672,5518311,16112,10799,2005,7446,1996,5313,8666,0.5,0.0,84,27.0,30,1,0,77.0,0.37456628680229187,0.12134215980768204
10556123,5369831,7034510,16112,6914,1994,11072,2006,9198,5040,1.0,0.0,62,2.0,9,14,63,2590.0,0.2450198084115982,0.08929268270730972
10560621,7907750,4732023,16112,12857,2011,4464,1988,3255,11648,0.5,0.0,22,25.0,11,4,392,126.0,0.5812640190124512,0.22245027124881744
10555940,8580801,7593867,16112,13830,2013,12318,2009,2282,3794,0.5,0.0,5,7.0,22,3,357,126.0,1.0,0.10662443935871124
10556123,5109387,9335497,16112,5962,1992,14740,2016,10150,1372,0.0,0.0,18,2.0,3,1,63,273.0,0.26470017433166504,0.1686965525150299
10561894,7073852,8699522,16119,11149,2006,13984,2014,4970,2135,0.0,0.0,28,4.0,5,17,21,1274.0,0.21797682344913483,0.018691429868340492
10565235,9471606,10109038,16119,14901,2016,15636,2018,1218,483,1.0,0.5,3,2.0,46,2,294,126.0,0.44048675894737244,0.23261748254299164
10563042,4155855,6843829,16119,1237,1979,10610,2005,14882,5509,0.0,0.0,24,8.0,2,14,4459,826.0,0.3893139958381653,0.18795427680015564
10567509,6356949,6968964,16119,9567,2002,10925,2005,6552,5194,0.5,0.0,1013,16.0,28,15,0,315.0,0.47890040278434753,0.20959100127220154
10565858,6930596,4053473,16119,10820,2005,649,1977,5299,15470,0.3333333333333333,0.0,73,4.0,8,2,147,12327.0,0.4383489489555359,-0.039569366723299026
10567349,8918896,5599695,16119,14236,2014,7705,1997,1883,8414,0.5,0.0,26,10.0,8,3,140,175.0,0.40334784984588623,0.35295164585113525
10571063,5192165,9184671,16126,6277,1993,14558,2015,9849,1568,1.0,0.0,36,2.0,12,21,35,266.0,0.2925047278404236,0.11110344529151917
10569059,5114401,7048282,16126,5983,1992,11100,2006,10143,5026,1.0,0.0,103,2.0,21,7,49,1862.0,0.423616886138916,0.047688595950603485
10570696,8941278,4621676,16126,14271,2015,3967,1986,1855,12159,0.0,0.0,5,16.0,13,3,7,4123.0,0.23131391406059265,0.2561075985431671
10574399,7283531,4421475,16126,11611,2007,2910,1983,4515,13216,1.0,0.0,1,6.0,4,8,4515,567.0,0.5339798331260681,0.04092657193541527
10568624,9974541,4954332,16126,15482,2018,5360,1990,644,10766,1.0,1.0,10,42.0,20,12,7,1484.0,0.4197583496570587,0.09416791051626205
10570406,5387758,6645034,16126,6977,1995,10176,2003,9149,5950,1.0,0.0,49,3.0,4,2,133,847.0,0.542190670967102,0.14095278084278107
10568652,4278091,7797938,16126,2021,1981,12682,2010,14105,3444,1.0,0.0,397,7.0,4,18,0,812.0,0.42476895451545715,0.13151705265045166
10571641,6002331,6490241,16126,8748,1999,9833,2002,7378,6293,0.0,0.0,233,2.0,13,1,21,5684.0,0.3532310724258423,0.2203531265258789
10568481,7100234,8323383,16126,11205,2006,13487,2012,4921,2639,0.5,0.0,7,5.0,3,7,1183,196.0,0.47422438859939575,0.07001525163650513
10568625,9364217,5093037,16126,14775,2016,5906,1992,1351,10220,1.0,0.0,193,5.0,735,3,0,1239.0,0.5143128037452698,0.15184950828552246
10572064,9274660,4243617,16126,14670,2016,1832,1981,1456,14294,1.0,0.0,18,19.0,16,1,35,931.0,0.5681074857711792,0.10035282373428345
10574109,8551020,9648031,16126,13795,2013,15104,2017,2331,1022,0.0,0.0,11,1.0,303,5,56,1022.0,0.14644242823123932,0.21687005460262299
10574308,10129010,9451765,16126,15657,2018,14880,2016,469,1246,1.0,0.0,1,2.0,4,5,469,707.0,0.49043959379196167,0.160480797290802
10574432,6647506,4210769,16126,10176,2003,1643,1980,5950,14483,0.0,0.0,18,6.0,13,2,357,56.0,0.3725666403770447,0.29265281558036804
10580832,8766531,5698835,16133,14061,2014,8020,1997,2072,8113,1.0,0.0,11,17.0,19,7,210,1603.0,0.5553648471832275,0.3577931821346283
10582326,7835689,6502629,16133,12738,2010,9868,2003,3395,6265,0.3333333333333333,0.0,242,5.0,62,15,7,1547.0,0.5046811103820801,0.23403307795524597
10580412,10380208,5736787,16133,15930,2019,8132,1998,203,8001,0.6666666666666666,0.0,1,13.0,2,7,203,861.0,0.48506683111190796,0.2197226881980896
10576593,4871629,5274212,16133,5024,1989,6571,1993,11109,9562,0.0,0.5,59,4.0,6,3,308,917.0,0.3178936839103699,0.17802400887012482
10582386,9122964,4285145,16133,14488,2015,2063,1981,1645,14070,0.5,0.0,26,4.0,27,6,0,7434.0,0.28394344449043274,0.15758119523525238
10577137,5380393,4074799,16133,6949,1995,782,1978,9184,15351,0.0,0.0,23,31.0,6,1,63,959.0,0.6287393569946289,0.40024736523628235
10582562,6377790,7049518,16133,9609,2002,11100,2006,6524,5033,1.0,0.0,97,5.0,10,5,7,924.0,0.4183450937271118,0.25307920575141907
10581874,9921978,5422833,16133,15419,2018,7096,1995,714,9037,0.0,0.0,30,35.0,199,12,7,175.0,0.25142744183540344,0.3284044563770294
10576683,10112380,7475915,16133,15643,2018,12066,2009,490,4067,0.4,0.0,1,3.0,20,5,490,294.0,0.6803987622261047,0.2053193300962448
10580119,4703758,6829861,16133,4324,1987,10575,2004,11809,5558,0.3333333333333333,0.0,38,9.0,4,10,7,700.0,0.42543908953666687,0.31056270003318787
10583014,7048766,6928161,16140,11100,2006,10813,2005,5040,5327,1.0,0.0,76,16.0,18,3,49,350.0,0.5946905016899109,0.10780743509531021
10582928,8808274,4987479,16140,14110,2014,5500,1991,2030,10640,1.0,0.0,229,3.0,244,13,7,3661.0,0.3210678994655609,0.2716388702392578
10582964,5605150,5409536,16140,7726,1997,7054,1995,8414,9086,1.0,0.0,141,3.0,11,3,469,3493.0,0.4440136253833771,0.25559431314468384
10587031,7439930,4788893,16140,11982,2008,4723,1988,4158,11417,0.5,0.0,12,10.0,28,2,182,588.0,0.501070499420166,0.20539666712284088
10587930,7337457,7480367,16140,11744,2008,12073,2009,4396,4067,1.0,1.0,71,2.0,7,11,14,2646.0,0.46648311614990234,0.20715881884098053
10587916,8731966,7984507,16140,14019,2014,12983,2011,2121,3157,0.5,0.5,7,3.0,1,3,147,126.0,0.300292044878006,0.1768520176410675
10593683,5744864,7180691,16147,8153,1998,11373,2007,7994,4774,0.5,0.0,3227,2.0,5,3,0,3556.0,0.5471675395965576,0.20525923371315002
10593121,9374788,9845105,16147,14782,2016,15328,2017,1365,819,0.5,0.0,12,1.0,4,7,7,819.0,0.19541236758232117,0.18676838278770447
10588623,9119957,4158617,16147,14488,2015,1265,1979,1659,14882,0.5,0.0,306,15.0,39,3,0,7602.0,0.3056068420410156,0.2868153154850006
10588630,7673783,5250565,16147,12486,2010,6487,1993,3661,9660,1.0,0.5,834,26.0,328,1,0,2415.0,0.38444045186042786,0.18657907843589783
10593346,6782510,6430478,16147,10463,2004,9714,2002,5684,6433,0.0,0.0,272,4.0,35,6,0,1911.0,0.344645231962204,0.27842530608177185
10593761,7432524,6237487,16147,11968,2008,9280,2001,4179,6867,1.0,0.0,37,3.0,33,4,14,3129.0,0.5768947601318359,0.20878973603248596
10588936,6673901,8390022,16147,10232,2004,13578,2013,5915,2569,0.5,0.0,71,12.0,1,29,7,266.0,0.3634079098701477,-0.0735655352473259
10591251,5063677,8762636,16147,5794,1991,14054,2014,10353,2093,1.0,0.0,10,2.0,2,1,28,189.0,0.5008161664009094,0.23687531054019928
10588653,6039693,8020169,16147,8846,2000,13039,2011,7301,3108,1.0,0.0,81,8.0,118,9,161,21.0,0.5208316445350647,0.15391625463962555
10590566,5855619,4506592,16147,8405,1999,3372,1985,7742,12775,0.25,0.0,242,7.0,10,1,35,8323.0,0.24609176814556122,-0.05132642015814781
10588624,7886951,6369939,16147,12829,2011,9595,2002,3318,6552,1.0,0.0,589,11.0,55,4,0,903.0,0.5350764989852905,0.21740207076072693
10594386,8995415,10031503,16147,14334,2015,15545,2018,1813,602,0.5,0.0,3,1.0,1,1,238,602.0,0.30799832940101624,0.16670295596122742
10596228,9907832,4611810,16154,15405,2018,3911,1986,749,12243,1.0,0.0,1,23.0,2,7,749,1925.0,0.9972277879714966,0.048986028879880905
10595862,5320627,4785333,16154,6739,1994,4702,1988,9415,11452,1.0,0.0,318,1.0,3,2,7,11452.0,0.3744196593761444,0.24766020476818085
10601767,7337968,6576247,16154,11751,2008,10022,2003,4403,6132,0.5,0.0,97,5.0,40,13,7,994.0,0.4625696539878845,0.09552957117557526
10595862,5503635,4495452,16154,7397,1996,3309,1985,8757,12845,1.0,0.0,932,20.0,24,2,7,3633.0,0.482573002576828,0.04573670029640198
10597501,4474907,4279904,16154,3197,1984,2028,1981,12957,14126,0.0,0.0,13,5.0,3,2,903,11221.0,0.5153481364250183,0.1387668401002884
10599753,10257196,4456594,16154,15804,2019,3099,1984,350,13055,0.5,0.0,3,2.0,26,2,35,8022.0,0.4734800159931183,0.04153218865394592
10596665,8376433,7337742,16154,13564,2013,11751,2008,2590,4403,0.0,0.0,3,9.0,4,14,119,259.0,0.2354554980993271,0.2076951116323471
10596936,7905545,7326605,16154,12857,2011,11723,2008,3297,4431,0.0,0.0,8,6.0,10,1,273,1253.0,0.5032599568367004,0.07670656591653824
10595875,9629635,8510109,16154,15090,2017,13739,2013,1064,2415,1.0,0.0,1,7.0,182,22,1064,455.0,0.43283355236053467,0.19339168071746826
10599332,7724240,10068177,16154,12563,2010,15587,2018,3591,567,0.0,1.0,4,1.0,15,1,1197,567.0,0.658345103263855,0.23849883675575256
10600069,4959624,6043700,16154,5381,1990,8853,2000,10773,7301,0.0,0.5,41,2.0,3,4,259,6958.0,0.15007001161575317,0.06385734677314758
10599101,7286063,8160864,16154,11618,2007,13256,2012,4536,2898,0.0,0.3333333333333333,100,3.0,7,976,21,161.0,0.39692404866218567,0.2876358926296234
10597882,4926522,6249164,16154,5255,1990,9301,2001,10899,6853,0.0,0.0,48,10.0,8,11,0,1967.0,0.3531111478805542,0.27332761883735657
10599311,5812128,5246373,16154,8300,1998,6473,1993,7854,9681,1.0,0.0,32,7.0,5,3,119,1547.0,0.2885660231113434,0.17327940464019775
10597384,7476744,4461003,16154,12066,2009,3120,1984,4088,13034,0.5,0.0,10,17.0,36,2,301,1218.0,0.4274244010448456,0.07527590543031693
10597917,9234509,4485052,16154,14621,2016,3253,1984,1533,12901,0.0,0.0,3,7.0,10,1,77,105.0,0.4536195993423462,0.0011144320014864206
10595861,8162197,4771531,16154,13263,2012,4646,1988,2891,11508,1.0,0.0,628,23.0,260,3,7,581.0,0.3286736309528351,0.21801869571208954
10601883,5341476,7428541,16154,6809,1994,11954,2008,9345,4200,0.5,0.3333333333333333,60,24.0,3,10,168,7.0,0.5037420988082886,0.2455637902021408
10597270,6883201,9275967,16154,10708,2005,14670,2016,5446,1484,0.06666666666666667,0.0,334,1.0,86,11,0,1484.0,0.24163590371608734,0.18114356696605682
10596109,5871562,3986216,16154,8447,1999,292,1976,7707,15862,0.0,0.0,18,30.0,7,1,196,84.0,0.22988654673099518,0.12096260488033295
10600066,6577329,5863276,16154,10022,2003,8426,1999,6132,7728,0.0,0.0,256,9.0,18,5,7,1603.0,0.4065841734409332,0.1838415116071701
10605894,6069581,4079248,16161,8916,2000,803,1978,7245,15358,1.0,1.0,82,44.0,32,1,35,119.0,0.5193138718605042,0.26120030879974365
10606416,5248856,6336346,16161,6480,1993,9504,2002,9681,6657,0.0,0.0,89,9.0,18,18,0,1988.0,0.308694064617157,0.029554253444075584
10609832,6532152,4301908,16161,9931,2003,2154,1981,6230,14007,0.0,0.0,570,13.0,28,1,14,35.0,0.3576112985610962,0.17880979180335999
10604011,5069220,6287525,16161,5815,1991,9385,2001,10346,6776,0.3333333333333333,0.0,82,4.0,8,6,7,1211.0,0.29702091217041016,0.15550267696380615
10603035,9433420,4734419,16161,14859,2016,4471,1988,1302,11690,1.0,0.5,226,8.0,239,3,7,1596.0,0.5132483243942261,0.06712442636489868
10609805,5183646,4359989,16161,6242,1993,2518,1982,9919,13643,0.0,0.0,49,2.0,27,7,28,658.0,0.44289353489875793,0.29496821761131287
10608348,5625365,4633751,16161,7789,1997,4023,1987,8372,12138,0.5,0.0,59,11.0,3,5,42,2527.0,0.6185950636863708,0.27247801423072815
10607246,7770068,4946001,16161,12633,2010,5332,1990,3528,10829,0.5,0.0,16,11.0,11,6,14,1526.0,0.41563016176223755,0.21324899792671204
10604259,7874590,5387068,16161,12808,2011,6977,1995,3353,9184,0.5,0.0,4,18.0,6,19,1092,84.0,0.5161001086235046,0.37645015120506287
10605530,5665608,4657039,16161,7922,1997,4121,1987,8239,12040,0.5,0.0,65,15.0,4,14,0,196.0,0.36931172013282776,0.3193386495113373
10606344,7095401,4175759,16161,11191,2006,1426,1979,4970,14735,0.0,0.0,99,13.0,16,1,7,588.0,0.30400925874710083,0.15132194757461548
10615047,6429465,5022459,16168,9714,2002,5640,1991,6454,10528,0.5,0.0,62,33.0,4,3,7,189.0,0.3591264486312866,0.17477349936962128
10616507,4862037,6021909,16168,4989,1989,8804,2000,11179,7364,0.0,0.0,224,88.0,6,6,0,28.0,0.4829869866371155,0.22453151643276215
10610292,5599345,7367077,16168,7705,1997,11814,2008,8463,4354,1.0,0.0,668,7.0,61,5,0,133.0,0.36458820104599,0.2767190635204315
10610283,6447785,4209864,16168,9749,2002,1643,1980,6419,14525,1.0,0.0,43,19.0,7,2,483,742.0,0.23920884728431702,0.2668558657169342
10610136,4689149,6629528,16168,4254,1987,10141,2003,11914,6027,0.0,1.0,67,7.0,2,19,0,70.0,0.33967825770378113,0.19510550796985626
10610210,6123715,3986020,16168,9035,2000,285,1976,7133,15883,1.0,0.0,368,29.0,71,1,21,1246.0,0.49521633982658386,0.048036783933639526
10610380,6419677,4331327,16168,9693,2002,2336,1982,6475,13832,1.0,0.0,271,3.0,90,1,0,1806.0,0.5367069244384766,0.3283945620059967
10616627,8245269,4787659,16168,13375,2012,4716,1988,2793,11452,1.0,0.0,8,9.0,6,3,231,336.0,0.5157654881477356,0.2987698018550873
10610137,6180416,7159795,16168,9161,2001,11331,2007,7007,4837,0.0,0.0,489,23.0,9,41,0,112.0,0.560968816280365,0.2015260010957718
10621765,7634117,6120577,16175,12402,2009,9028,2000,3773,7147,1.0,0.0,32,11.0,3,21,21,2849.0,0.5436817407608032,0.17465740442276
10617417,7861906,6360935,16175,12787,2011,9581,2002,3388,6594,1.0,0.0,1028,2.0,471,28,0,133.0,0.6537333726882935,0.2279427945613861
10617414,9844375,7112143,16175,15328,2017,11226,2006,847,4949,1.0,0.0,259,19.0,2622,11,0,1071.0,0.3346146047115326,0.3253714442253113
10622375,6503826,7636759,16175,9868,2003,12409,2009,6307,3766,0.5,0.0,122,16.0,11,8,7,714.0,0.26975682377815247,0.2145664542913437
10621660,7313543,9651374,16175,11681,2007,15111,2017,4494,1064,1.0,0.0,146,1.0,20,23,0,1064.0,0.222371444106102,0.20184089243412018
10617416,8113405,5285360,16175,13193,2012,6613,1994,2982,9562,1.0,0.0,560,12.0,54,6,0,2163.0,0.47965288162231445,0.20093613862991333
10617412,8236020,4536005,16175,13368,2012,3519,1985,2807,12656,1.0,0.0,330,17.0,104,1,7,448.0,0.30855417251586914,0.11035890132188797
10617413,8960521,6684367,16175,14299,2015,10253,2004,1876,5922,1.0,0.0,472,7.0,4,16,0,938.0,0.4471779465675354,0.21738135814666748
10617302,9339211,8448776,16175,14747,2016,13662,2013,1428,2513,1.0,0.0,9,3.0,6,13,175,973.0,0.49409928917884827,0.14574991166591644
10617918,8257197,4854778,16175,13396,2012,4968,1989,2779,11207,1.0,0.0,43,13.0,5,8,0,1225.0,0.7223142385482788,0.3395010530948639
10617414,4821939,4323627,16175,4856,1989,2287,1982,11319,13888,0.0,0.0,828,7.0,4,3,0,2611.0,0.26652392745018005,0.24406002461910248
10617418,5354303,4491822,16175,6858,1994,3288,1985,9317,12887,0.5,0.0,736,4.0,11,3,0,3010.0,0.39135903120040894,0.35324832797050476
10622337,6207473,5395043,16175,9217,2001,7005,1995,6958,9170,0.5,0.0,44,19.0,4,4,7,63.0,0.31852999329566956,0.26116329431533813
10621372,6446089,5211248,16175,9742,2002,6347,1993,6433,9828,1.0,0.0,1297,18.0,12,8,0,497.0,0.5208894610404968,0.18903055787086487
10620545,6633365,5576511,16175,10148,2003,7628,1996,6027,8547,1.0,0.0,308,18.0,6,19,0,910.0,0.4164581596851349,0.2960542142391205
10617420,6926716,7801650,16175,10813,2005,12682,2010,5362,3493,1.0,0.0,1177,3.0,117,5,0,1071.0,0.4050862491130829,0.2708074450492859
10617743,6455250,5200015,16175,9763,2002,6305,1993,6412,9870,0.0,0.0,18,2.0,1,2,847,2478.0,0.4357683062553406,-0.023540692403912544
10624861,8920433,8829701,16182,14243,2014,14131,2014,1939,2051,0.5,0.0,189,5.0,5,8,0,84.0,0.22151616215705872,0.026743587106466293
10624561,8922342,4156129,16182,14243,2014,1237,1979,1939,14945,0.16666666666666666,0.25,20,4.0,6,1,133,4158.0,0.5888420343399048,0.2672501504421234
10624635,7090637,5533519,16182,11184,2006,7495,1996,4998,8687,1.0,1.0,844,19.0,23,4,0,28.0,0.48660415410995483,0.2183118760585785
10630170,8525501,4352550,16182,13760,2013,2469,1982,2422,13713,0.0,0.0,4,23.0,3,7,567,7847.0,0.5704196691513062,0.14409248530864716
10629681,7382001,4317882,16182,11842,2008,2252,1982,4340,13930,1.0,0.0,54,20.0,12,1,301,3689.0,0.6276029944419861,0.04702555015683174
10627370,6109108,8130673,16182,9007,2000,13214,2012,7175,2968,0.5,0.0,19,3.0,6,3,280,294.0,0.6696279644966125,0.08813885599374771
10625261,5770388,9449227,16182,8209,1998,14873,2016,7973,1309,0.3333333333333333,0.25,101,4.0,19,1,7,14.0,0.28821292519569397,0.09620527923107147
10624635,5937951,6353730,16182,8629,1999,9560,2002,7553,6622,0.0,0.0,700,14.0,36,15,0,91.0,0.43522951006889343,0.15728355944156647
10628238,5694603,9017083,16182,8006,1997,14362,2015,8176,1820,1.0,0.0,59,1.0,7,2,98,1820.0,0.5151156783103943,0.3383043706417084
10625137,5179792,4314897,16182,6228,1993,2231,1982,9954,13951,0.0,0.0,166,23.0,22,1,0,3206.0,0.2984052896499634,0.3124294579029083
10624812,8612061,4434458,16182,13865,2013,2980,1984,2317,13202,0.3333333333333333,0.25,5,3.0,34,1,399,7434.0,0.6083799600601196,0.5119520425796509
10626192,5512311,4350485,16182,7425,1996,2455,1982,8757,13727,0.0,0.0,10,10.0,17,2,329,483.0,0.31183305382728577,0.2335905283689499
10624780,5702438,4662022,16182,8034,1997,4142,1987,8148,12040,1.0,0.0,475,7.0,10,3,0,2758.0,0.41287359595298767,0.19817683100700378
10624679,8721689,4209864,16182,14012,2014,1643,1980,2170,14539,1.0,0.0,19,19.0,20,2,14,756.0,0.502313494682312,0.23529942333698273
10638107,9247779,6952789,16189,14642,2016,10869,2005,1547,5320,0.0,0.3333333333333333,19,10.0,3,5,0,1519.0,0.24395467340946198,0.14648368954658508
10631962,8672678,4955429,16189,13956,2014,5367,1990,2233,10822,1.0,0.0,11,10.0,25,4,14,511.0,0.4708119332790375,0.2366408109664917
10637912,6363065,5245318,16189,9581,2002,6466,1993,6608,9723,1.0,0.0,392,14.0,6,9,14,98.0,0.3910297155380249,0.3127495348453522
10632032,8769747,10096912,16189,14068,2014,15622,2018,2121,567,0.5,0.0,34,1.0,5,15,56,567.0,0.3064427375793457,0.1907939463853836
10631859,7648519,8405904,16189,12437,2010,13599,2013,3752,2590,1.0,0.0,617,2.0,68,6,7,938.0,0.6501266956329346,0.23582686483860016
10634462,7327549,7927114,16189,11723,2008,12892,2011,4466,3297,0.5,0.0,16,6.0,26,5,0,581.0,0.5235103368759155,0.2018861472606659
10637149,5955992,5602410,16189,8664,1999,7712,1997,7525,8477,0.5,0.5,356,8.0,31,7,35,5362.0,0.2211003303527832,0.11735327541828156
10632190,7318924,6378949,16189,11702,2008,9616,2002,4487,6573,0.3333333333333333,0.0,13,7.0,11,5,651,245.0,0.43572476506233215,0.06872037053108215
10635266,5634128,5677244,16189,7817,1997,7957,1997,8372,8232,1.0,0.0,78,24.0,1,6,42,280.0,0.45284271240234375,0.06999386847019196
10633139,8715449,4672956,16189,14005,2014,4184,1987,2184,12005,0.2,0.0,20,28.0,153,7,126,2548.0,0.5976845026016235,0.26571136713027954
10637068,6317248,4359156,16189,9448,2001,2511,1982,6741,13678,0.0,0.0,297,10.0,44,1,0,1197.0,0.22269901633262634,0.20682762563228607
10633135,7587259,4360521,16189,12304,2009,2518,1982,3885,13671,0.125,0.1111111111111111,7,2.0,24,4,490,13342.0,0.5454011559486389,-0.0021327671129256487
10635872,7775438,5116364,16189,12647,2010,5990,1992,3542,10199,1.0,0.0,8,3.0,4,2,35,4088.0,0.43344807624816895,0.28472012281417847
10634720,7949915,6686611,16189,12927,2011,10260,2004,3262,5929,1.0,0.0,4,2.0,12,7,434,3724.0,0.4261360466480255,0.104095958173275
10636635,6358382,6881217,16189,9574,2002,10701,2005,6615,5488,0.3333333333333333,0.0,4,2.0,2,6,1806,2352.0,0.41863560676574707,0.3477044999599457
10639108,5710870,6072519,16196,8055,1998,8923,2000,8141,7273,0.0,0.0,141,5.0,17,13,42,819.0,0.3002173900604248,0.17221298813819885
10642287,5580221,5365164,16196,7642,1996,6893,1994,8554,9303,0.3333333333333333,0.0,103,10.0,45,6,49,3269.0,0.5134638547897339,0.3074238896369934
10641731,5451343,5465395,16196,7201,1995,7250,1995,8995,8946,0.0,0.0,104,24.0,10,3,70,609.0,0.3077208399772644,0.21131086349487305
10643640,9466319,4805785,16196,14894,2016,4800,1989,1302,11396,0.5,0.0,30,12.0,7,6,49,700.0,0.6068190932273865,0.17602486908435822
10641777,5384261,5630370,16196,6963,1995,7810,1997,9233,8386,0.3333333333333333,0.0,518,10.0,18,3,0,322.0,0.20860804617404938,0.17372563481330872
10644887,7499548,9339189,16196,12115,2009,14747,2016,4081,1449,0.25,0.16666666666666666,10,1.0,10,4,511,1449.0,0.5316048860549927,0.13180851936340332
10644200,8368115,8977477,16196,13550,2013,14313,2015,2646,1883,1.0,0.0,19,3.0,86,3,91,70.0,0.7161090970039368,0.18703536689281464
10644216,5695557,5228456,16196,8013,1997,6410,1993,8183,9786,0.0,0.0,142,12.0,11,1,42,1736.0,0.468334823846817,0.31597691774368286
10638988,8002465,5641964,16196,13018,2011,7845,1997,3178,8351,0.3333333333333333,0.3333333333333333,81,2.0,29,1,7,7049.0,0.414773553609848,0.41251140832901
10642407,7982724,6724863,16196,12983,2011,10337,2004,3213,5859,1.0,0.0,7,31.0,5,1,0,126.0,0.5981007218360901,0.23874908685684204
10639542,9511274,6852937,16196,14950,2016,10631,2005,1246,5565,0.5,0.0,29,6.0,557,1,7,2457.0,0.34929344058036804,0.2358534187078476
10650189,5444843,4524288,16203,7173,1995,3456,1985,9030,12747,1.0,0.0,18,15.0,7,3,462,1204.0,0.43427330255508423,0.27456966042518616
10646219,5607095,7976492,16203,7733,1997,12976,2011,8470,3227,1.0,1.0,1068,35.0,33,342,7,7.0,0.6954646110534668,0.24529370665550232
10650940,5072228,4512261,16203,5822,1991,3400,1985,10381,12803,0.5,0.0,208,46.0,5,10,14,63.0,0.2624305188655853,0.1911698430776596
10651200,8259286,8022373,16203,13396,2012,13046,2011,2807,3157,0.0,0.0,3,8.0,18,1,196,21.0,0.17883270978927612,0.16429248452186584
10650313,7769996,8850569,16203,12633,2010,14152,2014,3570,2051,0.0,0.5,34,3.0,13,14,308,119.0,0.2109910547733307,0.13722066581249237
10646220,7823760,5487019,16203,12724,2010,7327,1996,3479,8876,1.0,0.0,587,6.0,324,3,7,2422.0,0.5633176565170288,0.18509908020496368
10647220,6209693,4472546,16203,9224,2001,3183,1984,6979,13020,1.0,0.0,5,7.0,5,4,1071,6391.0,0.34986189007759094,0.04550344869494438
10646283,6477400,6070338,16203,9805,2002,8923,2000,6398,7280,0.25,0.0,193,30.0,128,6,0,42.0,0.4296088218688965,0.16746549308300018
10647517,6116898,6555944,16203,9021,2000,9980,2003,7182,6223,0.0,0.0,1,13.0,2,5,7182,651.0,0.17248930037021637,0.2956324517726898
10652495,10321082,6329905,16203,15867,2019,9476,2001,336,6727,1.0,0.5,2,13.0,2,6,63,203.0,0.9999999403953552,0.34957802295684814
10649571,9305531,5488988,16203,14705,2016,7341,1996,1498,8862,0.0,0.0,10,8.0,13,3,7,3290.0,0.5108442306518555,0.0825764536857605
10657328,7403941,7094151,16210,11891,2008,11191,2006,4319,5019,0.5,0.0,132,3.0,16,4,14,63.0,0.19922170042991638,0.17209495604038239
10659187,7949038,7937591,16210,12927,2011,12906,2011,3283,3304,0.3333333333333333,0.3333333333333333,9,2.0,2,428,364,2128.0,0.441306471824646,0.33755648136138916
10658247,8841701,5769966,16210,14145,2014,8209,1998,2065,8001,1.0,0.0,162,6.0,2,8,7,210.0,0.5530230402946472,0.13969263434410095
10657330,6697779,4400308,16210,10281,2004,2791,1983,5929,13419,0.0,0.0,18,11.0,14,4,175,5236.0,0.14139677584171295,-0.03464458882808685
10658086,5677938,4242860,16210,7957,1997,1832,1981,8253,14378,1.0,0.0,17,8.0,12,4,476,6195.0,0.6221097707748413,0.16497381031513214
10654275,4403229,6083216,16210,2805,1983,8951,2000,13405,7259,0.0,0.0,29,27.0,2,22,154,987.0,0.5176301002502441,0.2628460228443146
10653408,8221428,4585533,16210,13347,2012,3771,1986,2863,12439,1.0,0.0,22,11.0,8,2,49,7455.0,0.510017454624176,0.2661232352256775
10658205,6423949,9253870,16210,9700,2002,14642,2016,6510,1568,0.3333333333333333,0.0,56,3.0,5,5,0,434.0,0.518295168876648,0.1537734866142273
10659619,9565074,6322007,16210,15013,2017,9462,2001,1197,6748,1.0,0.0,21,3.0,8,5,0,294.0,0.5469591617584229,0.19210611283779144
10653413,7954686,4724142,16210,12941,2011,4422,1988,3269,11788,1.0,0.5,811,4.0,300,2,7,3577.0,0.47133496403694153,0.20184950530529022
10662468,8481292,6343891,16217,13704,2013,9532,2002,2513,6685,0.25,0.0,114,13.0,5,24,0,1813.0,0.2970900535583496,0.10816895961761475
10665610,6933533,10005821,16217,10827,2005,15517,2018,5390,700,0.3333333333333333,0.0,59,1.0,44,1,266,700.0,0.6901325583457947,0.039907921105623245
10660701,5599295,4562593,16217,7705,1997,3652,1985,8512,12565,1.0,0.0,130,20.0,162,6,56,3976.0,0.4878059923648834,0.1806568056344986
10663935,5237169,4942981,16217,6438,1993,5318,1990,9779,10899,0.0,0.0,62,4.0,2,3,42,1995.0,0.5546700954437256,0.12760213017463684
10667410,6856151,9864430,16217,10638,2005,15349,2018,5579,868,0.0,0.0,41,2.0,23,9,56,77.0,0.4398767054080963,0.23022131621837616
10670375,6080493,4389714,16224,8944,2000,2728,1983,7280,13496,0.0,0.0,8,5.0,6,1,672,4361.0,0.254962295293808,0.09021247178316116
10670599,7262028,4166101,16224,11562,2007,1335,1979,4662,14889,0.3333333333333333,0.0,89,4.0,15,1,21,12075.0,0.6100437045097351,0.195621058344841
10673849,9825947,9480687,16224,15300,2017,14915,2016,924,1309,0.5,0.0,1,2.0,1,12,924,301.0,0.866619348526001,0.10464394837617874
10670246,6079862,6076606,16224,8944,2000,8937,2000,7280,7287,0.0,0.0,91,14.0,7,32,91,609.0,0.5992627143859863,0.16816896200180054
10669140,8606392,7730519,16224,13858,2013,12570,2010,2366,3654,0.07142857142857142,0.07142857142857142,70,3.0,43,21,0,2072.0,0.5447453856468201,0.307357519865036
10673229,6970365,8787099,16224,10925,2005,14082,2014,5299,2142,0.5,0.0,60,3.0,1,15,0,742.0,0.19038912653923035,0.25782132148742676
10669519,6566126,4161977,16224,10001,2003,1300,1979,6223,14924,0.5,0.0,25,45.0,23,2,35,252.0,0.3551480174064636,0.3005167543888092
10667765,10092236,6785905,16224,15622,2018,10470,2004,602,5754,0.25,0.0,1,14.0,12,5,602,112.0,0.6445513963699341,0.26072269678115845
10671289,8442059,9157109,16224,13648,2013,14530,2015,2576,1694,0.5,0.0,17,1.0,12,2,7,1694.0,0.39772018790245056,-0.0076549542136490345
10668773,4631831,5797897,16224,4016,1986,8272,1998,12208,7952,0.0,0.0,18,30.0,3,168,280,133.0,0.30338534712791443,0.28753259778022766
10668082,8257725,9254822,16224,13396,2012,14649,2016,2828,1575,1.0,0.0,154,2.0,39,7,7,777.0,0.35519081354141235,0.07715953141450882
10671705,5704875,10318655,16224,8041,1998,15867,2019,8183,357,0.2,0.4,55,5.0,2,211,42,231.0,0.21149279177188873,0.10876515507698059
10673202,5073041,9045168,16224,5829,1991,14397,2015,10395,1827,0.5,0.0,113,6.0,4,10,56,70.0,0.45075830817222595,0.26755431294441223
10668416,4481077,9257255,16224,3232,1984,14649,2016,12992,1575,0.0,0.0,86,2.0,3,2,35,329.0,0.321446031332016,0.13864074647426605
10667808,8132705,5554199,16224,13221,2012,7558,1996,3003,8666,1.0,0.0,353,2.0,332,7,7,4375.0,0.3620896637439728,0.07069554179906845
10667737,8126731,4539480,16224,13207,2012,3533,1985,3017,12691,0.5,0.0,21,10.0,46,5,14,2975.0,0.3502389192581177,0.16394519805908203
10667808,7007176,8077361,16224,11016,2006,13130,2011,5208,3094,0.0,0.0,282,2.0,14,4,7,574.0,0.1697462499141693,0.28682246804237366
10668178,5483127,5053077,16224,7313,1996,5752,1991,8911,10472,0.3333333333333333,0.0,22,7.0,8,11,42,2765.0,0.4610660672187805,0.11571569740772247
10677159,8887485,5181601,16231,14201,2014,6235,1993,2030,9996,1.0,0.0,6,43.0,41,13,203,1008.0,0.6146019697189331,0.20242545008659363
10680987,9191775,5819343,16231,14565,2015,8321,1998,1666,7910,1.0,0.0,3,17.0,2,20,434,112.0,0.490153431892395,0.11337991803884506
10679977,6429484,4782845,16231,9714,2002,4695,1988,6517,11536,1.0,0.0,152,9.0,23,1,28,98.0,0.2695615589618683,0.08328638225793839
10675024,5381782,4725133,16231,6956,1995,4429,1988,9275,11802,1.0,0.5,933,7.0,15,2,7,4004.0,0.26149529218673706,0.1142125055193901
10679293,8930204,7356335,16231,14250,2015,11786,2008,1981,4445,1.0,0.0,45,5.0,36,2,56,1771.0,0.32811155915260315,0.13524951040744781
10675021,7556185,10180934,16231,12241,2009,15720,2019,3990,511,1.0,0.0,868,1.0,37,58,7,511.0,0.37646275758743286,0.09276062250137329
10676033,8827294,10078610,16231,14131,2014,15601,2018,2100,630,1.0,0.0,22,2.0,132,14,0,336.0,0.6124170422554016,0.2892330288887024
10676681,7513988,5640545,16231,12150,2009,7838,1997,4081,8393,1.0,0.0,14,19.0,1,6,35,868.0,0.4878416657447815,0.23840583860874176
10680970,9471370,9314841,16231,14901,2016,14719,2016,1330,1512,0.0,0.0,1,2.0,54,9,1330,210.0,0.5195798277854919,0.2045474648475647
10686380,6927441,5309003,16238,10813,2005,6697,1994,5425,9541,0.0,0.0,77,2.0,9,10,0,5509.0,0.32277676463127136,0.1591566950082779
10683949,6202962,6784834,16238,9210,2001,10470,2004,7028,5768,0.5,0.0,46,4.0,2,4,21,3871.0,0.4834109842777252,0.1863871067762375
10687302,6256577,8022361,16238,9315,2001,13046,2011,6923,3192,0.0,0.0,204,7.0,7,1,28,56.0,0.40332743525505066,-0.027052275836467743
10682146,5366458,4868768,16238,6900,1994,5010,1989,9338,11228,1.0,0.0,302,9.0,22,5,0,4851.0,0.5356968641281128,0.1302768588066101
10682830,5604019,8433760,16238,7719,1997,13634,2013,8519,2604,0.5,0.0,25,2.0,36,12,525,14.0,0.4868262708187103,0.05271071940660477
10685133,7458508,10049467,16238,12024,2008,15566,2018,4214,672,0.5,0.3333333333333333,136,1.0,16,1,7,672.0,0.34403732419013977,0.1702495515346527
10687100,5910987,5109251,16238,8559,1999,5962,1992,7679,10276,1.0,0.0,1059,2.0,226,18,14,6475.0,0.17294283211231232,0.2818135619163513
10682141,4995959,4187572,16238,5535,1991,1503,1980,10703,14735,0.0,0.0,215,10.0,1,1,0,3031.0,0.24399787187576294,0.35018667578697205
10684239,6490029,8605531,16238,9833,2002,13858,2013,6405,2380,1.0,0.0,10,32.0,9,5,7,63.0,0.6202620267868042,0.11583469063043594
10685717,8559235,5366921,16238,13802,2013,6900,1994,2436,9338,1.0,0.0,344,10.0,3,10,0,56.0,0.5502784848213196,0.4011682868003845
10685526,9858781,4797921,16238,15342,2018,4758,1989,896,11480,0.75,0.25,12,15.0,1,2,0,511.0,0.518572986125946,0.3802200257778168
10683974,4340841,10342323,16238,2392,1982,15895,2019,13846,343,0.0,0.0,43,1.0,1,12,483,343.0,0.37460488080978394,0.14221611618995667
10681881,8533992,8954377,16238,13774,2013,14285,2015,2464,1953,0.3333333333333333,0.0,5,3.0,48,5,84,112.0,0.7736389636993408,0.18357522785663605
10693894,7826242,6987046,16245,12724,2010,10974,2006,3521,5271,0.0,0.0,13,3.0,39,2,483,2576.0,0.3073625862598419,0.22098293900489807
10688394,9208403,8937673,16245,14586,2015,14264,2015,1659,1981,0.25,0.0,8,7.0,5,5,35,287.0,0.3940146565437317,0.2074533849954605
10690821,5283690,5631151,16245,6606,1994,7810,1997,9639,8435,0.5,0.0,16,3.0,9,1,273,2289.0,0.49068689346313477,0.16649816930294037
10688235,5628908,5556941,16245,7803,1997,7565,1996,8442,8680,1.0,0.5,346,2.0,46,3,0,4921.0,0.6829212307929993,0.08376982063055038
10688294,4795426,7339889,16245,4751,1989,11751,2008,11494,4494,1.0,0.0,68,2.0,12,4,140,3045.0,0.30668380856513977,0.14463067054748535
10687813,7530984,4158848,16245,12185,2009,1265,1979,4060,14980,1.0,0.0,580,6.0,16,2,0,182.0,0.3770027458667755,0.44101622700691223
10688500,4330514,5006315,16245,2329,1982,5577,1991,13916,10668,0.2,0.0,44,9.0,5,3,21,560.0,0.10207958519458771,0.22717730700969696
10687806,8172120,4905482,16245,13277,2012,5178,1990,2968,11067,1.0,0.0,610,8.0,79,3,7,588.0,0.4545707702636719,0.18409763276576996
10687813,10219832,5315516,16245,15769,2019,6718,1994,476,9527,1.0,0.0,77,5.0,85,12,0,5586.0,0.4387750029563904,0.12020496279001236
10695057,8465502,5426170,16252,13683,2013,7110,1995,2569,9142,1.0,0.0,555,11.0,408,9,0,2184.0,0.4760146141052246,0.24023979902267456
10695055,8366787,7626604,16252,13550,2013,12388,2009,2702,3864,1.0,0.0,266,4.0,183,4,0,1834.0,0.33812588453292847,0.1517777442932129
10695598,4220172,4379814,16252,1706,1980,2658,1983,14546,13594,0.0,0.0,15,9.0,6,1,826,5278.0,0.4278796315193176,0.21483151614665985
10699069,7912701,4525933,16252,12864,2011,3470,1985,3388,12782,1.0,0.0,60,16.0,32,1,0,175.0,0.367914080619812,0.23955482244491577
10700686,8564070,6237005,16252,13809,2013,9273,2001,2443,6979,0.25,0.25,14,15.0,40,3,245,294.0,0.2130427062511444,0.1443718820810318
10695062,8356740,9771099,16252,13536,2013,15244,2017,2716,1008,0.3333333333333333,0.25,508,1.0,47,2,0,1008.0,0.46054768562316895,0.20928625762462616
10695764,6251343,4458657,16252,9308,2001,3113,1984,6944,13139,0.3333333333333333,0.0,319,18.0,40,5,7,7.0,0.2606765925884247,0.0027200342155992985
10695055,8132703,4326755,16252,13221,2012,2308,1982,3031,13944,1.0,0.0,721,6.0,49,1,0,1603.0,0.5511120557785034,0.1811620444059372
10696355,8651212,8904528,16252,13928,2014,14215,2014,2324,2037,0.0,0.0,28,3.0,9,18,140,1386.0,0.6239975690841675,0.12521976232528687
10695547,5688523,4345000,16252,7992,1997,2420,1982,8260,13832,1.0,0.0,23,62.0,12,4,168,182.0,0.2772321403026581,0.08397238701581955
10695344,6613798,4366155,16252,10106,2003,2553,1982,6146,13699,1.0,0.0,117,5.0,15,7,21,1834.0,0.5458732843399048,0.2891824245452881
10695105,7628799,7316800,16252,12395,2009,11695,2008,3857,4557,1.0,0.0,35,5.0,241,2,84,329.0,0.5391503572463989,0.14877553284168243
10694903,6634037,4859362,16252,10155,2003,4982,1989,6097,11270,1.0,0.0,21,7.0,7,9,98,3283.0,0.5112703442573547,0.1176336258649826
10695058,9510830,4592304,16252,14950,2016,3806,1986,1302,12446,1.0,0.0,238,7.0,2198,2,0,6405.0,0.33904775977134705,0.20000259578227997
10694660,6494151,4144780,16252,9847,2002,1174,1979,6405,15078,0.0,0.0,4,3.0,4,1,1190,1540.0,0.3654297888278961,0.35738638043403625
10702329,6024744,6038990,16259,8811,2000,8846,2000,7448,7413,1.0,0.0,383,8.0,15,1,14,994.0,0.5931933522224426,0.32564014196395874
10707802,8950181,5156319,16259,14285,2015,6137,1992,1974,10122,0.25,0.0,3,16.0,2,2,294,4627.0,0.5961638689041138,0.13710547983646393
10702629,10188777,7764252,16259,15734,2019,12626,2010,525,3633,0.3333333333333333,0.0,1,5.0,12,4,525,1169.0,0.3097471594810486,0.1962680220603943
10702267,5628745,8261669,16259,7803,1997,13403,2012,8456,2856,1.0,0.0,677,1.0,11,3,0,2856.0,0.18655923008918762,0.3391166627407074
10702339,7773785,4266191,16259,12640,2010,1951,1981,3619,14308,0.5,0.25,72,17.0,107,4,21,1533.0,0.5876398086547852,0.10995961725711823
10706814,10401952,4935742,16259,15951,2019,5283,1990,308,10976,0.25,0.0,3,13.0,17,3,21,847.0,0.4768235683441162,0.2137744277715683
10702528,7741494,6787790,16259,12591,2010,10477,2004,3668,5782,0.3333333333333333,0.0,11,5.0,83,1,63,3262.0,0.49805301427841187,0.04895978420972824
10702265,8038044,4430476,16259,13074,2011,2959,1984,3185,13300,1.0,0.0,116,17.0,40,4,28,6783.0,0.4618232250213623,0.2869557738304138
10706056,8386377,4917096,16259,13571,2013,5220,1990,2688,11039,0.5,0.0,116,53.0,21,8,7,91.0,0.2799714505672455,0.36169347167015076
10708727,6788766,5062142,16259,10477,2004,5780,1991,5782,10479,0.5,0.5,76,11.0,1,4,42,4144.0,0.43174463510513306,0.05101155862212181
10702193,5695623,4261306,16259,8013,1997,1930,1981,8246,14329,0.0,0.0,711,4.0,2,1,14,6860.0,0.4337397813796997,0.1501542329788208
10703284,5497305,9116971,16259,7369,1996,14481,2015,8890,1778,1.0,0.0,370,5.0,21,27,14,105.0,0.6068043112754822,0.16209843754768372
10705870,10331588,4618722,16259,15881,2019,3946,1986,378,12313,0.5,0.0,3,2.0,57,1,7,11249.0,0.29280972480773926,0.15981145203113556
10706956,8340914,4098401,16259,13508,2012,915,1978,2751,15344,0.3333333333333333,0.0,71,13.0,2,2,28,63.0,0.31550267338752747,0.008904996328055859
10702303,5052396,5146783,16259,5752,1991,6102,1992,10507,10157,1.0,0.0,64,26.0,3,5,203,819.0,0.512241005897522,0.2347514033317566
10702125,8166983,7177897,16259,13270,2012,11366,2007,2989,4893,0.5,0.0,4,21.0,52,37,7,168.0,0.4410862326622009,0.31678226590156555
10702267,5841284,8500728,16259,8363,1998,13732,2013,7896,2527,0.0,1.0,105,14.0,7,6,0,14.0,0.13112029433250427,0.38998618721961975
10706419,6494666,7404720,16259,9847,2002,11898,2008,6412,4361,0.0,0.0,20,21.0,13,3,35,735.0,0.09607772529125214,0.15755395591259003
10705701,7173637,4364951,16259,11359,2007,2546,1982,4900,13713,0.0,0.0,24,7.0,16,1,350,2751.0,0.4075356423854828,0.1824878454208374
10713648,8078532,4623487,16266,13130,2011,3974,1986,3136,12292,0.3333333333333333,0.0,27,24.0,37,3,56,1673.0,0.49939560890197754,0.06751354783773422
10714744,5882621,5555811,16266,8475,1999,7565,1996,7791,8701,1.0,0.0,44,8.0,13,6,0,3752.0,0.5429063439369202,0.24845987558364868
10715115,6310492,4799185,16266,9434,2001,4765,1989,6832,11501,1.0,0.0,15,9.0,9,12,602,6650.0,0.38757559657096863,0.3036494553089142
10709468,4522327,5361335,16266,3449,1985,6879,1994,12817,9387,1.0,0.0,863,5.0,8,18,0,6342.0,0.5595634579658508,0.20534522831439972
10715655,5815407,8173873,16266,8307,1998,13277,2012,7959,2989,0.25,0.0,54,3.0,120,6,217,532.0,0.47222816944122314,0.07489500939846039
10715970,5852775,4315812,16266,8391,1998,2238,1982,7875,14028,1.0,0.0,564,3.0,4,1,14,245.0,0.3753407597541809,0.2430041879415512
10709682,6045528,5776743,16266,8860,2000,8223,1998,7406,8043,0.3333333333333333,0.3333333333333333,146,16.0,32,1,21,4403.0,0.34577012062072754,0.30281203985214233
10710725,4566649,4639551,16266,3680,1986,4044,1987,12586,12222,0.0,0.0,26,10.0,2,2,6118,4746.0,0.4126068949699402,0.16697217524051666
10715835,4358672,5776967,16266,2504,1982,8223,1998,13762,8043,0.0,0.0,228,4.0,3,2,77,35.0,0.3614814877510071,0.08767576515674591
10714314,8278909,5007139,16266,13424,2012,5584,1991,2842,10682,0.0,0.0,24,13.0,14,4,7,1407.0,0.25631746649742126,0.14921914041042328
10709854,8021308,5505967,16266,13046,2011,7404,1996,3220,8862,1.0,1.0,28,13.0,11,3,14,1106.0,0.40499305725097656,0.0742095485329628
10715955,6182287,6388197,16266,9161,2001,9630,2002,7105,6636,1.0,0.0,166,7.0,14,14,28,2156.0,0.49860695004463196,0.13166537880897522
10714115,4741038,9258925,16266,4499,1988,14649,2016,11767,1617,0.3333333333333333,0.16666666666666666,95,1.0,5,23,14,1617.0,0.5536696910858154,0.18224398791790009
10709901,8033438,3975168,16266,13067,2011,229,1976,3199,16037,1.0,0.0,345,12.0,281,1,0,91.0,0.45954906940460205,0.1275475174188614
10713066,6772229,5429563,16266,10442,2004,7124,1995,5824,9142,1.0,0.0,842,53.0,17,5,7,7.0,0.4083783030509949,0.17145152390003204
10709479,5312410,5114994,16266,6711,1994,5983,1992,9555,10283,1.0,0.0,307,2.0,5,4,7,3479.0,0.36278030276298523,0.1963232457637787
10709446,5560532,6523807,16266,7579,1996,9917,2003,8687,6349,1.0,0.0,1352,5.0,77,17,7,2996.0,0.34211015701293945,0.10780182480812073
10715342,7822837,5558784,16266,12717,2010,7572,1996,3549,8694,0.0,0.0,229,4.0,17,8,21,1029.0,0.2113410085439682,0.4110720753669739
10710651,8393422,4482183,16266,13585,2013,3239,1984,2681,13027,0.3333333333333333,0.3333333333333333,15,13.0,211,2,98,315.0,0.3992246091365814,0.3324136435985565
10716732,4998863,4084703,16273,5549,1991,838,1978,10724,15435,0.0,0.0,40,11.0,8,1,238,441.0,0.5504467487335205,0.10523823648691177
10720916,8045348,5916779,16273,13081,2011,8580,1999,3192,7693,0.5,0.0,11,23.0,13,5,329,56.0,0.6295711398124695,0.1678915172815323
10716573,8828071,8478419,16273,14131,2014,13697,2013,2142,2576,1.0,1.0,14,3.0,323,9,105,203.0,0.43145886063575745,0.38090798258781433
10716804,4863907,4914308,16273,4996,1989,5206,1990,11277,11067,0.5,0.0,54,6.0,4,5,301,5992.0,0.42006421089172363,0.2034768909215927
10719223,5452367,5165297,16273,7201,1995,6172,1992,9072,10101,0.5,0.0,162,31.0,5,7,42,112.0,0.3847043812274933,0.15321968495845795
10716563,9750499,6532926,16273,15223,2017,9938,2003,1050,6335,1.0,0.0,288,4.0,2611,3,7,28.0,0.23892076313495636,0.124934121966362
10719199,7376587,8558902,16273,11828,2008,13802,2013,4445,2471,1.0,0.0,84,2.0,52,1,63,1806.0,0.32097041606903076,0.356128454208374
10718445,8439880,9266288,16273,13648,2013,14663,2016,2625,1610,0.3333333333333333,0.0,29,4.0,22,1,238,56.0,0.7492510080337524,0.30862781405448914
10722109,5174295,5847334,16280,6207,1992,8377,1998,10073,7903,1.0,0.0,207,8.0,4,2,49,854.0,0.29438522458076477,0.31914007663726807
10722232,4127227,7274001,16280,1062,1978,11590,2007,15218,4690,0.0,0.0,398,7.0,1,9,7,119.0,0.49296143651008606,0.22651353478431702
10725350,6256081,4380010,16280,9315,2001,2658,1983,6965,13622,1.0,0.0,108,3.0,7,2,77,112.0,0.46458902955055237,0.05754375830292702
10722721,8000805,5562325,16280,13011,2011,7586,1996,3269,8694,0.3333333333333333,0.0,60,10.0,96,7,42,280.0,0.3646584749221802,0.22741669416427612
10725362,8322858,5220225,16280,13487,2012,6375,1993,2793,9905,0.5,0.0,6,16.0,14,4,763,49.0,0.5519393682479858,0.29788392782211304
10723409,8550551,6902708,16280,13795,2013,10750,2005,2485,5530,0.3333333333333333,0.0,46,4.0,10,19,28,2352.0,0.32301077246665955,0.23074792325496674
10721987,4766614,5551909,16280,4625,1988,7551,1996,11655,8729,1.0,0.0,38,5.0,9,16,126,700.0,0.5992471575737,0.18461310863494873
10725581,7755612,5655499,16280,12612,2010,7894,1997,3668,8386,0.5,0.0,62,7.0,6,3,14,56.0,0.45317506790161133,0.3355242908000946
10726458,6154771,5482701,16280,9098,2000,7313,1996,7182,8967,1.0,0.0,622,6.0,25,4,14,1120.0,0.38239407539367676,0.08929044008255005
10727396,6319430,5106202,16280,9455,2001,5955,1992,6825,10325,0.0,0.0,19,15.0,1,14,70,245.0,0.41956546902656555,0.2055564969778061
10725829,6826745,4183639,16280,10561,2004,1475,1980,5719,14805,0.5,0.0,1372,12.0,13,3,7,7203.0,0.20909236371517181,0.16479675471782684
10725947,6161173,7320002,16280,9112,2000,11702,2008,7168,4578,1.0,1.0,31,5.0,9,7,112,1358.0,0.3262602984905243,0.18425047397613525
10722315,7686826,4410786,16280,12507,2010,2847,1983,3773,13433,1.0,0.0,850,5.0,64,3,0,6552.0,0.5426478385925293,0.12317012250423431
10724947,6246050,8440953,16280,9294,2001,13648,2013,6986,2632,0.25,0.0,69,2.0,10,1,63,14.0,0.45899084210395813,0.3731825649738312
10724499,8457911,6418150,16280,13669,2013,9686,2002,2611,6594,0.0,0.0,1,21.0,6,3,2611,7.0,0.5628307461738586,0.19244013726711273
10736219,8525687,8795253,16287,13760,2013,14096,2014,2527,2191,0.0,0.25,16,2.0,181,20,189,287.0,0.26524171233177185,0.3445281684398651
10729436,7472816,6808588,16287,12059,2009,10526,2004,4228,5761,0.5,0.0,747,4.0,33,13,0,56.0,0.7004743218421936,0.16177882254123688
10729651,8097614,4383456,16287,13165,2012,2693,1983,3122,13594,1.0,0.0,11,25.0,2,7,21,7077.0,0.5718457102775574,0.016823502257466316
10729658,6723343,5538828,16287,10337,2004,7509,1996,5950,8778,1.0,0.0,65,4.0,8,5,28,826.0,0.46326538920402527,0.3373066186904907
10732571,6241684,8047983,16287,9287,2001,13088,2011,7000,3199,0.0,0.0,215,2.0,10,189,7,49.0,0.22336336970329285,0.13085269927978516
10731410,9260913,8224159,16287,14656,2016,13347,2012,1631,2940,1.0,0.0,4,3.0,10,9,483,1302.0,0.5258811712265015,0.16359053552150726
10732407,5868951,4834744,16287,8440,1999,4898,1989,7847,11389,0.0,0.0,58,11.0,3,13,7,14.0,0.47200679779052734,0.23946493864059448
10730413,6793283,5335286,16287,10491,2004,6788,1994,5796,9499,0.0,0.0,18,14.0,15,13,42,168.0,0.5609246492385864,0.2546296715736389
10734446,9105838,6931576,16287,14467,2015,10820,2005,1820,5467,1.0,0.0,8,27.0,1,14,105,490.0,0.3109799325466156,0.2680189907550812
10735809,6928280,4295740,16287,10813,2005,2119,1981,5474,14168,0.5,0.0,288,7.0,22,2,21,105.0,0.2382182776927948,0.36565977334976196
10729501,7942303,4929405,16287,12920,2011,5262,1990,3367,11025,0.3333333333333333,0.0,789,3.0,410,6,0,623.0,0.5088555812835693,0.15435627102851868
10735105,8020043,9084165,16287,13039,2011,14439,2015,3248,1848,0.0,0.5,7,2.0,3,2,0,434.0,0.5098569989204407,0.3729686141014099
10734192,7786454,8740947,16287,12661,2010,14033,2014,3626,2254,0.0,0.0,12,2.0,1,36,77,119.0,0.4489334225654602,0.025790996849536896
10730061,4358056,4002791,16287,2504,1982,376,1977,13783,15911,0.5,0.0,63,7.0,1,1,203,4368.0,0.6183344721794128,0.3011346459388733
10733601,5768373,4303506,16287,8202,1998,2161,1981,8085,14126,0.0,0.0,110,29.0,6,1,0,3108.0,0.39692240953445435,0.26475024223327637
10735892,7423580,4391716,16287,11940,2008,2742,1983,4347,13545,0.0,0.0,126,22.0,3,1,0,357.0,0.29955172538757324,0.1549854725599289
10741753,8987134,4508553,16294,14327,2015,3379,1985,1967,12915,0.3333333333333333,0.0,2,13.0,3,2,7,2002.0,0.4031820297241211,0.26591458916664124
10740847,6049773,10282728,16294,8867,2000,15832,2019,7427,462,1.0,1.0,157,1.0,7,4,14,462.0,0.5065229535102844,0.39407026767730713
10740723,6785659,5240866,16294,10470,2004,6452,1993,5824,9842,1.0,0.0,120,29.0,146,1,77,427.0,0.31754425168037415,0.14570622146129608
10736848,5733925,6202248,16294,8125,1998,9210,2001,8169,7084,1.0,0.0,538,2.0,99,2,7,259.0,0.24404384195804596,0.11637189239263535
10736431,10413463,6867994,16294,15965,2019,10666,2005,329,5628,0.5,0.0,1,14.0,3,4,329,231.0,0.5574639439582825,0.24248842895030975
10738484,8397456,5195548,16294,13592,2013,6291,1993,2702,10003,1.0,0.0,10,11.0,17,4,70,147.0,0.3994455337524414,0.2215295433998108
10738711,8398757,5260133,16294,13592,2013,6522,1993,2702,9772,0.0,0.0,76,3.0,4,7,7,238.0,0.34963884949684143,0.1769668608903885
10741659,9865704,5703460,16294,15349,2018,8034,1997,945,8260,1.0,0.5,10,5.0,10,3,28,1785.0,0.5317893028259277,0.06485611945390701
10737171,9764230,9477244,16294,15237,2017,14908,2016,1057,1386,0.3333333333333333,0.0,4,2.0,8,1,182,1239.0,0.567568302154541,0.25944164395332336
10737002,5636643,5312183,16294,7831,1997,6711,1994,8463,9583,0.3333333333333333,0.0,1169,4.0,58,4,0,5292.0,0.4308747351169586,0.14064347743988037
10737628,6049453,4777070,16294,8867,2000,4667,1988,7427,11627,0.0,0.0,39,7.0,7,5,21,1057.0,0.27871811389923096,0.15312063694000244
10746752,6568447,4549756,16301,10008,2003,3589,1985,6293,12712,0.5,0.0,7,9.0,9,3,1218,3577.0,0.36198070645332336,0.23190641403198242
10750309,6092076,5637757,16301,8965,2000,7831,1997,7336,8470,0.3333333333333333,0.0,253,3.0,38,3,231,4634.0,0.2634604573249817,0.11980679631233215
10743983,4842601,5253751,16301,4926,1989,6501,1993,11375,9800,1.0,0.0,283,19.0,10,31,7,3206.0,0.5589670538902283,0.3097124993801117
10749582,7327795,4932171,16301,11723,2008,5276,1990,4578,11025,1.0,0.0,63,39.0,60,2,21,70.0,0.43486860394477844,0.07261175662279129
10748904,6373325,7846376,16301,9602,2002,12759,2010,6699,3542,0.3333333333333333,0.0,61,33.0,6,47,154,189.0,0.36394640803337097,0.12356147170066833
10743877,10420549,4802172,16301,15972,2019,4779,1989,329,11522,0.5,0.0,45,5.0,4121,4,0,7.0,0.5303699374198914,0.20337574183940887
10750309,7541977,4512301,16301,12206,2009,3400,1985,4095,12901,0.3333333333333333,0.0,25,4.0,4,5,413,5229.0,0.4643280804157257,0.10186789929866791
10747533,10324717,4143844,16301,15874,2019,1167,1979,427,15134,1.0,0.0,4,14.0,25,1,0,28.0,0.9999999403953552,0.26156583428382874
10744416,7027820,8910089,16301,11058,2006,14222,2014,5243,2079,0.0,0.0,19,4.0,20,3,14,1372.0,0.4026727080345154,0.28121885657310486
10743849,7407076,4790442,16301,11905,2008,4730,1988,4396,11571,1.0,0.0,718,28.0,125,11,7,1309.0,0.7268961668014526,0.204810231924057
10750309,6853955,4719643,16301,10631,2005,4394,1988,5670,11907,0.25,0.3333333333333333,111,22.0,37,7,21,1834.0,0.5556539297103882,0.21240654587745667
10748419,9754424,7939101,16301,15223,2017,12913,2011,1078,3388,0.0,0.0,30,3.0,308,3,0,14.0,0.41520053148269653,-0.11064372956752777
10743872,5944715,8432973,16301,8643,1999,13634,2013,7658,2667,0.3333333333333333,0.0,1092,4.0,280,4,0,469.0,0.45522308349609375,0.31556814908981323
10743849,6853879,9361243,16301,10631,2005,14768,2016,5670,1533,0.0,0.0,607,2.0,9,360,7,931.0,0.2753278613090515,0.21465632319450378
10743851,9642620,4602792,16301,15104,2017,3862,1986,1197,12439,1.0,0.0,267,23.0,1056,6,0,1078.0,0.6821003556251526,0.32402148842811584
10748443,7162385,7217495,16301,11331,2007,11457,2007,4970,4844,0.3333333333333333,0.0,2,6.0,2,10,2555,2807.0,0.1995132565498352,0.07818125188350677
10744316,5021059,4049699,16301,5633,1991,628,1977,10668,15673,0.5,0.0,943,3.0,6,1,21,9044.0,0.3826112747192383,0.09084475785493851
10747570,4980822,5340366,16301,5472,1990,6809,1994,10829,9492,1.0,0.0,91,9.0,8,6,63,6146.0,0.45945262908935547,0.002586804563179612
10744262,7371562,5011369,16301,11821,2008,5598,1991,4480,10703,0.0,0.0,12,14.0,112,2,0,2471.0,0.4171275496482849,0.13886705040931702
10748566,6771466,6267332,16301,10442,2004,9343,2001,5859,6958,1.0,0.0,42,17.0,2,17,119,623.0,0.208463653922081,0.15197373926639557
10744567,9981319,5639963,16301,15489,2018,7838,1997,812,8463,0.5,0.0,1,6.0,8,7,812,1085.0,0.49010345339775085,0.26799800992012024
10751040,9655624,10419681,16308,15118,2017,15965,2019,1190,343,1.0,0.0,288,2.0,2569,10,7,98.0,0.47434329986572266,0.3552446961402893
10751136,5971976,5647432,16308,8699,1999,7866,1997,7609,8442,1.0,0.0,326,14.0,4,9,7,378.0,0.422721803188324,0.174238920211792
10751509,7054228,5730327,16308,11107,2006,8118,1998,5201,8190,0.0,0.0,62,30.0,8,14,112,287.0,0.3627412021160126,0.26795220375061035
10751124,8257723,7987012,16308,13396,2012,12990,2011,2912,3318,1.0,0.0,2,2.0,27,16,483,2548.0,0.36066293716430664,0.20675674080848694
10757319,8358691,6070474,16308,13536,2013,8923,2000,2772,7385,0.5,0.0,19,6.0,7,3,133,4683.0,0.39999550580978394,0.08719249069690704
10755813,10085748,4508324,16308,15615,2018,3379,1985,693,12929,0.3333333333333333,0.0,228,12.0,2673,3,0,7336.0,0.3876635432243347,0.16034123301506042
10756242,7902566,6544350,16308,12850,2011,9959,2003,3458,6349,1.0,0.0,20,4.0,57,5,315,588.0,0.6396123170852661,0.07709389925003052
10760351,5125148,7443491,16315,6025,1992,11989,2008,10290,4326,0.0,0.0,21,7.0,4,6,63,1918.0,0.5506945252418518,0.138591468334198
10764977,5982159,7078750,16315,8713,1999,11156,2006,7602,5159,0.5,0.0,5,9.0,7,7,5978,973.0,0.3869452178478241,0.08436929434537888
10762732,8035478,7026295,16315,13067,2011,11058,2006,3248,5257,0.0,0.0,14,4.0,7,1,21,1911.0,0.3493783175945282,0.06970687955617905
10758323,5257203,7712441,16315,6508,1993,12549,2010,9807,3766,0.0,0.0,359,7.0,24,9,0,63.0,0.3158564567565918,0.002315956400707364
10762635,9145116,6505768,16315,14516,2015,9875,2003,1799,6440,0.0,0.0,41,20.0,12,149,7,7.0,0.46062445640563965,0.28278905153274536
10758289,6743255,7166081,16315,10379,2004,11345,2007,5936,4970,1.0,1.0,294,2.0,44,29,7,742.0,0.4463900029659271,0.3610185980796814
10758292,4976711,4429406,16315,5458,1990,2952,1984,10857,13363,1.0,0.0,1001,9.0,5,4,21,2422.0,0.12056304514408112,-0.01145203411579132
10759806,9388183,10352787,16315,14803,2016,15902,2019,1512,413,1.0,0.0,11,3.0,158,130,84,7.0,0.7318930625915527,0.13530686497688293
10771621,8428234,4104430,16322,13627,2013,943,1978,2695,15379,0.5,0.0,25,27.0,5,1,63,4144.0,0.3753172755241394,0.14663173258304596
10769393,9424454,10177468,16322,14845,2016,15713,2019,1477,609,1.0,0.0,2,2.0,125,3,1197,91.0,0.9986142516136169,0.21547548472881317
10770346,6204200,7111882,16322,9210,2001,11226,2006,7112,5096,1.0,0.0,223,11.0,5,25,14,49.0,0.4174799919128418,0.07856618613004684
10770286,10276355,4945336,16322,15825,2019,5325,1990,497,10997,0.5,0.0,34,9.0,1103,3,0,357.0,0.26407837867736816,0.08005812764167786
10771508,5548324,7608585,16322,7537,1996,12353,2009,8785,3969,0.5,0.0,31,2.0,3,1,490,2352.0,0.4685235619544983,0.16084949672222137
10767164,9163216,4299376,16322,14537,2015,2140,1981,1785,14182,0.5,0.0,2,6.0,16,1,224,987.0,0.272295743227005,-0.08684617280960083
10771743,7978838,9308899,16322,12976,2011,14712,2016,3346,1610,0.5,0.0,30,2.0,145,2,14,1225.0,0.46908557415008545,0.3352111279964447
10770336,8084372,4124907,16322,13144,2011,1048,1978,3178,15274,0.3333333333333333,0.0,87,43.0,1,1,0,455.0,0.29009491205215454,0.43636345863342285
10765367,9364181,8013200,16322,14775,2016,13032,2011,1547,3290,1.0,0.0,171,4.0,137,6,7,777.0,0.7234615683555603,0.009705462493002415
10767835,8791647,3971112,16322,14089,2014,208,1976,2233,16114,0.0,0.0,32,22.0,3,1,161,2905.0,0.37209853529930115,0.28950759768486023
10770916,8194061,5422568,16322,13305,2012,7096,1995,3017,9226,0.2,0.2,26,13.0,3,2,7,560.0,0.4646623730659485,0.22682009637355804
10765432,8973805,7427763,16322,14313,2015,11954,2008,2009,4368,1.0,0.5,188,8.0,10,3,0,399.0,0.446542352437973,0.27595946192741394
10765799,5577169,4571384,16322,7628,1996,3701,1986,8694,12621,0.5,0.0,121,9.0,9,2,28,1687.0,0.030271515250205994,0.06528687477111816
10769546,5430614,4261306,16322,7124,1995,1930,1981,9198,14392,0.25,0.0,112,4.0,2,1,378,6923.0,0.34894487261772156,0.23076096177101135
10769931,7113090,5534065,16322,11226,2006,7495,1996,5096,8827,0.5,0.0,392,2.0,22,5,7,8008.0,0.33913782238960266,-0.040371667593717575
10770870,8755184,4415967,16322,14047,2014,2875,1983,2275,13447,0.2,0.16666666666666666,11,10.0,12,1,14,5201.0,0.41376614570617676,0.14912591874599457
10766291,5583662,5307331,16322,7649,1996,6690,1994,8673,9632,0.2,0.0,29,7.0,3,7,98,2499.0,0.42363399267196655,0.44363993406295776
10779390,6429544,5065754,16329,9714,2002,5801,1991,6615,10528,0.0,0.0,20,23.0,19,53,84,49.0,0.43352025747299194,0.09131474047899246
10773275,5612081,6128875,16329,7747,1997,9049,2000,8582,7280,1.0,0.0,8,4.0,3,3,2821,196.0,0.32672932744026184,-0.001784570631571114
10774376,4661225,7466974,16329,4135,1987,12038,2008,12194,4291,0.5,0.0,11,6.0,2,3,756,308.0,0.16288752853870392,0.11340298503637314
10773677,9550469,6932318,16329,14999,2017,10827,2005,1330,5502,1.0,0.0,10,8.0,3,9,84,56.0,0.6567349433898926,0.21166890859603882
10775165,7788883,4960056,16329,12668,2010,5388,1990,3661,10941,0.0,0.0,92,7.0,6,7,28,3465.0,0.3049445152282715,0.0999353900551796
10776629,9036001,9201313,16329,14383,2015,14579,2015,1946,1750,0.2,0.0,52,3.0,41,10,7,294.0,0.38150754570961,0.16604769229888916
10776329,9766987,5685715,16329,15237,2017,7985,1997,1092,8344,1.0,0.0,7,46.0,116,1,476,105.0,0.2972502112388611,0.19239595532417297
10772629,7506791,4787691,16329,12136,2009,4716,1988,4193,11613,1.0,0.0,1377,37.0,385,10,0,448.0,0.5981989502906799,-0.03770753741264343
10777472,9053527,4054798,16329,14404,2015,656,1977,1925,15673,0.0,0.0,51,12.0,270,1,182,9653.0,0.296028733253479,0.20180609822273254
10774616,5180018,5184811,16329,6228,1993,6249,1993,10101,10080,0.0,0.0,5,17.0,1,3,1582,434.0,0.5518378019332886,0.2636040449142456
10774382,7264929,6343276,16329,11569,2007,9525,2002,4760,6804,0.3333333333333333,0.0,316,7.0,133,5,0,196.0,0.21161508560180664,0.11410591006278992
10778912,8520921,3990241,16329,13753,2013,313,1976,2576,16016,0.0,0.0,4,9.0,5,1,0,6132.0,0.2654215693473816,0.2234792560338974
10785319,5109278,6720964,16336,5962,1992,10330,2004,10374,6006,0.5,0.0,134,16.0,9,20,21,231.0,0.3045991361141205,0.18762809038162231
10784422,5894108,7046368,16336,8503,1999,11093,2006,7833,5243,1.0,0.0,337,4.0,10,4,105,1519.0,0.348352313041687,0.3445174992084503
10779825,5425745,4086724,16336,7110,1995,852,1978,9226,15484,0.5,0.0,1430,30.0,57,1,0,1239.0,0.46094247698783875,0.26842373609542847
10779815,6506190,7111882,16336,9875,2003,11226,2006,6461,5110,1.0,0.0,579,11.0,15,25,21,63.0,0.6400430202484131,0.21912556886672974
10780880,8849494,8155461,16336,14152,2014,13249,2012,2184,3087,0.25,0.0,100,3.0,19,3,14,987.0,0.5857872366905212,0.15789557993412018
10779826,7753904,4160203,16336,12612,2010,1279,1979,3724,15057,0.5,0.0,949,4.0,527,1,0,6090.0,0.6114835739135742,0.07826341688632965
10779903,7944175,5282548,16336,12920,2011,6606,1994,3416,9730,0.0,0.0,644,16.0,11,2,0,280.0,0.17857196927070618,0.21564702689647675
10779822,7083619,5071468,16336,11170,2006,5822,1991,5166,10514,1.0,0.0,1071,21.0,116,10,0,420.0,0.2561846971511841,0.10013894736766815
10779963,8180461,4918678,16336,13284,2012,5220,1990,3052,11116,1.0,0.0,44,21.0,36,13,49,3297.0,0.44996577501296997,0.1563211977481842
10781991,5967647,3999130,16336,8692,1999,355,1976,7644,15981,0.0,0.0,23,4.0,1,1,2331,7889.0,0.6387469172477722,0.2984870970249176
10779825,10201365,8509114,16336,15748,2019,13739,2013,588,2597,0.5,0.0,146,14.0,822,13,0,7.0,0.6302374005317688,0.10077928006649017
10779827,5662258,10250368,16336,7915,1997,15797,2019,8421,539,1.0,0.0,1303,1.0,32,2,0,539.0,0.5405641794204712,0.060857709497213364
10791471,8229394,4007485,16343,13354,2012,404,1977,2989,15939,1.0,1.0,135,9.0,2,1,7,9373.0,0.4665887653827667,0.17290903627872467
10786253,8910846,5281231,16343,14229,2014,6599,1994,2114,9744,1.0,1.0,263,17.0,10,12,7,77.0,0.560027539730072,0.30303552746772766
10786175,6961603,4890714,16343,10897,2005,5115,1990,5446,11228,1.0,0.0,10,9.0,16,3,1008,1617.0,0.5342991352081299,0.2875317335128784
10789821,8204273,4422583,16343,13319,2012,2917,1983,3024,13426,0.6666666666666666,0.0,30,15.0,36,2,105,4277.0,0.429016649723053,0.18078361451625824
10791176,6772394,10252750,16343,10442,2004,15804,2019,5901,539,0.0,0.0,125,1.0,23,8,0,539.0,0.45249268412590027,0.05353403091430664
10786253,10376262,7584638,16343,15930,2019,12304,2009,413,4039,0.3333333333333333,0.0,61,2.0,340,4,7,3612.0,0.6937000155448914,0.4360848367214203
10791138,9912691,8566426,16343,15405,2018,13809,2013,938,2534,0.6666666666666666,0.5,58,3.0,221,18,7,301.0,0.41591396927833557,0.1968868374824524
10789211,8086652,5539014,16343,13144,2011,7509,1996,3199,8834,1.0,0.0,79,19.0,8,9,7,476.0,0.5307616591453552,0.09661257266998291
10786290,5752953,8242820,16343,8174,1998,13375,2012,8169,2968,1.0,0.0,4,7.0,1,1,2289,14.0,0.5190885663032532,0.15996792912483215
10785950,7884262,5490569,16343,12822,2011,7348,1996,3521,8995,0.3333333333333333,0.0,647,21.0,7,11,28,28.0,0.2075771540403366,0.10179103910923004
10786736,6639609,8984423,16343,10162,2003,14320,2015,6181,2023,0.0,0.0,7,2.0,3,4,168,917.0,0.20820669829845428,0.2691780626773834
10791168,9680708,8698851,16343,15139,2017,13984,2014,1204,2359,0.5,0.0,5,2.0,25,1,98,1078.0,0.3636776804924011,0.17318180203437805
10792166,5772661,6982710,16350,8216,1998,10960,2006,8134,5390,1.0,0.0,916,66.0,126,7,0,21.0,0.5851277709007263,0.2255406230688095
10792092,7226447,8740300,16350,11478,2007,14033,2014,4872,2317,1.0,0.0,102,4.0,128,18,70,98.0,0.4513271152973175,0.23482972383499146
10793675,4443592,4709589,16350,3029,1984,4352,1987,13321,11998,1.0,0.0,13,15.0,2,6,574,35.0,0.7608872652053833,0.2372606098651886
10796887,5313481,6073883,16350,6711,1994,8930,2000,9639,7420,0.3333333333333333,0.0,163,42.0,11,4,7,203.0,0.3429000973701477,0.1298290491104126
10792092,6607529,5735021,16350,10092,2003,8132,1998,6258,8218,1.0,0.0,153,14.0,13,6,14,588.0,0.6347448825836182,0.2216484248638153
10797060,10121794,4466683,16350,15650,2018,3155,1984,700,13195,1.0,0.0,2,6.0,30,4,7,5775.0,0.6133390069007874,0.2070450484752655
10793086,5978017,5438525,16350,8706,1999,7152,1995,7644,9198,0.25,0.0,140,7.0,10,6,7,77.0,0.5896728038787842,0.2650598883628845
10794549,7387402,6758922,16350,11856,2008,10414,2004,4494,5936,1.0,0.0,11,4.0,31,16,336,2114.0,0.41156962513923645,0.2827514410018921
10796922,6162302,6501611,16350,9119,2000,9861,2002,7231,6489,0.3333333333333333,0.0,91,7.0,12,22,28,4221.0,0.20758718252182007,0.14328549802303314
10797055,8570803,5201164,16350,13816,2013,6312,1993,2534,10038,0.5,0.0,103,16.0,63,5,14,868.0,0.7028089165687561,0.11214400827884674
10794128,6752044,4077584,16350,10400,2004,796,1978,5950,15554,0.0,0.0,21,11.0,3,1,469,2492.0,0.4605616331100464,0.33225035667419434
10795935,8055907,4409189,16350,13095,2011,2840,1983,3255,13510,1.0,0.0,37,3.0,10,4,140,9625.0,0.3567146956920624,-0.00868088100105524
10797758,7336929,4634735,16350,11744,2008,4023,1987,4606,12327,0.25,0.0,123,43.0,5,4,77,833.0,0.4278694689273834,0.09357306361198425
10796471,8006889,6272052,16350,13025,2011,9350,2001,3325,7000,0.5,0.5,802,26.0,17,8,7,168.0,0.46532154083251953,0.1785994917154312
10791928,5569219,6445622,16350,7607,1996,9742,2002,8743,6608,1.0,0.0,216,18.0,12,3,14,525.0,0.24456636607646942,-0.0020942355040460825
10799284,7267685,4022308,16357,11576,2007,495,1977,4781,15862,1.0,0.0,177,19.0,387,2,21,105.0,0.2503994107246399,0.18440045416355133
10802008,4399684,4806036,16357,2791,1983,4800,1989,13566,11557,1.0,0.0,30,8.0,1,6,623,1043.0,0.47752681374549866,0.024932177737355232
10800445,8825258,6542628,16357,14124,2014,9952,2003,2233,6405,0.0,0.0,88,18.0,50,5,21,35.0,0.33818453550338745,0.29385608434677124
10805451,5418837,5349844,16357,7082,1995,6844,1994,9275,9513,0.5,0.0,282,12.0,9,4,0,2583.0,0.3510892689228058,0.15285615622997284
10806008,5262678,9292405,16357,6529,1993,14691,2016,9828,1666,0.0,0.0,32,1.0,6,8,28,1666.0,0.31448304653167725,0.22268767654895782
10804516,6080507,5121605,16357,8944,2000,6011,1992,7413,10346,0.5,0.0,55,44.0,13,13,119,413.0,0.4179070293903351,0.17973431944847107
10806448,9999408,3987870,16364,15510,2018,299,1976,854,16065,1.0,0.0,294,7.0,103,1,7,686.0,0.40934592485427856,0.29503899812698364
10810322,7039654,7173508,16364,11079,2006,11359,2007,5285,5005,0.5,0.0,145,5.0,5,11,7,413.0,0.5305229425430298,0.17752216756343842
10806450,5782396,4072198,16364,8237,1998,768,1978,8127,15596,1.0,0.0,1520,5.0,35,1,0,448.0,0.3998035192489624,0.4757791757583618
10809877,9473592,6556565,16364,14901,2016,9980,2003,1463,6384,0.6666666666666666,0.3333333333333333,1,21.0,1,11,1463,2842.0,0.4003295302391052,0.18434542417526245
10807025,7610932,5420152,16364,12360,2009,7089,1995,4004,9275,0.0,0.0,26,4.0,103,2,49,4557.0,0.46748945116996765,0.012077312916517258
10806449,8430898,4007155,16364,13634,2013,404,1977,2730,15960,1.0,0.0,741,7.0,177,1,0,10290.0,0.44859805703163147,0.04489718750119209
10812913,9312744,4587050,16364,14712,2016,3778,1986,1652,12586,0.3333333333333333,0.0,5,12.0,3,3,154,7091.0,0.3277372717857361,0.0469963401556015
10807031,4671811,4983800,16364,4177,1987,5486,1991,12187,10878,1.0,0.0,33,4.0,8,2,539,4186.0,0.5674875378608704,0.15970531105995178
10809164,5939717,6429075,16364,8629,1999,9714,2002,7735,6650,0.3333333333333333,0.0,127,11.0,21,1,189,2485.0,0.2549527585506439,0.25187399983406067
10812361,7945736,4517091,16364,12920,2011,3421,1985,3444,12943,0.0,0.0,40,13.0,5,8,7,1211.0,0.4496559202671051,0.2500992715358734
10806448,9706981,6105314,16364,15174,2017,9000,2000,1190,7364,1.0,0.0,277,6.0,125,15,7,273.0,0.544383704662323,0.16586832702159882
10812167,10039012,6864042,16364,15552,2018,10659,2005,812,5705,1.0,0.0,1,31.0,2,15,812,1218.0,0.5374031066894531,0.28918617963790894
10812354,8683423,4228685,16364,13963,2014,1755,1980,2401,14609,0.5,0.0,20,12.0,14,3,434,3633.0,0.45598316192626953,0.19803619384765625
10809553,10121988,4027817,16364,15650,2018,523,1977,714,15841,1.0,0.0,5,18.0,2,3,203,889.0,0.6785273551940918,0.3141285479068756
10806477,4897651,9956677,16364,5143,1990,15461,2018,11221,903,0.0,0.0,134,3.0,4,124,28,434.0,0.3302135765552521,0.3247799873352051
10814107,5295977,4939321,16371,6655,1994,5297,1990,9716,11074,1.0,0.0,102,18.0,1,9,35,462.0,0.3712947368621826,0.24574975669384003
10813773,5865848,6595847,16371,8433,1999,10064,2003,7938,6307,1.0,0.0,694,8.0,35,25,0,581.0,0.6079568266868591,0.15929098427295685
10815903,6558041,6699916,16371,9987,2003,10288,2004,6384,6083,0.3333333333333333,0.0,20,3.0,12,8,721,119.0,0.30440932512283325,0.06464476138353348
10817945,4903201,4719709,16371,5164,1990,4401,1988,11207,11970,1.0,0.0,1197,23.0,11,5,0,21.0,0.2851080298423767,0.12631811201572418
10813641,10624630,10443722,16371,16182,2020,15993,2019,189,378,1.0,0.0,5,1.0,280,2,7,378.0,0.32298046350479126,0.30102774500846863
10813639,8157151,4534487,16371,13256,2012,3512,1985,3115,12859,1.0,0.0,1026,6.0,103,1,0,2191.0,0.3356230854988098,0.30487266182899475
10814980,6764446,7659343,16371,10428,2004,12458,2010,5943,3913,0.0,0.0,269,2.0,15,37,0,77.0,0.16030597686767578,0.18149255216121674
10813638,8771260,6673258,16371,14068,2014,10232,2004,2303,6139,1.0,0.0,149,5.0,953,24,7,630.0,0.6456363201141357,0.1281883865594864
10813764,5643293,10020381,16371,7852,1997,15531,2018,8519,840,1.0,0.0,202,4.0,1,14,0,91.0,0.40123432874679565,0.28026023507118225
10817826,8068930,5895881,16371,13116,2011,8510,1999,3255,7861,1.0,0.0,16,7.0,52,6,21,2009.0,0.4501641094684601,0.285507470369339
10817795,7351975,7789124,16371,11779,2008,12668,2010,4592,3703,0.0,0.0,207,7.0,3,5,28,182.0,0.20939813554286957,-0.0042992644011974335
10816551,5543524,4438825,16371,7523,1996,3008,1984,8848,13363,0.0,0.0,65,7.0,5,2,175,4312.0,0.33921077847480774,0.02972855418920517
10814083,6216691,7349210,16371,9238,2001,11772,2008,7133,4599,1.0,0.0,59,2.0,72,23,7,3619.0,0.5643332004547119,0.21369606256484985
10817606,6272641,8585741,16371,9350,2001,13837,2013,7021,2534,1.0,0.0,302,18.0,6,58,7,161.0,0.4531988501548767,0.06418561190366745
10813641,5474057,4803620,16371,7285,1995,4786,1989,9086,11585,1.0,0.0,943,20.0,21,3,0,4438.0,0.4939294457435608,0.24742867052555084
10813638,7936142,4548110,16371,12906,2011,3582,1985,3465,12789,0.0,0.0,233,4.0,6,3,7,7665.0,0.2682749629020691,0.3583422005176544
10814989,9650954,4468666,16371,15111,2017,3162,1984,1260,13209,1.0,0.0,2,1.0,7,2,371,13209.0,0.5770823359489441,0.20370681583881378
10821288,7899554,4175001,16378,12843,2011,1419,1979,3535,14959,1.0,0.0,73,5.0,190,2,42,1904.0,0.6899276375770569,0.07182987779378891
10820999,6599520,4904444,16378,10071,2003,5171,1990,6307,11207,1.0,0.0,61,2.0,1,4,21,6909.0,0.46722212433815,0.2803679406642914
10825286,8366555,4648031,16378,13550,2013,4079,1987,2828,12299,0.0,0.0,2,21.0,3,2,504,266.0,0.6072499752044678,0.26293209195137024
10822076,4304375,8024469,16378,2168,1981,13046,2011,14210,3332,0.5,0.0,33,5.0,3,11,105,882.0,0.349086731672287,0.24518141150474548
10820807,6044283,5820737,16378,8853,2000,8321,1998,7525,8057,0.3333333333333333,0.0,241,13.0,2,8,14,273.0,0.3391079306602478,0.1711106151342392
10820920,5662662,6836229,16378,7915,1997,10589,2004,8463,5789,1.0,0.0,1526,9.0,120,11,7,1946.0,0.42002224922180176,0.20876525342464447
10821699,5335532,4346737,16378,6795,1994,2434,1982,9583,13944,0.0,0.0,14,8.0,5,2,77,1561.0,0.18171069025993347,0.2437155693769455
10823003,8413773,4170550,16378,13613,2013,1377,1979,2765,15001,0.5,0.0,36,16.0,66,4,0,1092.0,0.2943917512893677,0.294864684343338
10822666,4155774,10005681,16378,1237,1979,15517,2018,15141,861,0.5,0.3333333333333333,10,2.0,3,14,1792,504.0,0.44763755798339844,0.20614290237426758
10830359,9151137,5409408,16385,14523,2015,7054,1995,1862,9331,0.5,0.0,2,2.0,10,1,616,6664.0,0.39066600799560547,0.09375596791505814
10831596,10439648,4643542,16385,15986,2019,4065,1987,399,12320,1.0,0.0,1,12.0,11,2,399,175.0,0.6102315783500671,0.20754241943359375
10828066,7875030,4738102,16385,12808,2011,4492,1988,3577,11893,1.0,0.0,31,9.0,3,2,105,7091.0,0.6869584918022156,0.1907949000597
10827980,6413393,3991425,16385,9679,2002,320,1976,6706,16065,0.2,0.3333333333333333,578,12.0,4,1,0,35.0,0.42330312728881836,0.06592756509780884
10828186,5954253,5401818,16385,8664,1999,7026,1995,7721,9359,0.0,0.0,80,15.0,37,2,21,2114.0,0.6142210364341736,0.12218405306339264
10832903,6125789,5078048,16385,9042,2000,5850,1992,7343,10535,0.3333333333333333,0.0,180,5.0,13,5,0,189.0,0.1901668906211853,0.3241424262523651
10833942,8983994,4181551,16385,14320,2015,1461,1980,2065,14924,0.5,0.0,20,7.0,6,1,0,343.0,0.19433170557022095,0.06732817739248276
10828087,7753909,4167040,16385,12612,2010,1342,1979,3773,15043,1.0,0.0,87,16.0,441,5,0,2002.0,0.5989915728569031,0.3559839427471161
10828098,5317952,6249147,16385,6732,1994,9301,2001,9653,7084,0.0,0.0,125,3.0,8,36,0,1897.0,0.2766805589199066,0.30448731780052185
10828059,6120519,4830209,16385,9028,2000,4884,1989,7357,11501,1.0,0.0,67,6.0,8,10,0,7070.0,0.32816281914711,0.15024594962596893
10828924,6679996,8132430,16385,10246,2004,13221,2012,6139,3164,0.0,0.14285714285714285,55,3.0,16,18,133,1302.0,0.4692339599132538,0.1807488203048706
10828027,6045560,4419793,16385,8860,2000,2903,1983,7525,13482,1.0,0.0,1535,2.0,52,1,14,11508.0,0.7493118047714233,0.27417999505996704
10828032,7485124,5171716,16385,12087,2009,6193,1992,4298,10192,0.16666666666666666,0.16666666666666666,427,17.0,72,9,0,2709.0,0.4455186128616333,0.17288631200790405
10830873,7161527,4995839,16385,11331,2007,5535,1991,5054,10850,0.5,0.0,20,9.0,2,6,217,196.0,0.3088417947292328,0.0924212783575058
10834577,7418253,9815969,16385,11926,2008,15293,2017,4459,1092,0.0,0.0,241,2.0,1,24,28,483.0,0.41596081852912903,0.05685365945100784
10828086,7341558,5911435,16385,11758,2008,8566,1999,4627,7819,0.5,0.0,35,2.0,30,7,0,6923.0,0.23215098679065704,0.03390319272875786
10828189,6706060,5910102,16385,10302,2004,8559,1999,6083,7826,0.5,0.5,46,13.0,3,19,35,637.0,0.631280779838562,0.20573528110980988
10827783,8528569,3974040,16385,13767,2013,222,1976,2618,16163,0.25,0.25,166,10.0,1,1,7,5145.0,0.38825589418411255,0.34624961018562317
10832818,7321862,6631494,16385,11709,2008,10141,2003,4676,6244,0.5,0.0,102,3.0,55,5,7,245.0,0.49928778409957886,0.15865950286388397
10831130,6144820,5692486,16385,9077,2000,8006,1997,7308,8379,1.0,0.0,18,4.0,4,4,616,4816.0,0.6237012147903442,0.23956435918807983
10828762,7048166,8144891,16385,11100,2006,13235,2012,5285,3150,1.0,0.0,2,3.0,10,2,3528,42.0,0.5358120799064636,0.24190382659435272
10828185,6010529,6117951,16385,8769,2000,9021,2000,7616,7364,1.0,0.0,154,7.0,54,5,7,3780.0,0.5799915194511414,0.3212319612503052
10835247,5423471,5281442,16392,7103,1995,6599,1994,9289,9793,1.0,0.0,906,11.0,45,7,0,1330.0,0.4882441759109497,0.25904324650764465
10839388,6044360,5512804,16392,8853,2000,7425,1996,7539,8967,0.5,0.0,580,8.0,16,7,0,266.0,0.4320772886276245,0.23598510026931763
10837059,6197506,4101575,16392,9196,2001,929,1978,7196,15463,1.0,0.0,176,11.0,42,1,7,5971.0,0.4712345004081726,0.23968786001205444
10840570,6942944,7406577,16392,10848,2005,11898,2008,5544,4494,0.3333333333333333,0.0,24,2.0,49,1,238,3507.0,0.5184682011604309,0.1659904420375824
10839302,8369967,4632640,16392,13550,2013,4016,1986,2842,12376,0.5,0.0,35,26.0,3009,5,7,6594.0,0.40044236183166504,0.2819269597530365
10839953,9687417,7511580,16392,15153,2017,12143,2009,1239,4249,0.0,0.0,15,2.0,7,15,84,3752.0,0.3950021266937256,0.2715192139148712
10835175,6938618,4230159,16392,10841,2005,1762,1980,5551,14630,0.0,0.0,39,6.0,69,1,56,8148.0,0.20673684775829315,-0.07375779747962952
10838264,8796069,8671771,16392,14096,2014,13956,2014,2296,2436,0.0,0.0,242,3.0,103,8,28,889.0,0.4554500877857208,0.2135949581861496
10841104,9215075,6826938,16392,14593,2015,10568,2004,1799,5824,0.25,0.0,65,2.0,446,9,0,672.0,1.0,0.24168026447296143
10835251,7143926,9469664,16392,11296,2006,14901,2016,5096,1491,1.0,0.5,1236,3.0,10,78,0,77.0,0.5377852320671082,0.14213909208774567
10835245,6835199,9956677,16392,10589,2004,15461,2018,5803,931,1.0,0.0,1375,3.0,33,124,0,462.0,0.42595717310905457,0.38068729639053345
10835247,10238386,8386137,16392,15790,2019,13571,2013,602,2821,0.5,0.0,124,12.0,3989,3,0,28.0,0.40979263186454773,0.09986872971057892
10838062,4957362,5239033,16392,5374,1990,6445,1993,11018,9947,0.3333333333333333,0.0,28,5.0,5,27,0,2072.0,0.4641791880130768,0.06447844207286835
10835290,7811328,6612235,16392,12703,2010,10106,2003,3689,6286,0.5,0.0,54,6.0,11,6,84,3472.0,0.34300246834754944,0.3505045175552368
10847295,5635889,10462764,16399,7824,1997,16007,2019,8575,392,0.5,0.0,83,1.0,35,1,0,392.0,0.5069085955619812,0.1738932728767395
10848807,5289476,6204920,16399,6627,1994,9210,2001,9772,7189,0.16666666666666666,0.0,187,29.0,9,6,0,21.0,0.17018665373325348,0.12898194789886475
10847365,6864041,5862463,16399,10659,2005,8419,1999,5740,7980,0.0,0.0,159,3.0,11,6,0,2065.0,0.4632876515388489,0.31712961196899414
10842982,9126028,6771827,16399,14495,2015,10442,2004,1904,5957,1.0,0.0,9,4.0,298,19,126,28.0,0.7207462191581726,0.11094339936971664
10847363,10453749,6834297,16399,16000,2019,10582,2004,399,5817,1.0,0.0,1,27.0,7,25,399,14.0,0.7647432088851929,0.18101507425308228
10842490,10271844,10408089,16399,15825,2019,15958,2019,574,441,1.0,0.0,140,1.0,31,1,0,441.0,0.5541704297065735,0.3150533437728882
10842552,5258005,6630288,16399,6515,1993,10141,2003,9884,6258,1.0,0.0,43,8.0,2,16,441,1841.0,0.49002349376678467,0.19721463322639465
10849193,5970542,5093037,16399,8699,1999,5906,1992,7700,10493,0.0,0.0,27,5.0,3,3,77,1512.0,0.5177431702613831,0.2984280586242676
10842995,7742612,4075834,16399,12591,2010,789,1978,3808,15610,0.5,0.0,3,5.0,9,1,364,3402.0,0.5376501679420471,0.18550455570220947
10849156,7499393,6086799,16399,12115,2009,8958,2000,4284,7441,1.0,0.0,55,10.0,3,46,42,427.0,0.5439515709877014,0.07201328128576279
10843885,7975901,9154011,16399,12976,2011,14523,2015,3423,1876,0.0,0.0,14,6.0,3,10,49,42.0,0.30525141954421997,0.26855918765068054
10846644,8386996,7701101,16399,13571,2013,12528,2010,2828,3871,1.0,0.0,8,3.0,7,9,217,1043.0,0.6282615065574646,0.059274718165397644
10842610,5604293,7215791,16399,7719,1997,11450,2007,8680,4949,0.5,0.0,64,5.0,2,10,798,2520.0,0.2196151316165924,0.035078078508377075
10842492,6993413,10225365,16399,10988,2006,15769,2019,5411,630,0.0,0.0,547,7.0,6,87,0,35.0,0.43980175256729126,0.038674551993608475
10842619,9119718,4387144,16399,14488,2015,2714,1983,1911,13685,1.0,0.0,37,16.0,4,17,14,2555.0,0.5599580407142639,0.11145501583814621
10844764,8938954,5109449,16399,14271,2015,5962,1992,2128,10437,0.5,0.0,19,18.0,64,7,420,2352.0,0.5332140922546387,0.20126460492610931
10852613,10585321,7208993,16406,16140,2020,11436,2007,266,4970,0.25,0.0,1,4.0,94,5,266,217.0,0.6093193292617798,0.13183949887752533
10855593,8804733,7464739,16406,14103,2014,12038,2008,2303,4368,1.0,0.0,24,2.0,9,1,42,2387.0,0.4496161937713623,0.20762495696544647
10856099,6700534,4398474,16406,10288,2004,2784,1983,6118,13622,0.6666666666666666,0.0,52,5.0,14,8,35,5607.0,0.473431795835495,0.09629730135202408
10853470,8140576,4735485,16406,13228,2012,4478,1988,3178,11928,1.0,0.0,34,15.0,8,9,28,10017.0,0.36291390657424927,0.18101383745670319
10854443,6048409,10389359,16406,8867,2000,15937,2019,7539,469,0.0,0.3333333333333333,38,1.0,10,2,154,469.0,0.43897631764411926,0.24619421362876892
10850057,4414973,8157517,16406,2875,1983,13256,2012,13531,3150,0.0,0.0,238,4.0,2,10,14,70.0,0.6470061540603638,0.3481776714324951
10854315,6586176,7794483,16406,10043,2003,12675,2010,6363,3731,0.0,0.0,102,7.0,6,19,7,98.0,0.511346697807312,0.1193532645702362
10849461,7318666,5259011,16406,11702,2008,6515,1993,4704,9891,0.3333333333333333,0.0,17,19.0,38,5,84,938.0,0.48584139347076416,0.22863095998764038
10854269,8964496,7914598,16406,14299,2015,12871,2011,2107,3535,1.0,0.0,253,6.0,30,11,0,343.0,0.5389319062232971,0.19184061884880066
10863181,9139633,6521397,16413,14509,2015,9910,2003,1904,6503,0.0,0.0,13,2.0,2,7,56,6251.0,0.13539054989814758,0.15006206929683685
10856847,8105941,8581914,16413,13179,2012,13830,2013,3234,2583,0.0,0.0,63,3.0,17,7,14,973.0,0.28925901651382446,0.10028670728206635
10858617,4501834,5530806,16413,3344,1985,7481,1996,13069,8932,0.0,0.0,61,3.0,5,4,294,385.0,0.4864603281021118,0.07091207057237625
10860095,5360971,8043317,16413,6879,1994,13081,2011,9534,3332,0.0,0.0,139,3.0,7,185,63,406.0,0.6350795030593872,0.15953730046749115
10860310,6802061,6825699,16413,10505,2004,10561,2004,5908,5852,1.0,0.0,122,15.0,66,6,42,1295.0,0.27910149097442627,0.16888777911663055
10856868,6500194,10024185,16413,9861,2002,15538,2018,6552,875,1.0,0.0,683,1.0,32,5,0,875.0,0.25830185413360596,0.1522517055273056
10857184,8956828,9451885,16413,14292,2015,14880,2016,2121,1533,1.0,0.2,50,1.0,23,5,28,1533.0,0.44170981645584106,0.022572018206119537
10857038,5911222,7530005,16413,8566,1999,12178,2009,7847,4235,1.0,0.0,208,4.0,14,2,14,2408.0,0.2686247229576111,0.11579354107379913
10859368,5528888,7635300,16413,7481,1996,12409,2009,8932,4004,0.0,0.0,98,2.0,2,5,56,3304.0,0.4697556793689728,0.18510082364082336
10863146,9053622,7209550,16413,14404,2015,11436,2007,2009,4977,0.5,1.0,135,2.0,34,8,7,3122.0,0.443419486284256,0.4691318869590759
10863558,8800044,6924878,16413,14096,2014,10806,2005,2317,5607,1.0,0.0,22,6.0,4,33,0,1155.0,0.27668386697769165,0.15110425651073456
10856973,6338735,4146464,16413,9511,2002,1181,1979,6902,15232,1.0,0.0,371,4.0,45,3,0,10430.0,0.6124468445777893,0.1759459674358368
10856929,9204891,7595172,16413,14586,2015,12325,2009,1827,4088,1.0,1.0,81,2.0,6,9,0,2275.0,0.25610074400901794,0.162253275513649
10856987,6451054,5663657,16413,9756,2002,7915,1997,6657,8498,1.0,0.0,177,30.0,39,11,0,1043.0,0.4806930124759674,0.009377812966704369
10865165,6764602,7125871,16420,10428,2004,11254,2006,5992,5166,0.6666666666666666,0.25,57,3.0,8,3,28,1078.0,0.2785796821117401,0.14624305069446564
10866922,6289448,9133820,16420,9385,2001,14502,2015,7035,1918,1.0,0.0,13,3.0,6,4,497,252.0,0.4698207676410675,0.07828604429960251
10865148,6531423,4684789,16420,9931,2003,4233,1987,6489,12187,0.5,0.0,61,32.0,8,6,105,336.0,0.35676711797714233,0.17111945152282715
10867327,7812711,7581503,16420,12703,2010,12297,2009,3717,4123,0.0,0.0,45,16.0,12,15,133,35.0,0.5380129814147949,0.2465682029724121
10867786,6981832,4209302,16420,10960,2006,1636,1980,5460,14784,0.5,0.0,117,40.0,22,1,0,714.0,0.3128575086593628,0.12015289068222046
10864183,5241059,4113651,16420,6452,1993,985,1978,9968,15435,0.0,0.0,103,8.0,6,1,14,2247.0,0.5570598840713501,0.17955176532268524
10868974,6116743,4316699,16420,9021,2000,2245,1982,7399,14175,0.0,0.0,420,16.0,24,7,7,70.0,0.3180941343307495,0.04849311336874962
10866915,6304088,4302853,16420,9420,2001,2161,1981,7000,14259,0.0,0.0,20,30.0,3,1,357,595.0,0.17498716711997986,0.17721012234687805
10869666,7377928,8915112,16427,11835,2008,14236,2014,4592,2191,0.3333333333333333,0.0,1044,2.0,38,3,0,406.0,0.4522967040538788,0.35195392370224
10873786,6662023,8834208,16427,10204,2003,14138,2014,6223,2289,0.5,0.0,666,4.0,10,24,21,1064.0,0.32464367151260376,0.17351017892360687
10870658,7572910,8564550,16427,12276,2009,13809,2013,4151,2618,0.5,0.0,8,9.0,6,3,224,581.0,0.6227702498435974,0.07912793010473251
10872641,6376884,7213351,16427,9609,2002,11450,2007,6818,4977,0.5,0.0,6,2.0,3,8,595,1806.0,0.5335253477096558,0.11489585041999817
10871036,5037212,4662100,16427,5696,1991,4142,1987,10731,12285,1.0,0.0,51,7.0,11,1,112,2422.0,0.33154430985450745,0.23288482427597046
10869666,6293942,6931631,16427,9399,2001,10820,2005,7028,5607,0.3333333333333333,0.0,1144,16.0,285,2,0,294.0,0.44737374782562256,0.1820795089006424
10869909,9828415,6560770,16427,15307,2017,9987,2003,1120,6440,1.0,0.0,6,3.0,45,5,84,2961.0,0.9999998807907104,0.21742528676986694
10873858,7376113,9908427,16427,11828,2008,15405,2018,4599,1022,0.5,0.0,43,2.0,3,26,98,770.0,0.4342922568321228,0.144089937210083
10869659,8721536,8217139,16427,14012,2014,13340,2012,2415,3087,1.0,1.0,17,4.0,31,2,7,1617.0,0.48122113943099976,-0.008678574115037918
10873892,7809791,5151399,16427,12696,2010,6116,1992,3731,10311,0.0,0.0,70,5.0,18,6,21,518.0,0.436588317155838,0.16061650216579437
10873877,9106453,10519680,16427,14467,2015,16070,2019,1960,357,0.5,0.0,12,1.0,22,2,35,357.0,0.5371112823486328,0.15737870335578918
10870008,5545202,10420315,16427,7530,1996,15972,2019,8897,455,1.0,0.0,240,1.0,1,1,35,455.0,0.5125117301940918,0.16807954013347626
10873794,8812448,6118742,16427,14110,2014,9021,2000,2317,7406,0.5,0.0,37,15.0,6,6,14,154.0,0.18438465893268585,0.08926165103912354
10880235,6393483,10203394,16434,9637,2002,15748,2019,6797,686,0.0,0.0,187,1.0,39,3,28,686.0,0.34362444281578064,0.07331769168376923
10874425,8992580,6956036,16434,14334,2015,10883,2005,2100,5551,1.0,0.3333333333333333,60,8.0,2,13,7,567.0,0.4076632857322693,0.2615468502044678
10876090,4861714,7648628,16434,4989,1989,12437,2010,11445,3997,1.0,0.0,83,3.0,61,8,77,686.0,0.3490844666957855,0.09272699058055878
10874452,5980516,5898076,16434,8713,1999,8517,1999,7721,7917,1.0,0.0,192,2.0,24,1,21,7623.0,0.44730091094970703,0.03973129391670227
10874396,6938706,6338929,16434,10841,2005,9511,2002,5593,6923,0.0,0.0,212,13.0,12,5,0,3521.0,0.3492695391178131,0.19610565900802612
10875489,8585086,9692448,16434,13837,2013,15153,2017,2597,1281,1.0,0.0,2,2.0,8,6,2331,819.0,0.830277144908905,0.19681648910045624
10878017,6577947,h2188,16434,10022,2003,11443,2007,6412,4991,1.0,0.0,106,2.0,3,1,70,1176.0,0.21438737213611603,0.039267849177122116
10878859,6536011,5594796,16434,9938,2003,7684,1997,6496,8750,0.5,0.0,21,9.0,7,3,329,329.0,0.307997465133667,0.24401211738586426
10880313,7389913,8203222,16434,11863,2008,13319,2012,4571,3115,0.5,0.0,92,2.0,1,4,0,259.0,0.4173848628997803,0.1553567498922348
10881401,8044536,7761457,16441,13081,2011,12619,2010,3360,3822,0.0,0.0,478,5.0,28,29,0,2282.0,0.04153388738632202,0.13735848665237427
10884194,6925241,5698055,16441,10806,2005,8020,1997,5635,8421,1.0,0.0,274,14.0,13,9,35,7.0,0.5744777917861938,0.32883700728416443
10886589,10505252,10354018,16441,16049,2019,15902,2019,392,539,1.0,0.0,55,1.0,132,1,49,539.0,0.7112112641334534,0.243197500705719
10882064,4811904,4080047,16441,4821,1989,810,1978,11620,15631,0.3333333333333333,0.0,65,7.0,1,1,35,1162.0,0.49533984065055847,0.09945489466190338
10884771,9779063,9206726,16441,15251,2017,14586,2015,1190,1855,1.0,0.0,16,2.0,24,4,7,245.0,0.45684802532196045,0.08283109217882156
10881355,5408999,4086279,16441,7054,1995,845,1978,9387,15596,0.5,0.0,492,18.0,25,2,0,1918.0,0.4640868604183197,0.09654582291841507
10886911,6563366,6882959,16441,9994,2003,10701,2005,6447,5740,1.0,0.0,78,11.0,7,3,28,189.0,0.2983342707157135,-0.0720507800579071
10881869,6487443,6811582,16441,9826,2002,10533,2004,6615,5908,0.25,0.0,201,7.0,31,21,0,679.0,0.24756105244159698,-0.029428862035274506
10886832,6987444,6117492,16441,10974,2006,9021,2000,5467,7420,0.0,0.0,64,16.0,5,8,0,469.0,0.3011333644390106,0.13759757578372955
10883175,4976996,8069958,16441,5458,1990,13123,2011,10983,3318,1.0,0.0,241,16.0,12,17,14,189.0,0.44088202714920044,0.05112718790769577
10886123,8404499,6703464,16441,13599,2013,10295,2004,2842,6146,1.0,0.0,118,12.0,7,13,0,42.0,0.1919495016336441,0.29927656054496765
10884264,9417463,5504038,16441,14838,2016,7397,1996,1603,9044,1.0,0.0,2,19.0,4,14,315,2667.0,0.43621379137039185,0.11149308830499649
10882123,7210385,4097507,16441,11443,2007,908,1978,4998,15533,0.0,0.0,7,4.0,25,1,483,2002.0,0.609449565410614,0.26057252287864685
10882260,8168023,7206295,16441,13270,2012,11429,2007,3171,5012,0.3333333333333333,0.0,19,16.0,161,5,455,420.0,0.43219032883644104,0.2076822966337204
10883175,6884475,4343456,16441,10708,2005,2413,1982,5733,14028,1.0,0.0,60,37.0,76,3,14,574.0,0.36775705218315125,0.2053956687450409
10893305,8767825,4577411,16448,14061,2014,3736,1986,2387,12712,1.0,0.0,22,11.0,4,3,14,924.0,0.6029255986213684,0.08856836706399918
10891263,6850949,5243199,16448,10624,2005,6459,1993,5824,9989,1.0,0.0,1464,24.0,13,5,0,2737.0,0.3401128351688385,0.1366712749004364
10892016,7274207,8565664,16448,11590,2007,13809,2013,4858,2639,0.0,0.0,34,2.0,7,11,14,1911.0,0.35116180777549744,0.15021538734436035
10891357,7412455,4708130,16448,11912,2008,4345,1987,4536,12103,1.0,0.0,809,17.0,25,3,0,84.0,0.2984160780906677,0.10732550919055939
10888516,6010715,5850531,16448,8769,2000,8384,1998,7679,8064,1.0,0.0,185,55.0,8,6,7,56.0,0.23569881916046143,0.04668606072664261
10892281,4792832,6559668,16448,4737,1988,9987,2003,11711,6461,1.0,0.0,33,7.0,3,32,280,4011.0,0.4092615842819214,0.32083791494369507
10888433,6488710,5431366,16448,9833,2002,7131,1995,6615,9317,1.0,0.0,445,8.0,8,2,7,2415.0,0.43395042419433594,0.0882183387875557
10888718,7993289,6415142,16448,13004,2011,9679,2002,3444,6769,0.5,0.0,71,10.0,110,9,0,560.0,0.38663971424102783,0.01575252041220665
10892198,6110832,10545682,16448,9007,2000,16098,2020,7441,350,1.0,0.0,110,1.0,5,5,7,350.0,0.37080082297325134,0.11526486277580261
10888689,6428487,6766924,16448,9714,2002,10435,2004,6734,6013,1.0,0.0,560,8.0,15,4,0,203.0,0.4441663324832916,0.22616681456565857
10896806,6155199,7125871,16455,9105,2000,11254,2006,7350,5201,0.0,0.0,32,3.0,17,3,364,1113.0,0.5489732027053833,0.15338701009750366
10895064,6735890,6177273,16455,10365,2004,9154,2001,6090,7301,1.0,0.0,57,6.0,41,1,35,3808.0,0.47582241892814636,0.0027226379606872797
10897598,8055310,7744553,16455,13095,2011,12598,2010,3360,3857,0.25,0.0,85,16.0,9,128,49,21.0,0.2827971577644348,0.06411681324243546
10895568,8849387,5842581,16455,14152,2014,8370,1998,2303,8085,0.0,0.0,22,24.0,5,7,63,147.0,0.4461972117424011,0.09898818284273148
10894469,7025160,4166164,16455,11058,2006,1335,1979,5397,15120,0.3333333333333333,0.0,21,3.0,13,5,98,574.0,0.5160613656044006,0.14838197827339172
10902117,6550012,6217555,16462,9966,2003,9238,2001,6496,7224,0.5,0.0,463,28.0,4,20,14,77.0,0.2756117284297943,0.01958348974585533
10900760,8206522,5375113,16462,13326,2012,6928,1994,3136,9534,0.0,0.0,78,10.0,52,5,28,5992.0,0.3020177185535431,0.12400456517934799
10904611,7996792,10540008,16462,13004,2011,16091,2020,3458,371,0.25,0.16666666666666666,199,1.0,17,9,14,371.0,0.4665335416793823,0.4943706691265106
10898193,4821939,7539222,16462,4856,1989,12199,2009,11606,4263,0.0,0.0,985,3.0,4,5,0,2338.0,0.41671690344810486,0.22722381353378296
10898628,6592620,4608701,16462,10057,2003,3890,1986,6405,12572,0.5,0.0,12,27.0,17,8,133,742.0,0.4839441776275635,0.20350533723831177
10904262,6865426,5362262,16462,10659,2005,6886,1994,5803,9576,0.0,0.0,47,18.0,8,2,182,217.0,0.41171228885650635,0.18873438239097595
10902094,8473894,8004538,16462,13690,2013,13018,2011,2772,3444,1.0,0.0,22,3.0,9,3,357,2646.0,0.6152511239051819,0.22035092115402222
10902081,7065555,9438338,16462,11128,2006,14859,2016,5334,1603,0.5,0.5,42,6.0,18,11,21,147.0,0.5037364959716797,0.150985985994339
10900886,7919319,7647710,16462,12878,2011,12437,2010,3584,4025,0.0,0.0,24,6.0,4,176,63,1442.0,0.3231366276741028,0.08788100630044937
10898184,7296724,4723209,16462,11646,2007,4415,1988,4816,12047,0.5,0.0,1104,23.0,67,1,0,140.0,0.4566594958305359,0.21807828545570374
10898142,6884218,6002322,16462,10708,2005,8748,1999,5754,7714,1.0,0.0,49,15.0,23,9,854,154.0,0.3978319466114044,0.061959657818078995
10904720,10324935,7904898,16462,15874,2019,12850,2011,588,3612,0.5,0.5,6,4.0,29,14,14,49.0,0.29200267791748047,0.25503432750701904
10901686,4868832,6352771,16462,5010,1989,9560,2002,11452,6902,0.3333333333333333,0.0,290,8.0,12,28,0,1617.0,0.24173477292060852,0.1244550421833992
10905427,7189207,7440167,16469,11394,2007,11982,2008,5075,4487,1.0,0.0,827,19.0,244,1,0,658.0,0.4997805953025818,0.04640315845608711
10905427,7055730,8111526,16469,11114,2006,13186,2012,5355,3283,1.0,0.0,1094,2.0,67,6,0,756.0,0.5491251349449158,0.27097180485725403
10905423,9301759,6221496,16469,14705,2016,9245,2001,1764,7224,0.25,0.0,745,6.0,2177,12,0,259.0,0.4142651855945587,0.21002128720283508
10905425,9011464,8494385,16469,14355,2015,13718,2013,2114,2751,1.0,0.0,94,5.0,502,7,63,1862.0,0.5990145206451416,0.11707791686058044
10905418,10226239,4562506,16469,15776,2019,3652,1985,693,12817,1.0,0.0,118,35.0,283,9,7,42.0,0.12928350269794464,0.14840976893901825
10910888,5821728,5178865,16469,8321,1998,6221,1993,8148,10248,0.0,0.3333333333333333,286,6.0,6,6,35,231.0,0.32105863094329834,0.08181648701429367
10906739,8104601,4733727,16469,13179,2012,4471,1988,3290,11998,1.0,0.0,31,5.0,21,6,98,6104.0,0.3929677903652191,0.07579603791236877
10905427,7963963,9110270,16469,12955,2011,14474,2015,3514,1995,1.0,0.0,875,2.0,323,5,0,1372.0,0.39641073346138,0.26838842034339905
10908438,5757986,10471303,16469,8181,1998,16021,2019,8288,448,1.0,0.0,78,4.0,9,1,7,28.0,0.32682129740715027,0.051543351262807846
10905888,6171241,4820019,16469,9140,2001,4849,1989,7329,11620,0.5,0.0,59,3.0,14,1,315,4767.0,0.20679309964179993,0.3393160104751587
10905808,7766892,4416604,16469,12633,2010,2882,1983,3836,13587,0.3333333333333333,0.0,165,43.0,8,4,14,595.0,0.4711042046546936,0.27953246235847473
10905427,6698643,5196249,16469,10288,2004,6291,1993,6181,10178,1.0,0.0,1582,4.0,154,3,0,4102.0,0.4745335280895233,0.3399107754230499
10905422,6638285,4918181,16469,10162,2003,5220,1990,6307,11249,1.0,0.0,1087,6.0,13,4,0,7238.0,0.5838374495506287,0.004346136469393969
10905837,6588427,8180099,16469,10050,2003,13284,2012,6419,3185,0.5,0.0,44,3.0,134,15,0,1820.0,0.5252136588096619,0.23352102935314178
10912882,4453931,4925922,16476,3085,1984,5248,1990,13391,11228,1.0,1.0,37,25.0,8,1,42,70.0,0.5499787330627441,-0.035242266952991486
10912930,6913595,5417102,16476,10778,2005,7082,1995,5698,9394,0.5,0.0,45,4.0,46,5,112,7896.0,0.4651334285736084,0.23908312618732452
10915899,7209561,6607087,16476,11436,2007,10092,2003,5040,6384,0.5,0.0,125,9.0,6,3,7,1813.0,0.1948290467262268,0.04891272634267807
10916950,8610530,4139259,16476,13865,2013,1139,1979,2611,15337,0.2,0.0,43,12.0,12,3,14,2961.0,0.25948813557624817,0.09310751408338547
10913943,6179830,5661090,16476,9161,2001,7908,1997,7315,8568,0.5,0.0,50,7.0,9,9,98,5215.0,0.21707496047019958,0.09272781759500504
10912559,6723091,5536632,16476,10337,2004,7502,1996,6139,8974,1.0,0.0,1087,13.0,27,6,7,2597.0,0.23496396839618683,0.2319260686635971
10912917,5445626,7478129,16476,7180,1995,12066,2009,9296,4410,1.0,0.0,86,18.0,3,3,217,7.0,0.6194747090339661,0.04183492437005043
10914090,6214217,4758466,16476,9231,2001,4583,1988,7245,11893,0.5,0.0,31,19.0,10,8,266,189.0,0.5873191356658936,0.21777938306331635
10922878,9721389,4653877,16483,15188,2017,4107,1987,1295,12376,0.3333333333333333,0.3333333333333333,2,5.0,1,2,378,525.0,0.3571840822696686,0.27811288833618164
10920152,8210256,5244009,16483,13333,2012,6466,1993,3150,10017,0.5,0.0,11,3.0,56,4,812,1050.0,0.3460859954357147,0.24389897286891937
10922756,10055793,4512463,16483,15573,2018,3400,1985,910,13083,1.0,0.0,16,12.0,41,2,21,1785.0,1.0000001192092896,0.14581827819347382
10918498,6524312,5069531,16483,9917,2003,5815,1991,6566,10668,1.0,0.0,210,6.0,89,11,70,5397.0,0.47596025466918945,0.12069345265626907
10918318,7027848,9461935,16483,11058,2006,14887,2016,5425,1596,1.0,0.0,332,1.0,168,6,0,1596.0,0.6281612515449524,0.3153649866580963
10918425,9492276,7328774,16483,14929,2016,11730,2008,1554,4753,1.0,0.0,21,3.0,123,8,77,1281.0,0.5184186697006226,0.28945639729499817
10919163,6085090,5441325,16483,8951,2000,7166,1995,7532,9317,0.0,0.16666666666666666,298,12.0,4,17,56,112.0,0.5034975409507751,0.2749497592449188
10924791,4700378,8405201,16483,4303,1987,13599,2013,12180,2884,1.0,0.0,56,3.0,4,41,140,1848.0,0.2335323840379715,0.09636106342077255
10922203,10409730,4610752,16483,15958,2019,3904,1986,525,12579,0.25,0.0,1,3.0,1,3,525,4123.0,0.3858186602592468,0.0946483388543129
10918422,9402726,8959573,16483,14824,2016,14292,2015,1659,2191,0.5,0.0,17,8.0,9,25,0,833.0,0.3514045178890228,0.29339107871055603
10925605,9259265,5268650,16490,14656,2016,6550,1993,1834,9940,1.0,0.0,157,5.0,170,2,7,2702.0,0.32721462845802307,0.14181697368621826
10926634,5781872,6336928,16490,8230,1998,9504,2002,8260,6986,0.3333333333333333,0.0,54,48.0,9,8,301,7.0,0.4767061471939087,0.1542089730501175
10926618,8205703,7755700,16490,13326,2012,12612,2010,3164,3878,0.3333333333333333,0.0,20,2.0,14,9,70,3633.0,0.4398656487464905,0.13512080907821655
10930136,5696898,4321980,16490,8013,1997,2280,1982,8477,14210,0.3333333333333333,0.0,396,13.0,12,1,42,7490.0,0.26206958293914795,0.1552838832139969
10927773,5390640,9374002,16490,6991,1995,14782,2016,9499,1708,0.5,0.0,10,1.0,2,2,1547,1708.0,0.45076310634613037,0.1669086217880249
10925653,5334205,5705416,16490,6788,1994,8041,1998,9702,8449,1.0,0.0,246,10.0,12,2,7,6167.0,0.5204575657844543,0.1550542712211609
10926523,7930815,6179964,16490,12899,2011,9161,2001,3591,7329,0.0,0.0,20,16.0,69,6,168,679.0,0.306272953748703,0.2541017532348633
10925639,5639640,9872289,16490,7838,1997,15356,2018,8652,1134,0.0,0.0,38,2.0,18,2,63,833.0,0.21353690326213837,0.17444944381713867
10931228,9257848,5155744,16490,14649,2016,6130,1992,1841,10360,0.3333333333333333,0.0,34,9.0,24,2,0,6699.0,0.38637030124664307,0.25776293873786926
10925599,7950560,3981029,16490,12934,2011,264,1976,3556,16226,1.0,0.5,1020,2.0,343,1,7,15638.0,0.7301831841468811,0.24056841433048248
10925603,8770458,6000748,16490,14068,2014,8748,1999,2422,7742,1.0,0.0,449,10.0,322,3,0,1687.0,0.5362228155136108,0.3261384963989258
10931338,6760373,6600265,16490,10414,2004,10071,2003,6076,6419,0.5,0.0,32,11.0,5,4,28,2996.0,0.43472355604171753,0.07827549427747726
10927041,8025755,4746347,16490,13053,2011,4527,1988,3437,11963,0.0,0.0,2,16.0,1,3,175,105.0,0.39645230770111084,0.11648384481668472
10925605,8201720,6806918,16490,13319,2012,10519,2004,3171,5971,1.0,0.0,753,20.0,56,5,0,938.0,0.499380886554718,0.13584400713443756
10925639,5512549,4799900,16490,7425,1996,4772,1989,9065,11718,0.5,0.0,210,24.0,3,7,21,588.0,0.14939060807228088,0.29030680656433105
10931750,7895261,6000748,16490,12836,2011,8748,1999,3654,7742,0.5,0.0,57,10.0,122,3,77,1687.0,0.37652745842933655,0.07687737792730331
10927966,8126592,5511799,16490,13207,2012,7425,1996,3283,9065,0.0,0.2,19,8.0,10,12,217,714.0,0.5986723899841309,0.2713559865951538
10928804,6338148,8928617,16490,9504,2002,14250,2015,6986,2240,0.0,0.0,31,8.0,14,42,623,63.0,0.48024195432662964,0.13732853531837463
10937030,10395243,7296772,16497,15944,2019,11646,2007,553,4851,1.0,0.0,1,27.0,2,6,553,7.0,0.4307844936847687,0.17438243329524994
10932708,8938279,4545859,16497,14264,2015,3568,1985,2233,12929,1.0,0.0,12,4.0,37,6,21,10675.0,0.4958135187625885,0.05715058371424675
10932872,9743946,6032953,16497,15216,2017,8832,2000,1281,7665,0.5,0.0,71,5.0,13,1,0,5005.0,0.20539049804210663,0.14055389165878296
10932705,9662052,4658833,16497,15125,2017,4128,1987,1372,12369,0.2,0.3333333333333333,134,10.0,360,5,7,980.0,0.3231015205383301,0.25108835101127625
10932772,8092932,10558767,16497,13158,2012,16112,2020,3339,385,0.0,0.0,703,1.0,7,14,7,385.0,0.05597979202866554,0.057687848806381226
10932774,9737301,9583005,16497,15209,2017,15034,2017,1288,1463,1.0,0.0,441,1.0,2608,13,0,1463.0,0.4208667278289795,0.05082967132329941
10936729,5757617,7772642,16497,8181,1998,12640,2010,8316,3857,0.25,0.0,70,16.0,2,9,140,1309.0,0.12131141871213913,0.13009057939052582
10932774,8066158,5285793,16497,13116,2011,6620,1994,3381,9877,0.0,1.0,345,25.0,112,5,0,70.0,0.3476496636867523,0.19749034941196442
10933486,7220941,5281442,16497,11464,2007,6599,1994,5033,9898,1.0,0.0,22,11.0,6,7,119,1435.0,0.6356795430183411,0.1637229174375534
10932774,9839480,9573201,16497,15321,2017,15027,2017,1176,1470,1.0,0.0,358,2.0,248,30,0,1057.0,0.4630530774593353,0.24788996577262878
10937092,7685048,5993810,16497,12500,2010,8734,1999,3997,7763,1.0,0.0,36,4.0,45,2,511,1582.0,0.5785204172134399,0.05790068581700325
10936157,8495505,4844047,16497,13718,2013,4933,1989,2779,11564,0.5,0.0,14,18.0,8,3,0,3010.0,0.2835535407066345,0.23573681712150574
10936872,5806079,4093141,16497,8286,1998,887,1978,8211,15610,1.0,0.0,243,6.0,49,1,224,7959.0,0.32165050506591797,0.2916898727416992
10942184,5541061,5662655,16504,7516,1996,7915,1997,8988,8589,0.5,0.0,151,26.0,3,12,14,7.0,0.3638950288295746,0.039277978241443634
10944278,10144304,7124676,16504,15678,2018,11254,2006,826,5250,0.0,0.0,2,3.0,13,7,7,3976.0,0.7083533406257629,0.3586809039115906
10940193,8778655,3990241,16504,14075,2014,313,1976,2429,16191,0.3333333333333333,0.0,3,9.0,1,1,735,6307.0,0.3269509971141815,0.19305959343910217
10940341,5469147,6014905,16504,7264,1995,8783,2000,9240,7721,0.0,0.0,3,3.0,5,6,672,2989.0,0.4517098367214203,0.1479019969701767
10941490,10322384,5016753,16504,15874,2019,5619,1991,630,10885,0.3333333333333333,0.0,65,5.0,1110,11,7,175.0,0.2804587483406067,0.27989456057548523
10951213,5926057,6056224,16511,8601,1999,8888,2000,7910,7623,0.0,0.0,11,2.0,10,8,7,6853.0,0.4365185499191284,0.11049163341522217
10946131,5607579,9725852,16511,7733,1997,15195,2017,8778,1316,0.2,0.0,175,4.0,10,3,70,427.0,0.5557507276535034,0.32221049070358276
10945729,7086267,7888709,16511,11177,2006,12829,2011,5334,3682,0.0,0.0,299,14.0,2,27,0,98.0,0.27426236867904663,0.19848693907260895
10949623,9037464,5502133,16511,14383,2015,7390,1996,2128,9121,0.5,0.0,37,7.0,5,9,28,5551.0,0.37194326519966125,0.2248918116092682
10947099,8371478,3975712,16511,13557,2013,229,1976,2954,16282,0.5,0.0,10,52.0,30,1,7,2233.0,0.5093413591384888,0.1722051501274109
10951735,9432452,4612920,16511,14852,2016,3918,1986,1659,12593,0.6666666666666666,0.0,3,54.0,11,9,70,21.0,0.3564940094947815,0.09343602508306503
10950981,9214766,6479147,16511,14593,2015,9812,2002,1918,6699,1.0,0.0,24,6.0,6,17,21,343.0,0.7488881945610046,0.24609172344207764
10950029,5856829,7925295,16511,8405,1999,12885,2011,8106,3626,0.5,0.5,100,6.0,3,9,595,182.0,0.5428537130355835,0.27121448516845703
10948146,8496345,7470318,16511,13725,2013,12052,2008,2786,4459,0.3333333333333333,0.0,4,3.0,1,12,1547,119.0,0.5556989312171936,0.2579265832901001
10947980,7731891,4443987,16511,12577,2010,3036,1984,3934,13475,1.0,0.0,47,15.0,236,5,315,378.0,0.44019579887390137,0.16243351995944977
10945828,5603721,8044061,16511,7719,1997,13081,2011,8792,3430,1.0,0.5,373,4.0,7,3,7,1904.0,0.23209144175052643,0.02016914263367653
10949745,8204927,9596084,16511,13319,2012,15048,2017,3192,1463,1.0,0.5,20,6.0,2,3,574,301.0,0.5331166386604309,0.2703385651111603
10946748,5510281,3991888,16511,7418,1996,320,1976,9093,16191,0.0,0.0,96,6.0,4,2,231,3976.0,0.23300020396709442,0.31682881712913513
10949648,9883838,5497387,16511,15377,2018,7369,1996,1134,9142,0.3333333333333333,0.0,18,8.0,1,11,7,6076.0,0.45499634742736816,0.11760212481021881
10952759,4526571,8555786,16518,3470,1985,13802,2013,13048,2716,0.3333333333333333,0.0,218,2.0,1,8,21,1666.0,0.543475329875946,0.2840885818004608
10954885,5333993,4755396,16518,6788,1994,4569,1988,9730,11949,0.5,0.0,36,11.0,4,5,21,6524.0,0.4694638252258301,0.2265114188194275
10957455,7461006,5858107,16518,12024,2008,8412,1999,4494,8106,0.5,0.0,30,30.0,14,8,7,3647.0,0.21223175525665283,0.03794194012880325
10957784,9786774,8209951,16518,15258,2017,13333,2012,1260,3185,1.0,0.0,19,4.0,6,7,14,378.0,0.6102302670478821,0.3622494339942932
10957706,5915167,4398934,16518,8573,1999,2784,1983,7945,13734,1.0,0.0,1117,12.0,26,1,0,2695.0,0.4544956386089325,0.18599556386470795
10952862,6695848,4726091,16518,10281,2004,4436,1988,6237,12082,1.0,0.0,160,12.0,5,6,63,1162.0,0.48288819193840027,0.3742351830005646
10954417,7700764,5243199,16518,12528,2010,6459,1993,3990,10059,0.5,0.0,68,24.0,3,5,98,2807.0,0.35435277223587036,0.12159448117017746
10952727,9411370,7256652,16518,14831,2016,11548,2007,1687,4970,0.0,0.0,312,5.0,5,6,7,868.0,0.1993941217660904,0.26283323764801025
10957007,6353439,4825243,16518,9560,2002,4863,1989,6958,11655,0.5,0.3333333333333333,48,14.0,11,8,168,4970.0,0.6048515439033508,0.3805474638938904
10954785,7681338,4804713,16518,12500,2010,4793,1989,4018,11725,0.0,0.0,31,3.0,19,3,7,5663.0,0.35746335983276367,0.04838123172521591
10953820,5795013,4824212,16518,8265,1998,4863,1989,8253,11655,1.0,0.0,17,6.0,9,7,371,147.0,0.5194751024246216,0.15629783272743225
10952878,6652508,7253370,16518,10190,2003,11541,2007,6328,4977,1.0,0.0,173,4.0,88,5,7,2884.0,0.5731403827667236,0.322588711977005
10957470,4419535,7632243,16518,2896,1983,12402,2009,13622,4116,0.5,0.0,207,45.0,8,74,0,42.0,0.4185633659362793,0.3550080955028534
10952727,8834465,9536275,16518,14138,2014,14978,2017,2380,1540,0.5,0.0,73,3.0,4,4,7,322.0,0.3717633783817291,0.2395399957895279
10959186,10660077,5965537,16518,16210,2020,8685,1999,308,7833,1.0,0.0,1,18.0,1,5,308,154.0,0.48134928941726685,0.1252766251564026
10959072,10523388,4542824,16518,16070,2019,3554,1985,448,12964,0.3333333333333333,0.0,71,20.0,122,1,0,105.0,0.4585958421230316,0.23336495459079742
10959586,7951218,8754745,16525,12934,2011,14047,2014,3591,2478,0.3333333333333333,0.0,17,3.0,25,2,84,567.0,0.3272041976451874,0.20177125930786133
10963704,8254633,4414129,16525,13389,2012,2868,1983,3136,13657,0.25,0.0,32,6.0,6,3,63,7854.0,0.23203319311141968,0.05463119596242905
10963814,6892189,6336112,16525,10722,2005,9497,2002,5803,7028,0.5,1.0,37,28.0,10,6,973,504.0,0.18801084160804749,0.28009918332099915
10961369,6523650,4994626,16525,9917,2003,5528,1991,6608,10997,0.0,0.0,25,8.0,10,1,7,5012.0,0.23834306001663208,0.2793574929237366
10959725,9408606,4420333,16525,14831,2016,2903,1983,1694,13622,1.0,0.0,670,7.0,2349,9,0,1750.0,0.6258141994476318,0.11077573150396347
10959652,9801588,9473341,16525,15279,2017,14901,2016,1246,1624,1.0,0.0,136,10.0,553,39,7,203.0,0.1876474767923355,0.08413559198379517
10962406,6855894,7678925,16525,10638,2005,12493,2010,5887,4032,0.5,0.0,9,6.0,7,6,490,2541.0,0.646085798740387,0.030899036675691605
10963273,9576574,9808879,16525,15027,2017,15286,2017,1498,1239,0.25,0.0,44,2.0,1682,9,7,266.0,0.3715355098247528,0.23224030435085297
10961036,7984845,4131189,16525,12990,2011,1090,1978,3535,15435,0.5,0.0,13,11.0,50,1,154,7469.0,0.49915704131126404,0.23209227621555328
10960201,5827735,7134526,16525,8335,1998,11275,2006,8190,5250,0.0,0.0,257,2.0,5,19,63,1645.0,0.22942966222763062,0.03408440575003624
10959728,9901344,4317876,16525,15398,2018,2252,1982,1127,14273,1.0,0.0,354,5.0,2632,2,0,8148.0,0.49102795124053955,0.17463842034339905
10962784,4191446,9720455,16525,1524,1980,15188,2017,15001,1337,0.2,0.16666666666666666,45,1.0,3,8,56,1337.0,0.495414674282074,0.4543084502220154
10959725,6530942,5429563,16525,9931,2003,7124,1995,6594,9401,1.0,0.0,169,61.0,21,5,7,7.0,0.43130800127983093,0.3065017759799957
10959540,4907707,7182220,16525,5185,1990,11380,2007,11340,5145,1.0,0.5,184,3.0,7,6,7,1001.0,0.5366498827934265,0.3063264489173889
10966684,5589957,4484624,16532,7670,1996,3253,1984,8862,13279,0.3333333333333333,0.0,20,6.0,9,1,245,490.0,0.4330531060695648,0.15088780224323273
10967010,9314489,7372662,16532,14719,2016,11821,2008,1813,4711,0.6666666666666666,0.0,43,8.0,1,27,7,280.0,0.55522620677948,0.28028392791748047
10966724,7648457,4385975,16532,12437,2010,2707,1983,4095,13825,1.0,0.0,386,37.0,72,11,0,98.0,0.35884833335876465,0.22233344614505768
10967300,10155181,9777125,16532,15692,2018,15251,2017,840,1281,0.25,0.0,12,2.0,10,1,21,259.0,0.49708980321884155,0.09955938160419464
10966829,4985022,7502461,16532,5493,1991,12122,2009,11039,4410,1.0,0.0,171,4.0,5,3,70,553.0,0.5227197408676147,0.18759067356586456
10966459,4193411,4492693,16532,1538,1980,3295,1985,14994,13237,1.0,0.0,83,2.0,1,1,91,12782.0,0.6609289050102234,-0.0607696957886219
10972604,5351288,5458505,16532,6844,1994,7229,1995,9688,9303,0.5,0.0,124,41.0,8,2,56,252.0,0.5774756669998169,0.12651339173316956
10968393,5318671,4476229,16532,6732,1994,3204,1984,9800,13328,1.0,0.0,44,21.0,5,3,21,14.0,0.3662487268447876,-0.04956445097923279
10969370,5498974,9465825,16532,7376,1996,14894,2016,9156,1638,1.0,0.0,60,9.0,8,3,665,140.0,0.5118295550346375,0.12953650951385498
10966718,10463384,3991321,16532,16014,2019,313,1976,518,16219,0.5,0.3333333333333333,101,3.0,4189,1,0,10311.0,0.4322053790092468,0.01777012273669243
10968988,6932731,5371591,16532,10827,2005,6914,1994,5705,9618,0.5,0.0,19,10.0,8,5,189,1827.0,0.6849275827407837,0.3768443763256073
10966747,7806891,4094709,16532,12696,2010,894,1978,3836,15638,1.0,0.0,1251,22.0,6,2,0,371.0,0.6146105527877808,0.18369971215724945
10969976,9183157,8123948,16532,14558,2015,13207,2012,1974,3325,1.0,0.0,8,13.0,1,4,14,385.0,0.538454532623291,0.16262753307819366
10980120,4383234,4126834,16539,2686,1983,1055,1978,13853,15484,0.3333333333333333,0.25,52,6.0,1,1,14,10444.0,0.23973698914051056,0.06392770260572433
10977348,8300864,4188927,16539,13452,2012,1510,1980,3087,15029,0.3333333333333333,0.0,92,33.0,1,2,35,7.0,0.44675299525260925,0.2284029722213745
10976551,8042947,6738682,16539,13081,2011,10365,2004,3458,6174,0.0,0.0,15,20.0,2,14,196,14.0,0.4031156003475189,0.1249828040599823
10973397,4816654,5910135,16539,4835,1989,8559,1999,11704,7980,0.3333333333333333,0.3333333333333333,121,16.0,12,8,651,567.0,0.422463059425354,0.2394767552614212
10975004,10059645,6163726,16539,15580,2018,9119,2000,959,7420,1.0,0.0,1,47.0,18,6,959,42.0,0.6212460994720459,0.3010050356388092
10976671,6087772,6674481,16539,8958,2000,10232,2004,7581,6307,0.0,0.0,21,7.0,4,15,490,3927.0,0.3938342332839966,0.3667599856853485
10976559,9366867,4136357,16539,14775,2016,1118,1979,1764,15421,0.5,0.0,93,16.0,53,2,0,5796.0,0.2693230211734772,0.32325148582458496
10976315,5281540,9860761,16539,6599,1994,15342,2018,9940,1197,1.0,0.0,127,4.0,4,10,28,168.0,0.45255836844444275,-0.045448996126651764
10979906,8196199,9734554,16539,13305,2012,15202,2017,3234,1337,0.5,1.0,180,11.0,97,1,119,28.0,0.3991360068321228,0.30848750472068787
10973871,4744980,8664521,16539,4520,1988,13942,2014,12019,2597,1.0,0.0,55,2.0,9,3,721,189.0,0.4832177758216858,0.1482980102300644
10973978,4944659,9921571,16539,5325,1990,15419,2018,11214,1120,0.5,0.0,177,1.0,6,13,63,1120.0,0.513908863067627,0.11560703814029694
10976271,5265144,5304099,16539,6536,1993,6683,1994,10003,9856,0.5,0.0,63,34.0,8,7,77,203.0,0.7128653526306152,0.19028739631175995
10973770,6767637,7907736,16539,10435,2004,12857,2011,6104,3682,0.0,0.0,34,13.0,7,161,154,7.0,0.46575307846069336,0.07365398108959198
10976892,8001465,5163580,16539,13011,2011,6165,1992,3528,10374,1.0,0.0,191,16.0,12,1,21,252.0,0.14464610815048218,0.09553324431180954
10973650,9119726,6803543,16539,14488,2015,10512,2004,2051,6027,1.0,0.0,3,4.0,1,3,658,525.0,0.6642214059829712,0.16620416939258575
10975237,5380815,6623817,16539,6949,1995,10127,2003,9590,6412,1.0,0.0,1,23.0,8,4,9590,42.0,0.4279806315898895,0.09983599185943604
10984327,6772195,7669547,16546,10442,2004,12479,2010,6104,4067,0.3333333333333333,0.0,408,3.0,7,13,0,357.0,0.37267059087753296,0.1640864461660385
10985977,6058434,7192429,16546,8888,2000,11401,2007,7658,5145,0.0,0.0,175,8.0,6,26,126,210.0,0.3137837052345276,0.0758550688624382
10980461,5220917,9855215,16546,6382,1993,15342,2018,10164,1204,0.3333333333333333,0.3333333333333333,164,3.0,7,1,0,378.0,0.2254851758480072,0.025167088955640793
10981924,6090382,4798356,16546,8965,2000,4765,1989,7581,11781,1.0,0.0,368,12.0,3,1,0,1435.0,0.16383683681488037,0.11141862720251083
10985662,10033285,8226247,16546,15545,2018,13354,2012,1001,3192,1.0,0.0,2,5.0,10,13,28,182.0,0.5869595408439636,0.11312117427587509
10980461,4955861,4378021,16546,5367,1990,2644,1983,11179,13902,0.3333333333333333,0.3333333333333333,341,16.0,11,1,0,2114.0,0.23238690197467804,0.2559599280357361
10980534,6402766,7976492,16546,9658,2002,12976,2011,6888,3570,0.5,0.5,894,35.0,13,342,7,14.0,0.4275513291358948,0.3032680153846741
10982706,8016531,6718518,16546,13039,2011,10323,2004,3507,6223,1.0,0.0,21,27.0,1,11,7,147.0,0.42757028341293335,0.14677125215530396
10980273,7802569,9053018,16546,12689,2010,14404,2015,3857,2142,0.3333333333333333,0.0,30,2.0,7,11,21,1351.0,0.3319236934185028,0.09893379360437393
10993087,9497768,4235556,16553,14929,2016,1790,1980,1624,14763,1.0,0.0,1,6.0,4,1,1624,147.0,0.4170360565185547,0.11043687909841537
10992238,7038430,7662001,16553,11079,2006,12465,2010,5474,4088,0.0,0.0,87,4.0,4,28,21,2751.0,0.4370899200439453,0.21201498806476593
10989491,7201161,8733400,16553,11422,2007,14026,2014,5131,2527,1.0,0.0,24,5.0,8,8,154,392.0,0.716895341873169,0.21053002774715424
10989516,7417421,5584776,16553,11926,2008,7656,1996,4627,8897,1.0,0.0,7,21.0,17,9,497,413.0,0.7331473231315613,0.14690014719963074
10990926,8706798,6985941,16553,13991,2014,10967,2006,2562,5586,1.0,1.0,72,22.0,2,16,7,1281.0,0.44137078523635864,0.3532419502735138
10987156,5395033,5405798,16553,7005,1995,7040,1995,9548,9513,1.0,0.0,1548,9.0,3,8,0,3815.0,0.4161573648452759,0.38407400250434875
10993717,5480409,4699063,16560,7306,1996,4303,1987,9254,12257,1.0,0.0,1408,10.0,32,1,0,1715.0,0.5722640156745911,0.09517316520214081
10997091,10877905,4564380,16560,16434,2020,3666,1986,126,12894,1.0,0.0,1,3.0,6,6,126,1372.0,0.9999998807907104,0.1481071412563324
10993739,5431658,5484547,16560,7131,1995,7320,1996,9429,9240,1.0,0.0,618,22.0,10,5,14,756.0,0.33224600553512573,0.021858802065253258
10998045,7975192,5413862,16560,12969,2011,7068,1995,3591,9492,1.0,1.0,120,4.0,232,2,56,6601.0,0.38334155082702637,0.0664779469370842
10993713,4478220,6169748,16560,3218,1984,9133,2001,13342,7427,0.5,0.0,475,7.0,3,31,7,49.0,0.37514251470565796,0.18243274092674255
10995108,5707745,5103243,16560,8048,1998,5941,1992,8512,10619,0.2,0.0,1201,2.0,20,4,7,1673.0,0.2149914652109146,0.06268201023340225
10995068,5645985,4446600,16560,7859,1997,3050,1984,8701,13510,0.3333333333333333,0.0,372,18.0,7,2,28,7749.0,0.3147260546684265,0.01632842607796192
10994662,7600954,10294215,16560,12339,2009,15846,2019,4221,714,1.0,0.0,2,1.0,13,17,3465,714.0,0.4541316032409668,0.2363908588886261
10997071,4914577,6923335,16560,5206,1990,10806,2005,11354,5754,1.0,0.0,68,13.0,22,13,1225,609.0,0.3195590674877167,0.1430383175611496
10997874,5509693,7242415,16560,7418,1996,11513,2007,9142,5047,0.0,1.0,80,7.0,4,8,126,322.0,0.41524338722229004,0.21647831797599792
10993783,6616579,6465076,16560,10113,2003,9784,2002,6447,6776,0.0,0.0,97,12.0,25,31,14,2345.0,0.31992602348327637,0.19761483371257782
10994604,6164123,5320136,16560,9126,2000,6739,1994,7434,9821,0.5,0.0,47,44.0,25,3,14,49.0,0.40617886185646057,0.3116794526576996
10995783,6264393,4107369,16560,9336,2001,957,1978,7224,15603,0.25,0.0,47,5.0,13,1,154,1771.0,0.3872697651386261,0.22340412437915802
10996289,6798193,7516881,16560,10498,2004,12157,2009,6062,4403,0.3333333333333333,0.0,46,3.0,3,9,7,3017.0,0.5760143995285034,0.15752951800823212
10999157,7216164,6994650,16560,11450,2007,10995,2006,5110,5565,0.5,0.0,113,8.0,15,18,7,245.0,0.2436550408601761,0.16172946989536285
10999220,7286490,6479947,16560,11618,2007,9812,2002,4942,6748,0.5,0.0,127,3.0,10,16,0,2779.0,0.30025342106819153,0.12744423747062683
10998628,4291312,4382739,16560,2091,1981,2686,1983,14469,13874,1.0,1.0,81,12.0,2,1,42,3220.0,0.4182712435722351,-0.00527547299861908
10993717,4988334,5413862,16560,5507,1991,7068,1995,11053,9492,1.0,0.0,834,4.0,10,2,0,6601.0,0.44930076599121094,0.08483819663524628
10996290,4837542,5558213,16560,4905,1989,7572,1996,11655,8988,0.0,0.0,28,7.0,3,3,154,210.0,0.3339189887046814,0.24696683883666992
10993713,5392979,5016753,16560,6998,1995,5619,1991,9562,10941,1.0,0.0,1293,5.0,14,11,7,231.0,0.4366903007030487,0.23413412272930145
10993730,7299561,5760765,16560,11653,2007,8188,1998,4907,8372,1.0,0.0,39,3.0,7,5,91,6279.0,0.4215434491634369,0.17641767859458923
10994289,6349735,6271186,16560,9553,2002,9350,2001,7007,7210,0.0,0.0,45,2.0,4,7,476,2009.0,0.3827018737792969,0.08285786211490631
10997315,6374252,8719531,16560,9602,2002,14005,2014,6958,2555,1.0,1.0,359,3.0,28,9,14,42.0,0.23271237313747406,0.2022460252046585
10993721,5129885,6191811,16560,6039,1992,9182,2001,10521,7378,1.0,0.0,282,8.0,8,8,35,2870.0,0.45558708906173706,0.17502132058143616
11001988,7192100,4031690,16567,11401,2007,544,1977,5166,16023,0.0,0.0,3,8.0,11,1,154,5131.0,0.48944514989852905,0.3515295386314392
11002743,4260257,7302181,16567,1923,1981,11653,2007,14644,4914,0.2,0.0,39,15.0,1,18,168,805.0,0.4167611300945282,0.24363231658935547
11005998,9161296,8385827,16567,14530,2015,13571,2013,2037,2996,1.0,1.0,55,2.0,22,1,21,1932.0,0.31225016713142395,0.3333461284637451
11005657,7047129,8521388,16567,11093,2006,13753,2013,5474,2814,0.2,0.1,67,8.0,4,9,35,1029.0,0.31322866678237915,0.34645020961761475
11001619,8642541,4248930,16567,13914,2014,1860,1981,2653,14707,0.5,0.0,17,11.0,1,5,560,77.0,0.5500084161758423,0.16565676033496857
11005062,6160828,5350368,16567,9112,2000,6844,1994,7455,9723,1.0,0.0,101,3.0,18,12,21,203.0,0.3072986304759979,0.21276387572288513
11002961,8384999,7447494,16567,13571,2013,11996,2008,2996,4571,0.2,0.25,194,20.0,33,16,21,7.0,0.6858698129653931,0.18467985093593597
11012529,7007228,8375429,16574,11016,2006,13557,2013,5558,3017,0.0,0.0,193,3.0,17,6,7,1638.0,0.4201241731643677,0.4016120433807373
11008808,9226476,8592024,16574,14614,2016,13844,2013,1960,2730,0.0,0.0,2,2.0,10,9,371,833.0,0.2833406329154968,0.009385257959365845
11009284,5924295,8521084,16574,8601,1999,13753,2013,7973,2821,0.3333333333333333,0.0,125,3.0,2,6,98,1253.0,0.3272145688533783,0.08888216316699982
11007073,9119656,3998912,16574,14488,2015,355,1976,2086,16219,1.0,0.0,82,4.0,123,1,0,9450.0,0.4027186632156372,0.18369923532009125
11007004,10045776,5041522,16574,15566,2018,5710,1991,1008,10864,0.3333333333333333,0.0,401,7.0,2659,1,0,1239.0,0.6135990023612976,0.14187009632587433
11006955,8673210,8423126,16574,13956,2014,13620,2013,2618,2954,0.2,0.5,523,6.0,23,12,0,392.0,0.24717020988464355,0.3881344497203827
11010127,8194827,8431055,16574,13305,2012,13634,2013,3269,2940,0.0,0.0,11,2.0,7,8,0,539.0,0.3677540421485901,0.1307908147573471
11008278,6192596,10202860,16574,9189,2001,15748,2019,7385,826,0.0,0.0,120,2.0,16,3,266,266.0,0.3887636661529541,0.2066158503293991
11006923,8527033,4332411,16574,13760,2013,2343,1982,2814,14231,1.0,0.0,13,6.0,1,1,28,462.0,0.3995411992073059,0.34020206332206726
re48560,6270435,4759798,16574,9350,2001,4590,1988,7224,11984,1.0,0.0,52,12.0,15,3,161,3437.0,0.7025635838508606,0.1418258249759674
11007680,5868957,6727213,16574,8440,1999,10344,2004,8134,6230,0.5,0.0,7,8.0,11,3,896,2618.0,0.5650951266288757,0.29432204365730286
11018758,5717686,8723208,16581,8076,1998,14012,2014,8505,2569,1.0,0.0,49,2.0,10,1,56,826.0,0.5681698322296143,0.21076667308807373
11016100,5492840,7424822,16581,7355,1996,11947,2008,9226,4634,0.5,0.5,231,6.0,3,10,175,1176.0,0.3601200580596924,0.08476577699184418
11018156,6844243,4887013,16581,10610,2005,5094,1989,5971,11487,0.5,0.0,126,6.0,18,6,0,2310.0,0.22945354878902435,0.21118441224098206
11016605,9389732,6522190,16581,14803,2016,9910,2003,1778,6671,0.5,0.0,20,18.0,4,7,182,658.0,0.44352957606315613,0.031723860651254654
11019213,7353388,3995255,16581,11779,2008,334,1976,4802,16247,1.0,0.0,169,4.0,73,1,0,5446.0,0.0853271335363388,0.1478523313999176
11018864,10187208,4836438,16581,15727,2019,4905,1989,854,11676,0.6666666666666666,0.0,1,23.0,6,3,854,707.0,0.35441696643829346,0.17107826471328735
11019159,8855271,6219893,16581,14159,2014,9245,2001,2422,7336,1.0,0.0,77,6.0,4,11,14,2016.0,0.4048849642276764,0.19967101514339447
11014015,4988322,3983876,16581,5507,1991,278,1976,11074,16303,1.0,0.0,21,5.0,4,1,224,11627.0,0.4350101351737976,0.2716714143753052
11019001,9094137,6544862,16581,14453,2015,9959,2003,2128,6622,1.0,0.0,156,28.0,32,76,0,994.0,0.2716759145259857,0.148363396525383
11014524,7165581,5848997,16581,11345,2007,8384,1998,5236,8197,0.0,0.0,4,23.0,7,5,2079,161.0,0.5042667984962463,0.42529910802841187
11026307,9801250,5386245,16588,15272,2017,6970,1995,1316,9618,0.5,0.0,21,2.0,4,5,28,7126.0,0.7046049237251282,0.16878646612167358
11024629,9368589,10606110,16588,14775,2016,16161,2020,1813,427,1.0,0.0,3,2.0,6,11,924,63.0,0.6533079743385315,0.35777923464775085
11021368,8373157,7696106,16588,13557,2013,12521,2010,3031,4067,0.0,0.0,2,5.0,1,5,637,616.0,0.6076784729957581,0.28461164236068726
11020115,9510846,4223761,16588,14950,2016,1727,1980,1638,14861,1.0,0.0,400,4.0,61,1,0,168.0,0.3371068239212036,0.31407228112220764
11020109,6758846,9935747,16588,10414,2004,15433,2018,6174,1155,1.0,0.0,1031,2.0,10,1,7,301.0,0.31290650367736816,0.19534526765346527
11025544,7945721,4750490,16588,12920,2011,4548,1988,3668,12040,0.5,0.0,26,16.0,7,2,707,1883.0,0.5158145427703857,0.09397048503160477
11025718,9495364,5731641,16588,14929,2016,8118,1998,1659,8470,0.0,0.0,4,13.0,125,3,112,644.0,0.33108365535736084,0.07103476673364639
11020119,8453911,4282345,16588,13669,2013,2042,1981,2919,14546,1.0,0.0,70,2.0,276,1,7,12390.0,0.48071712255477905,0.1287979930639267
11023462,8805875,9680260,16588,14103,2014,15139,2017,2485,1449,0.5,0.0,33,6.0,18,9,98,259.0,0.24179621040821075,0.16720187664031982
11023081,5878872,6774079,16588,8468,1999,10449,2004,8120,6139,0.5,0.0,64,3.0,5,1,154,2996.0,0.5634026527404785,0.19059894979000092
11020596,7435221,6714476,16588,11975,2008,10316,2004,4613,6272,1.0,0.0,33,10.0,29,4,168,1393.0,0.46864399313926697,0.19938239455223083
11026326,6554654,6412303,16588,9980,2003,9679,2002,6608,6909,0.3333333333333333,0.0,8,5.0,2,2,378,3423.0,0.4966396987438202,0.1599552184343338
11020104,7530990,4524288,16588,12185,2009,3456,1985,4403,13132,1.0,0.0,65,15.0,17,3,49,154.0,0.4308302104473114,0.1753900796175003
11020175,6599311,4054887,16588,10071,2003,656,1977,6517,15932,1.0,0.0,456,10.0,20,2,14,5670.0,0.2932744324207306,0.26604196429252625
11023850,7050624,4940102,16588,11100,2006,5304,1990,5488,11284,0.5,0.0,88,14.0,36,2,0,2072.0,0.5324770212173462,0.0641762986779213
11020115,5575805,4420051,16588,7628,1996,2903,1983,8960,13685,1.0,0.0,1027,23.0,3,4,0,959.0,0.5117652416229248,0.16784197092056274
11020026,4810470,5330689,16588,4814,1989,6774,1994,11774,9814,0.0,0.3333333333333333,357,11.0,1,27,21,3136.0,0.27703094482421875,0.23868899047374725
11020114,8678263,4471229,16588,13963,2014,3176,1984,2625,13412,1.0,0.0,836,12.0,3,2,0,476.0,0.45489317178726196,0.1644342839717865
11026743,9445868,6322093,16595,14873,2016,9462,2001,1722,7133,1.0,0.0,10,7.0,49,7,161,2233.0,0.5739124417304993,0.20799987018108368
11026680,6168605,5149391,16595,9133,2001,6109,1992,7462,10486,0.16666666666666666,0.0,936,7.0,5,10,0,273.0,0.5081726908683777,0.2605949640274048
11029911,8175668,7660750,16595,13277,2012,12458,2010,3318,4137,0.2,0.2,23,6.0,17,16,0,784.0,0.20696039497852325,0.3025566637516022
11030276,9824068,5193027,16595,15300,2017,6277,1993,1295,10318,0.5,0.0,24,6.0,93,4,7,3759.0,1.0000001192092896,0.16606317460536957
11026591,5387193,9136809,16595,6977,1995,14502,2015,9618,2093,1.0,0.0,102,7.0,11,7,35,504.0,0.2383498251438141,0.18131457269191742
11029974,5790825,6288393,16595,8251,1998,9385,2001,8344,7210,1.0,0.0,424,10.0,9,43,7,350.0,0.35030627250671387,0.20383399724960327
11027841,7397363,8053453,16595,11877,2008,13095,2011,4718,3500,0.0,0.0,168,2.0,409,2,49,2394.0,0.38870853185653687,0.13142478466033936
11026699,7364581,5158114,16595,11807,2008,6144,1992,4788,10451,1.0,0.0,55,10.0,21,6,56,14.0,0.3759000599384308,0.22900263965129852
11026836,5657760,4899098,16595,7901,1997,5150,1990,8694,11445,1.0,0.0,493,17.0,13,4,14,2982.0,0.0806218832731247,0.12074705213308334
11027050,8641692,6293270,16595,13914,2014,9399,2001,2681,7196,1.0,0.0,18,12.0,133,5,56,651.0,0.6189693808555603,0.20190994441509247
11026678,6786382,10415989,16595,10477,2004,15965,2019,6118,630,0.5,0.0,1673,1.0,11,12,0,630.0,0.3123697340488434,0.14747728407382965
11027860,4391081,7954651,16595,2742,1983,12941,2011,13853,3654,0.5,0.0,52,11.0,1,5,168,147.0,0.4576733112335205,0.23831750452518463
11030017,10061599,4072812,16595,15580,2018,768,1978,1015,15827,0.25,0.0,4,23.0,6,1,0,287.0,0.42270150780677795,0.02494768239557743
11033826,5443260,8139748,16602,7173,1995,13228,2012,9429,3374,1.0,0.0,87,4.0,22,21,42,203.0,0.6593555808067322,0.021258840337395668
11034486,5482669,4374709,16602,7313,1996,2609,1983,9289,13993,0.5,0.0,25,25.0,8,1,581,49.0,0.38662952184677124,0.2493416965007782
11033677,5053189,4832342,16602,5752,1991,4891,1989,10850,11711,0.0,0.0,19,16.0,4,8,791,105.0,0.32078102231025696,0.23624378442764282
11033325,8382754,6045259,16602,13571,2013,8860,2000,3031,7742,1.0,0.0,29,14.0,648,24,0,42.0,0.586790919303894,0.09761369973421097
11038313,9837736,5744913,16602,15314,2017,8153,1998,1288,8449,1.0,0.5,2,27.0,2,40,938,203.0,0.4013734459877014,0.09052964299917221
11033433,5752280,4228829,16602,8174,1998,1755,1980,8428,14847,0.5,0.0,51,14.0,2,1,77,1869.0,0.47974693775177,0.2033872902393341
11038816,6941252,6509606,16602,10841,2005,9882,2003,5761,6720,0.0,0.0,18,12.0,26,11,637,2331.0,0.6041715145111084,-0.021615689620375633
11039020,7984511,5758125,16602,12983,2011,8181,1998,3619,8421,0.0,0.0,207,5.0,49,10,56,2135.0,0.2948741614818573,0.24731947481632233
11035510,4637640,7630744,16602,4037,1987,12395,2009,12565,4207,0.5,0.0,74,6.0,7,2,70,2023.0,0.6436664462089539,0.19188016653060913
11042663,5813017,5650092,16609,8300,1998,7873,1997,8309,8736,0.5,0.0,963,2.0,13,4,0,8176.0,0.42835769057273865,0.12762551009655
11040180,8007460,4556834,16609,13025,2011,3624,1985,3584,12985,1.0,0.0,31,2.0,49,4,0,11935.0,0.5226308703422546,0.1782759577035904
11040854,8939262,9797319,16609,14271,2015,15272,2017,2338,1337,1.0,0.0,9,2.0,15,23,0,595.0,0.7063764333724976,0.23336577415466309
11044170,8462212,5326992,16609,13676,2013,6760,1994,2933,9849,0.5,0.0,80,20.0,7,5,49,581.0,0.3319561183452606,0.1028493344783783
11043556,9202915,6284163,16609,14579,2015,9378,2001,2030,7231,1.0,0.0,3,5.0,54,2,1512,3220.0,0.5528405904769897,-0.014833894558250904
11040112,5919743,4379498,16609,8587,1999,2658,1983,8022,13951,0.0,0.0,8,8.0,5,1,329,2996.0,0.33217158913612366,0.19866226613521576
11039889,9044285,5556240,16609,14397,2015,7565,1996,2212,9044,0.3333333333333333,0.0,11,23.0,6,3,294,91.0,0.31564849615097046,0.3070605397224426
11042281,7751285,4758716,16609,12605,2010,4583,1988,4004,12026,0.0,0.5,72,23.0,2,1,42,2163.0,0.5826146006584167,0.3048233091831207
11044246,8301500,6094380,16609,13452,2012,8972,2000,3157,7637,0.5,0.0,56,10.0,9,10,0,3822.0,0.35167643427848816,0.2164166271686554
11039660,8347526,8642693,16609,13522,2013,13914,2014,3087,2695,0.5,0.0,7,2.0,43,77,994,1540.0,0.6464396715164185,0.09411442279815674
11040234,5295935,4336427,16609,6655,1994,2364,1982,9954,14245,1.0,0.0,104,40.0,7,1,21,21.0,0.6465760469436646,0.19967500865459442
11045189,7798386,7977238,16616,12682,2010,12976,2011,3934,3640,0.5,0.0,1396,2.0,349,6,7,2814.0,0.72738116979599,0.34644758701324463
11045267,8019045,10590666,16616,13039,2011,16147,2020,3577,469,0.0,0.0,55,1.0,1,3,0,469.0,0.2917301058769226,0.1961682140827179
11047935,6268728,4783168,16616,9343,2001,4695,1988,7273,11921,0.5,0.5,17,10.0,4,1,168,5166.0,0.6175718307495117,0.024466482922434807
11049820,8378495,4093038,16616,13564,2013,887,1978,3052,15729,1.0,0.0,10,9.0,2,2,882,1358.0,0.6547914147377014,0.08127154409885406
re48612,7412030,8936308,16616,11912,2008,14264,2015,4704,2352,0.25,0.0,26,2.0,1,9,63,931.0,0.7040773034095764,0.2541760504245758
11045270,7766894,5541931,16616,12633,2010,7516,1996,3983,9100,1.0,0.0,817,7.0,237,10,0,2254.0,0.5640715956687927,0.15670524537563324
11048640,7350021,8914450,16616,11772,2008,14229,2014,4844,2387,0.5,0.5,28,2.0,12,1,0,1876.0,0.6247938871383667,0.21525028347969055
11047389,5632612,4677561,16616,7817,1997,4198,1987,8799,12418,0.5,0.0,30,22.0,3,4,196,2618.0,0.6950836777687073,0.22812412679195404
11045192,6175290,4329664,16616,9147,2001,2322,1982,7469,14294,0.0,0.0,592,33.0,13,6,0,868.0,0.04438794031739235,-0.03113744780421257
11045120,6201980,6831774,16616,9203,2001,10575,2004,7413,6041,1.0,0.0,560,5.0,5,5,7,2030.0,0.6486655473709106,0.13233676552772522
11049638,5801432,10648763,16616,8279,1998,16203,2020,8337,413,1.0,0.0,88,1.0,13,29,56,413.0,0.2832169532775879,0.3149864077568054
11045120,5462645,8231104,16616,7243,1995,13361,2012,9373,3255,0.0,0.0,627,4.0,6,11,7,161.0,0.4505447447299957,0.06306180357933044
11046219,6523892,6229214,16616,9917,2003,9259,2001,6699,7357,1.0,0.0,129,4.0,5,8,434,5677.0,0.6044824123382568,0.1507357656955719
11044971,5044123,7828757,16616,5724,1991,12731,2010,10892,3885,0.0,0.0,12,3.0,6,8,2562,1624.0,0.6757992506027222,0.16170376539230347
11045270,8540128,4049426,16616,13781,2013,628,1977,2835,15988,1.0,0.0,1063,10.0,1280,1,0,8904.0,0.43334463238716125,0.13103103637695312
11051873,5443463,4001791,16623,7173,1995,369,1977,9450,16254,1.0,0.0,1462,2.0,4,1,0,15981.0,0.55723637342453,0.2681668698787689
11051724,5208154,5350928,16623,6333,1993,6844,1994,10290,9779,0.0,0.0,330,3.0,11,4,7,6594.0,0.3158248960971832,0.2405991107225418
11051813,7967179,4451403,16623,12962,2011,3071,1984,3661,13552,1.0,0.0,1076,2.0,98,2,0,5201.0,0.4560372829437256,0.11833740770816803
11052211,6135432,8948117,16623,9063,2000,14278,2015,7560,2345,0.0,0.0,98,2.0,23,4,21,301.0,0.29948487877845764,0.1715923398733139
11051882,10070914,10503584,16623,15594,2018,16049,2019,1029,574,0.5,0.0,4,1.0,2,4,189,574.0,0.34915223717689514,0.24844136834144592
11056344,5279886,7081399,16623,6592,1994,11163,2006,10031,5460,0.0,0.5,73,5.0,10,3,0,2121.0,0.1881902664899826,0.5435355305671692
11053373,4215682,5761851,16623,1678,1980,8195,1998,14945,8428,0.0,0.0,349,7.0,5,6,21,1071.0,0.04793943464756012,0.0576731376349926
11057225,9608933,4675970,16623,15062,2017,4198,1987,1561,12425,1.0,0.0,20,8.0,21,2,21,294.0,0.38149386644363403,0.1694011241197586
11054846,6457437,5048978,16623,9770,2002,5738,1991,6853,10885,0.0,0.0,38,30.0,10,4,224,371.0,0.275702565908432,0.23216798901557922
11051806,9220501,5908749,16623,14607,2015,8552,1999,2016,8071,1.0,0.0,687,7.0,2152,6,7,1253.0,0.5694393515586853,0.07439173012971878
11051531,5967226,3993837,16623,8692,1999,327,1976,7931,16296,1.0,0.0,20,9.0,1,1,448,1932.0,0.5454226732254028,0.3259614109992981
11052005,5916085,3992037,16623,8580,1999,320,1976,8043,16303,1.0,0.0,14,16.0,7,1,252,1428.0,0.536162793636322,0.37186750769615173
11051654,6845707,4528010,16623,10617,2005,3477,1985,6006,13146,0.5,0.0,33,19.0,11,10,21,1106.0,0.42353853583335876,0.18178024888038635
11053591,6722837,5839323,16623,10337,2004,8363,1998,6286,8260,0.0,0.0,133,18.0,2,5,7,42.0,0.09179041534662247,0.13923901319503784
11051810,7021669,6905564,16623,11051,2006,10757,2005,5572,5866,0.0,0.0,568,12.0,16,5,0,490.0,0.3293941617012024,0.22953900694847107
11054257,7644506,5630296,16623,12430,2010,7810,1997,4193,8813,1.0,0.0,22,20.0,9,13,224,175.0,0.4026135802268982,0.12016390264034271
11051810,7832612,6257274,16623,12738,2010,9322,2001,3885,7301,1.0,0.0,1294,2.0,277,4,0,3255.0,0.45183849334716797,0.3289756774902344
11062283,7245765,4666428,16630,11520,2007,4156,1987,5110,12474,1.0,0.0,55,8.0,13,3,0,84.0,0.4711684286594391,0.11830780655145645
11058426,6224617,6340176,16630,9252,2001,9518,2002,7378,7112,1.0,0.0,807,31.0,9,4,0,161.0,0.22840198874473572,0.26813918352127075
11062552,7555376,4257704,16630,12234,2009,1909,1981,4396,14721,0.0,0.0,15,4.0,3,1,84,6699.0,0.42328640818595886,0.24718043208122253
11063645,7567621,7591635,16630,12262,2009,12318,2009,4368,4312,1.0,0.0,62,16.0,21,20,28,91.0,0.2582206428050995,0.21012777090072632
11058423,7252660,8094080,16630,11541,2007,13158,2012,5089,3472,1.0,0.0,1013,3.0,11,6,0,2205.0,0.5547521710395813,0.14117829501628876
11061252,7883207,6430478,16630,12822,2011,9714,2002,3808,6916,0.3333333333333333,0.0,14,4.0,190,6,42,2394.0,0.4240396320819855,0.15985922515392303
11058447,7819819,8315011,16630,12717,2010,13473,2012,3913,3157,1.0,0.0,235,4.0,107,15,7,2401.0,0.362872838973999,0.31030938029289246
11058448,8956349,9918557,16630,14292,2015,15419,2018,2338,1211,0.5,0.0,210,2.0,481,14,0,126.0,0.5717109441757202,0.2529100477695465
11058237,6105796,4528445,16630,9000,2000,3477,1985,7630,13153,1.0,0.0,48,6.0,15,1,294,8799.0,0.31008708477020264,0.2641201615333557
11063393,7645158,4749167,16630,12430,2010,4541,1988,4200,12089,1.0,0.0,42,27.0,21,2,98,1638.0,0.3629351556301117,0.10126706957817078
11062131,5889884,6753511,16630,8489,1999,10400,2004,8141,6230,1.0,0.0,68,15.0,8,8,0,259.0,0.5635130405426025,0.14244309067726135
11063972,7486780,8005714,16630,12087,2009,13018,2011,4543,3612,1.0,0.0,192,2.0,409,8,35,1050.0,0.49220648407936096,0.2918439209461212
11070927,6174278,6777898,16637,9147,2001,10456,2004,7490,6181,0.0,0.25,75,8.0,18,10,7,2450.0,0.24102768301963806,0.28629910945892334
11065197,9180091,5308029,16637,14558,2015,6697,1994,2079,9940,1.0,0.0,14,13.0,534,1,189,980.0,1.0,0.14827606081962585
11064921,6117290,9684472,16637,9021,2000,15146,2017,7616,1491,0.0,0.0,807,4.0,18,9,0,49.0,0.27217715978622437,0.09416971355676651
11065402,6761164,10060202,16637,10421,2004,15580,2018,6216,1057,0.3333333333333333,0.0,33,2.0,4,12,0,175.0,0.47283652424812317,0.27906933426856995
11064737,8881737,5294702,16637,14194,2014,6648,1994,2443,9989,0.5,0.0,90,5.0,210,1,14,7630.0,0.4691278040409088,0.1679569035768509
11068995,8108655,5887731,16637,13179,2012,8489,1999,3458,8148,1.0,0.0,80,29.0,3,8,7,490.0,0.10217490792274475,0.17837266623973846
11070031,6586762,4100262,16637,10043,2003,922,1978,6594,15715,0.3333333333333333,0.0,212,26.0,15,2,56,49.0,0.2777315080165863,-0.06348960101604462
11066705,7232653,7987349,16637,11492,2007,12990,2011,5145,3647,0.0,0.0,46,9.0,1,1,21,1267.0,0.13817352056503296,0.06607228517532349
11065444,7797041,4650082,16637,12675,2010,4093,1987,3962,12544,0.5,0.0,126,22.0,18,3,42,826.0,0.5611780285835266,0.09914612770080566
11069103,8425322,7121130,16637,13627,2013,11247,2006,3010,5390,0.0,0.0,43,3.0,22,5,7,1337.0,0.4534932076931,0.1121702790260315
11071545,8113410,9579544,16644,13193,2012,15034,2017,3451,1610,0.25,0.0,1041,18.0,1074,8,0,14.0,0.32338327169418335,0.2869841456413269
11071890,5308303,6065329,16644,6697,1994,8909,2000,9947,7735,0.3333333333333333,0.0,28,5.0,6,3,651,21.0,0.4924682676792145,0.0898958295583725
11071537,8808329,5240861,16644,14110,2014,6452,1993,2534,10192,1.0,0.0,14,9.0,1218,4,182,623.0,0.5010170340538025,-0.021446814760565758
11073315,5770048,4931515,16644,8209,1998,5269,1990,8435,11375,0.0,0.0,4,3.0,3,6,602,6678.0,0.4636067748069763,0.16474170982837677
11071395,4809376,7740330,16644,4814,1989,12591,2010,11830,4053,1.0,1.0,5,2.0,5,3,4921,448.0,0.5523052215576172,0.260323703289032
11071480,10154815,8412209,16644,15692,2018,13606,2013,952,3038,1.0,0.0,102,10.0,1068,1,7,280.0,0.3871292769908905,0.11515039950609207
11071543,5738629,9725852,16644,8139,1998,15195,2017,8505,1449,0.5,0.0,530,4.0,48,3,7,560.0,0.4170665144920349,0.2358977347612381
11075147,6313527,3985481,16644,9441,2001,285,1976,7203,16359,1.0,0.0,12,17.0,2,1,1981,5369.0,0.6368916630744934,0.2783217430114746
11075414,10800398,5527304,16644,16357,2020,7474,1996,287,9170,0.5,0.0,1,51.0,1,14,287,147.0,0.6742640733718872,0.2086719125509262
11081345,6696367,6017224,16651,10281,2004,8790,2000,6370,7861,0.5,0.5,92,3.0,14,6,7,1946.0,0.436207115650177,0.30164292454719543
11080012,8355919,8821451,16651,13529,2013,14124,2014,3122,2527,0.5,0.0,214,9.0,189,2,14,49.0,0.2994965612888336,0.1690637469291687
11078356,4086298,5111364,16651,845,1978,5969,1992,15806,10682,1.0,0.0,62,9.0,2,5,1113,6139.0,0.5781548023223877,0.21259522438049316
11082355,8046823,7332035,16651,13081,2011,11737,2008,3570,4914,1.0,0.0,212,8.0,16,24,7,728.0,0.3392881155014038,0.2535463571548462
11076782,9480422,9166255,16651,14915,2016,14537,2015,1736,2114,0.5,0.5,201,2.0,270,2,0,609.0,0.5473059415817261,0.06795322149991989
11077068,6375963,4391063,16651,9609,2002,2742,1983,7042,13909,0.3333333333333333,0.0,163,12.0,10,1,56,175.0,0.63823002576828,0.2280891239643097
11076921,8075571,9605544,16651,13130,2011,15062,2017,3521,1589,0.5,0.0,907,4.0,205,6,0,273.0,0.35253283381462097,0.1877051740884781
11079269,7038784,6765760,16651,11079,2006,10428,2004,5572,6223,0.5,0.0,4,3.0,6,27,1666,4613.0,0.33387184143066406,-0.04151718690991402
11082355,8423511,7582076,16651,13620,2013,12297,2009,3031,4354,0.5,0.0,34,4.0,1,5,42,630.0,0.3508114516735077,0.3005349338054657
11081423,7012554,5192470,16651,11030,2006,6277,1993,5621,10374,0.0,0.0,11,3.0,2,9,1253,7147.0,0.5099114775657654,0.38699591159820557
11076997,9220455,4708974,16651,14607,2015,4345,1987,2044,12306,1.0,0.0,13,10.0,4,9,126,5320.0,0.46304622292518616,0.010488159954547882
11082859,7728755,7704659,16651,12570,2010,12535,2010,4081,4116,0.5,0.0,66,14.0,14,8,7,217.0,0.2790239453315735,0.05329994112253189
11082786,9579039,9512988,16651,15034,2017,14950,2016,1617,1701,0.2,0.0,192,2.0,530,2,0,665.0,0.49957984685897827,0.08404739201068878
11080678,7882203,5356884,16651,12815,2011,6865,1994,3836,9786,1.0,0.0,6,3.0,2,1,175,8869.0,0.1045190617442131,0.19505493342876434
11083454,7241288,6111236,16658,11513,2007,9007,2000,5145,7651,1.0,0.0,1086,2.0,24,16,0,1981.0,0.7223519682884216,0.2397562861442566
11083458,8366787,6161486,16658,13550,2013,9119,2000,3108,7539,1.0,0.0,475,45.0,183,4,0,175.0,0.36475491523742676,0.3589981198310852
11087287,7024205,4998268,16658,11051,2006,5542,1991,5607,11116,0.3333333333333333,0.0,158,33.0,24,6,98,602.0,0.4819733202457428,0.09917347133159637
11084107,4565471,10453333,16658,3673,1986,16000,2019,12985,658,1.0,0.0,16,2.0,5,28,119,364.0,0.5581537485122681,0.07864001393318176
11087875,8233955,6748211,16658,13361,2012,10386,2004,3297,6272,0.0,0.0,417,17.0,182,20,0,14.0,0.45354458689689636,0.4367680251598358
11086458,8031094,4044906,16658,13060,2011,607,1977,3598,16051,0.3333333333333333,0.0,464,17.0,18,1,7,1064.0,0.5990503430366516,0.1780526489019394
11083864,7137388,4250104,16658,11282,2006,1867,1981,5376,14791,1.0,0.0,75,7.0,25,1,7,756.0,0.4944268465042114,0.1632358580827713
11092767,5877565,4657039,16665,8461,1999,4121,1987,8204,12544,0.0,0.0,58,15.0,8,14,7,700.0,0.3501688838005066,0.12519808113574982
11091230,8517466,10614649,16665,13753,2013,16168,2020,2912,497,0.0,0.0,13,1.0,18,4,63,497.0,0.610844075679779,0.12862379848957062
11090045,8061576,5028267,16665,13109,2011,5661,1991,3556,11004,0.5,0.0,783,9.0,449,6,7,588.0,0.2898344099521637,0.19078528881072998
11093223,6877000,5877559,16665,10687,2005,8461,1999,5978,8204,0.5,0.0,8,36.0,9,7,826,126.0,0.4575854241847992,0.03892955183982849
11095615,8266438,6297070,16665,13403,2012,9406,2001,3262,7259,1.0,0.0,56,25.0,121,33,273,1694.0,0.46201401948928833,0.13970878720283508
11100439,9189535,10703409,16672,14565,2015,16259,2020,2107,413,1.0,0.0,1,1.0,7,18,2107,413.0,0.42501595616340637,0.31896692514419556
11100215,6657956,7954686,16672,10197,2003,12941,2011,6475,3731,0.0,0.0,30,3.0,7,300,490,7.0,0.5689268112182617,0.2930122911930084
11096752,7156853,5779576,16672,11324,2007,8230,1998,5348,8442,1.0,0.0,271,34.0,6,5,7,154.0,0.3297813832759857,0.271113783121109
11096512,5758545,4827036,16672,8188,1998,4870,1989,8484,11802,0.0,0.0,54,3.0,6,1,0,8309.0,0.30434659123420715,0.06035566329956055
11100744,5252811,7907551,16672,6494,1993,12857,2011,10178,3815,0.5,0.0,166,11.0,5,410,147,119.0,0.49768245220184326,0.22921320796012878
11101318,7402866,4199394,16672,11891,2008,1573,1980,4781,15099,0.5,0.0,29,4.0,6,1,112,2520.0,0.6154888868331909,0.1432778239250183
11099811,10452712,7642115,16672,16000,2019,12423,2010,672,4249,0.5,0.0,1,8.0,2,73,672,336.0,0.5985807776451111,0.27044305205345154
11099282,9384864,9024658,16672,14796,2016,14369,2015,1876,2303,0.6666666666666666,0.3333333333333333,17,3.0,24,11,28,1127.0,0.4358665347099304,0.2537047564983368
11097091,7323961,6290370,16672,11716,2008,9392,2001,4956,7280,0.0,0.0,8,3.0,2,3,175,5936.0,0.4625372290611267,0.21133242547512054
11099058,9354108,5441837,16672,14761,2016,7166,1995,1911,9506,1.0,0.0,2,6.0,4,9,1295,3248.0,0.6464214324951172,0.23045924305915833
11097044,7857806,9862934,16672,12780,2010,15349,2018,3892,1323,1.0,0.0,118,2.0,42,1,0,693.0,0.4236763119697571,0.15175098180770874
11098563,5052489,5662712,16672,5752,1991,7915,1997,10920,8757,0.5,0.0,79,22.0,1,44,49,56.0,0.4157443940639496,0.3646395206451416
11096491,4899974,5393145,16672,5157,1990,6998,1995,11515,9674,1.0,0.0,44,14.0,4,25,1120,91.0,0.48884180188179016,0.3556680679321289
11102600,7787632,6292403,16672,12661,2010,9392,2001,4011,7280,1.0,0.0,14,16.0,5,29,42,1883.0,0.5315181612968445,0.36808234453201294
11096754,8945095,6383042,16672,14278,2015,9623,2002,2394,7049,0.5,0.0,243,15.0,25,5,0,175.0,0.36952927708625793,0.2852652072906494
11106424,8751026,4561522,16679,14040,2014,3652,1985,2639,13027,0.4,0.0,106,12.0,2,2,28,1946.0,0.6653490662574768,0.21389587223529816
11103875,6481654,5763973,16679,9819,2002,8195,1998,6860,8484,0.5,0.0,30,29.0,10,11,266,742.0,0.582345187664032,0.2353212684392929
11103269,10292701,10144469,16679,15846,2019,15678,2018,833,1001,1.0,0.0,223,2.0,45,14,0,161.0,0.617164134979248,0.2915401756763458
11105616,9844427,4601624,16679,15328,2017,3855,1986,1351,12824,0.6666666666666666,0.0,6,25.0,177,3,189,161.0,0.7421944737434387,0.34255853295326233
11105852,7284174,4768503,16679,11611,2007,4632,1988,5068,12047,1.0,0.0,9,31.0,3,7,490,343.0,0.50999516248703,0.08225628733634949
11103264,6364895,7777482,16679,9588,2002,12647,2010,7091,4032,0.5,0.0,378,11.0,9,9,42,21.0,0.4508651793003082,0.11786466091871262
11103516,8435561,7868213,16679,13641,2013,12794,2011,3038,3885,1.0,0.0,38,2.0,7,1,0,2562.0,0.537877082824707,0.0636923685669899
11107453,9857921,4418681,16679,15342,2018,2896,1983,1337,13783,0.0,0.0,10,7.0,9,1,56,826.0,0.21992477774620056,0.02767670899629593
11104616,6133181,5726705,16679,9056,2000,8104,1998,7623,8575,0.3333333333333333,0.3333333333333333,11,26.0,11,4,21,91.0,0.4720468521118164,0.2696845531463623
11103241,6939358,4136612,16679,10841,2005,1125,1979,5838,15554,0.5,0.0,1120,2.0,11,2,7,13713.0,0.28468865156173706,0.20532330870628357
11103243,5415334,5879282,16679,7075,1995,8468,1999,9604,8211,1.0,1.0,1613,5.0,14,4,0,287.0,0.3457326292991638,0.290206640958786
11110096,4704381,6850948,16686,4324,1987,10624,2005,12362,6062,0.5,0.0,102,13.0,1,4,182,2618.0,0.3001393675804138,0.07500312477350235
11111422,7858703,4161313,16686,12780,2010,1293,1979,3906,15393,0.5,0.0,6,28.0,3,2,105,91.0,0.5121005177497864,-0.010949582792818546
11112393,6329207,8039989,16686,9476,2001,13074,2011,7210,3612,0.0,0.0,6,2.0,12,16,1547,1848.0,0.5946936011314392,0.26036548614501953
11113158,8832324,8183554,16686,14131,2014,13291,2012,2555,3395,0.5,0.0,43,5.0,3,39,7,21.0,0.3972037136554718,0.18697203695774078
11114714,7022146,5056049,16686,11051,2006,5759,1991,5635,10927,1.0,0.0,7,24.0,11,5,42,84.0,0.34604600071907043,0.1274823695421219
11115160,5838268,10159825,16686,8356,1998,15699,2018,8330,987,0.0,0.0,143,3.0,2,72,42,63.0,0.47317078709602356,0.04733491316437721
11114464,8264065,6481958,16686,13403,2012,9819,2002,3283,6867,1.0,0.0,116,6.0,16,1,0,2044.0,0.16059966385364532,0.07582403719425201
11109858,5817093,5689346,16686,8314,1998,7992,1997,8372,8694,0.16666666666666666,0.0,1524,24.0,24,4,7,854.0,0.36575889587402344,0.08916333317756653
11114294,6238734,5281079,16686,9280,2001,6599,1994,7406,10087,0.5,0.0,169,17.0,6,4,0,518.0,0.44553011655807495,0.13700836896896362
11115500,6256671,6398200,16686,9315,2001,9651,2002,7371,7035,0.0,0.0,185,6.0,13,5,7,707.0,0.4332596957683563,0.1656099557876587
11109704,6224152,4153530,16686,9252,2001,1223,1979,7434,15463,1.0,0.0,39,8.0,18,4,273,13678.0,0.5645173788070679,0.3934233784675598
11112949,8212779,7825150,16686,13333,2012,12724,2010,3353,3962,0.3333333333333333,0.0,20,6.0,6,22,196,504.0,0.39705973863601685,0.25655031204223633
11114195,10166025,10156109,16686,15706,2019,15692,2018,980,994,0.3333333333333333,0.0,328,2.0,944,153,0,672.0,0.5835338830947876,0.2425508201122284
11114852,8086192,6464840,16686,13144,2011,9784,2002,3542,6902,0.5,0.0,126,17.0,1,7,126,196.0,0.3733009994029999,0.10341978073120117
11121742,7564360,10426918,16693,12255,2009,15979,2019,4438,714,0.0,0.0,21,2.0,9,86,21,259.0,0.6043693423271179,0.07171119749546051
11122669,8148357,7288828,16693,13242,2012,11625,2007,3451,5068,0.0,0.0,13,7.0,2,8,21,1498.0,0.02975626103579998,0.17794682085514069
11118120,8585889,4132594,16693,13837,2013,1097,1979,2856,15596,1.0,0.0,5,15.0,4,1,336,294.0,0.4440145790576935,0.22476428747177124
11117407,8590789,7730695,16693,13844,2013,12577,2010,2849,4116,0.0,0.0,460,7.0,50,8,35,63.0,0.2639094889163971,0.14927920699119568
11121216,7126212,10718094,16693,11254,2006,16273,2020,5439,420,1.0,0.0,108,2.0,75,8,56,238.0,0.48602110147476196,0.15093813836574554
11119415,6952253,5925628,16693,10869,2005,8601,1999,5824,8092,0.5,0.0,487,34.0,19,14,14,679.0,0.41412460803985596,-0.008909196592867374
11116407,7595878,10141254,16693,12325,2009,15671,2018,4368,1022,0.5,0.0,11,4.0,10,3,259,56.0,0.28600189089775085,0.055046435445547104
11118362,8925310,5458505,16693,14250,2015,7229,1995,2443,9464,0.2,0.0,4,41.0,10,2,91,14.0,0.49512574076652527,0.05419628694653511
11122669,7542251,4086623,16693,12206,2009,845,1978,4487,15848,0.09090909090909091,0.09090909090909091,62,5.0,6,2,21,10689.0,0.2627395689487457,0.15376140177249908
11116695,6683308,4154536,16693,10253,2004,1230,1979,6440,15463,0.0,0.0,32,17.0,4,2,42,1078.0,0.35966452956199646,0.29405540227890015
11124133,4920460,7214112,16700,5227,1990,11450,2007,11473,5250,0.3333333333333333,0.3333333333333333,20,7.0,2,8,98,399.0,0.3850807845592499,0.2529154121875763
11128292,8860471,6681806,16700,14166,2014,10253,2004,2534,6447,0.5,0.0,4,15.0,7,5,553,343.0,0.4325173795223236,0.30288031697273254
11125180,7693646,4685660,16700,12514,2010,4240,1987,4186,12460,0.0,0.0,14,6.0,1,1,203,21.0,0.5707061290740967,0.15447746217250824
11127508,5122331,5327195,16700,6011,1992,6760,1994,10689,9940,1.0,0.0,2,10.0,7,3,3318,1372.0,0.5660104751586914,0.28949519991874695
11124121,6859148,5444798,16700,10645,2005,7173,1995,6055,9527,0.0,0.0,329,17.0,10,4,0,2394.0,0.5185657143592834,0.4385109543800354
11132107,8055644,7480608,16707,13095,2011,12073,2009,3612,4634,1.0,1.0,38,7.0,1,11,35,1582.0,0.5504969358444214,0.16144932806491852
11129680,8784304,10460602,16707,14082,2014,16007,2019,2625,700,1.0,0.0,483,2.0,6,207,0,238.0,0.260136216878891,0.13188524544239044
11131959,8588647,5620124,16707,13837,2013,7775,1997,2870,8932,1.0,0.0,13,9.0,43,5,42,581.0,1.0,0.20469307899475098
11129715,5089015,8043317,16707,5892,1992,13081,2011,10815,3626,1.0,1.0,537,3.0,14,185,0,700.0,0.4413067698478699,0.40195631980895996
11133105,8008088,4289829,16707,13025,2011,2084,1981,3682,14623,0.0,0.0,442,7.0,53,4,0,6972.0,0.1775459200143814,0.1891716718673706
11129636,10159481,4872061,16707,15699,2018,5024,1989,1008,11683,0.2,0.0,213,11.0,26,9,0,5761.0,0.34783869981765747,0.2676948308944702
11129613,10729509,10769535,16707,16287,2020,16322,2020,420,385,1.0,0.0,53,3.0,4865,30,0,42.0,0.5364084839820862,0.26451781392097473
11131838,5963376,5354195,16707,8678,1999,6858,1994,8029,9849,0.25,0.0,13,24.0,4,11,2814,105.0,0.3764239251613617,0.0923483818769455
11129627,4781183,4110279,16707,4688,1988,971,1978,12019,15736,1.0,0.0,144,32.0,8,2,35,2863.0,0.3237632215023041,0.15970098972320557
11129928,4449969,7239057,16707,3064,1984,11506,2007,13643,5201,0.5,0.0,28,2.0,4,7,2093,686.0,0.3812328279018402,0.14362503588199615
11131472,5704221,10107028,16707,8041,1998,15636,2018,8666,1071,0.5,0.0,19,2.0,7,51,14,294.0,0.562854528427124,0.15444111824035645
11129611,6852219,8205597,16707,10631,2005,13326,2012,6076,3381,0.0,0.0,68,9.0,17,11,7,644.0,0.2974392771720886,0.20182499289512634
11129670,5394187,5432788,16707,6998,1995,7131,1995,9709,9576,0.0,0.0,216,4.0,5,3,0,4172.0,0.30694258213043213,0.19154243171215057
11135360,6689069,5662712,16714,10267,2004,7915,1997,6447,8799,0.3333333333333333,0.3333333333333333,32,22.0,42,44,119,98.0,0.23766133189201355,0.2170134037733078
11135489,7922605,5740547,16714,12885,2011,8139,1998,3829,8575,1.0,0.0,2,12.0,5,10,399,399.0,0.6623288989067078,0.2514825165271759
11137202,8317349,8654158,16714,13480,2012,13928,2014,3234,2786,0.5,0.0,2,6.0,4,1,1736,21.0,0.5749322175979614,0.37058183550834656
11134944,6325805,5851089,16714,9469,2001,8391,1998,7245,8323,1.0,0.0,814,24.0,38,11,0,294.0,0.3438490927219391,0.06135569140315056
11138299,7853925,4030801,16714,12766,2010,537,1977,3948,16177,1.0,0.0,36,21.0,4,1,0,84.0,0.4479843080043793,0.17583264410495758
11139308,7874726,7634941,16714,12808,2011,12409,2009,3906,4305,0.0,0.0,151,2.0,43,4,0,1904.0,0.21694177389144897,0.20869499444961548
11137887,10276261,4661139,16714,15825,2019,4135,1987,889,12579,1.0,0.0,1,15.0,1,8,889,7.0,0.4895244538784027,0.2540414035320282
11135785,8454788,10409074,16714,13669,2013,15958,2019,3045,756,0.0,0.0,11,1.0,161,2,273,756.0,0.4877151548862457,0.25046199560165405
11134947,7067038,5136585,16714,11135,2006,6060,1992,5579,10654,0.0,0.0,781,27.0,37,6,0,1617.0,0.14992643892765045,0.24253477156162262
11134978,7101373,4278472,16714,11205,2006,2021,1981,5509,14693,0.5,0.0,537,4.0,247,2,7,9212.0,0.18211603164672852,0.09732408076524734
11135416,9930297,8200374,16714,15426,2018,13312,2012,1288,3402,0.3333333333333333,0.0,9,13.0,266,3,35,154.0,0.22998635470867157,0.18680958449840546
11144915,8312519,5482564,16721,13466,2012,7313,1996,3255,9408,1.0,0.0,110,23.0,1,1,21,3220.0,0.3748490512371063,0.18867655098438263
11141156,5400267,6534196,16721,7019,1995,9938,2003,9702,6783,0.0,0.0,1390,4.0,10,8,0,777.0,0.180467888712883,0.14221322536468506
11142190,8965621,4226874,16721,14299,2015,1741,1980,2422,14980,0.3333333333333333,0.0,156,2.0,76,2,14,13314.0,0.6926708817481995,0.08444192260503769
11141663,8360845,4596835,16721,13543,2013,3827,1986,3178,12894,1.0,0.0,14,11.0,5,8,189,147.0,0.2911328375339508,0.025872159749269485
11141600,9827434,6642283,16721,15307,2017,10169,2003,1414,6552,1.0,0.0,4,4.0,74,2,203,4319.0,0.9169312119483948,0.15502622723579407
11142944,5238043,8015967,16721,6445,1993,13039,2011,10276,3682,1.0,0.0,7,3.0,1,19,1932,2898.0,0.5834516286849976,0.23107293248176575
11146656,6681370,4080047,16721,10246,2004,810,1978,6475,15911,0.5,0.0,120,7.0,10,1,56,1442.0,0.20951952040195465,0.12864667177200317
11141155,5439479,5498420,16721,7159,1995,7376,1996,9562,9345,1.0,1.0,1093,17.0,20,2,0,70.0,0.4572542905807495,0.11738207191228867
11141080,6138302,4798146,16721,9070,2000,4765,1989,7651,11956,1.0,0.0,84,6.0,7,3,154,8729.0,0.5244351029396057,0.09103367477655411
11140804,6158523,6187659,16721,9112,2000,9175,2001,7609,7546,0.3333333333333333,0.0,20,8.0,12,6,70,2303.0,0.32652950286865234,0.04536939412355423
11142555,7365240,4206340,16721,11807,2008,1615,1980,4914,15106,0.0,0.0,6,19.0,37,1,77,105.0,0.21967917680740356,0.15699324011802673
11144952,7272645,6271525,16721,11583,2007,9350,2001,5138,7371,1.0,0.0,31,8.0,18,4,1274,196.0,0.34695714712142944,0.19889123737812042
11141294,5709017,7398749,16721,8055,1998,11884,2008,8666,4837,0.0,0.0,27,6.0,1,7,91,1939.0,0.4822394549846649,0.20704659819602966
11147979,6479176,5735021,16728,9812,2002,8132,1998,6916,8596,0.0,0.0,13,14.0,35,6,245,966.0,0.30689284205436707,0.2770833373069763
11151468,7865439,7363655,16728,12787,2011,11800,2008,3941,4928,1.0,1.0,26,9.0,2,28,133,1015.0,0.24904054403305054,0.14998096227645874
11153266,6990591,6163209,16728,10981,2006,9119,2000,5747,7609,0.0,0.5,260,7.0,17,1,7,1232.0,0.4647147059440613,0.2113002985715866
11147665,6692512,6114475,16728,10274,2004,9014,2000,6454,7714,1.0,0.0,464,8.0,11,14,49,938.0,0.23092877864837646,0.0967763289809227
11150310,9400164,6813550,16728,14817,2016,10533,2004,1911,6195,0.5,0.5,4,6.0,56,2,315,805.0,0.3653241693973541,0.24340277910232544
11149123,7720036,6775107,16728,12556,2010,10449,2004,4172,6279,0.0,0.0,122,12.0,10,6,56,35.0,-0.04207877442240715,0.21732276678085327
11149308,5869717,4184202,16728,8440,1999,1475,1980,8288,15253,0.0,0.0,16,14.0,11,2,105,1750.0,0.04788826033473015,0.23957191407680511
11147653,5711666,4576897,16728,8062,1998,3729,1986,8666,12999,1.0,0.0,132,7.0,6,4,28,1792.0,0.7835039496421814,0.10045282542705536
11148327,7828533,9127559,16728,12731,2010,14495,2015,3997,2233,0.0,0.0,4,4.0,6,2,2275,140.0,0.279469758272171,0.3253413140773773
11147462,9031642,5046378,16728,14376,2015,5731,1991,2352,10997,1.0,0.0,24,5.0,2,2,35,1155.0,0.5126779079437256,0.1376854032278061
11149145,6303833,6721215,16728,9420,2001,10330,2004,7308,6398,0.0,0.0,11,4.0,2,3,651,3038.0,0.14360247552394867,0.11776384711265564
11147465,4706680,4677346,16728,4338,1987,4198,1987,12390,12530,1.0,0.0,107,11.0,3,3,196,4368.0,0.6592101454734802,0.26227399706840515
11157298,6324693,4597910,16735,9462,2001,3834,1986,7273,12901,1.0,0.0,1747,7.0,16,2,7,1281.0,0.2936249077320099,0.01090118009597063
11154298,4417890,4169122,16735,2889,1983,1363,1979,13846,15372,1.0,0.0,642,6.0,6,1,0,9170.0,0.31914064288139343,0.32256466150283813
11158652,6380046,4168698,16735,9616,2002,1363,1979,7119,15372,0.5,0.0,351,27.0,5,1,0,154.0,0.1679936647415161,0.1507614254951477
11154297,7625370,10411608,16735,12388,2009,15958,2019,4347,777,1.0,0.0,929,2.0,32,2,0,280.0,0.3912874758243561,0.0727350115776062
11157143,7441207,10808822,16735,11982,2008,16364,2020,4753,371,0.5,0.0,51,2.0,4,1,70,56.0,0.31622350215911865,0.2512260675430298
11154296,9539060,5559215,16735,14985,2017,7572,1996,1750,9163,0.3333333333333333,0.0,141,5.0,5,4,7,5698.0,0.13574649393558502,0.09479106217622757
11155150,9623742,7181657,16735,15083,2017,11373,2007,1652,5362,0.6666666666666666,0.0,14,13.0,18,10,77,1799.0,0.6353586316108704,0.11508971452713013
11154378,4920336,5886365,16735,5227,1990,8482,1999,11508,8253,0.0,0.0,136,62.0,5,6,7,224.0,0.4293002188205719,0.32298243045806885
11158559,7190064,5536187,16735,11394,2007,7502,1996,5341,9233,0.5,0.0,23,14.0,11,1,7,1484.0,0.4191725254058838,0.18093839287757874
11154946,4426565,10564212,16735,2938,1984,16119,2020,13797,616,1.0,0.0,29,2.0,1,6,119,126.0,0.5826754570007324,0.07534000277519226
11154298,6264617,9735469,16735,9336,2001,15202,2017,7399,1533,1.0,0.0,480,6.0,28,13,0,266.0,0.382466197013855,0.23844796419143677
11164955,8110099,7927506,16742,13186,2012,12892,2011,3556,3850,0.0,0.5,155,8.0,76,1,7,77.0,0.07356752455234528,0.23743201792240143
11164548,10178421,4166899,16742,15713,2019,1342,1979,1029,15400,0.0,0.0,13,5.0,25,2,14,3108.0,0.2862362861633301,0.19535504281520844
11160305,4753250,4098059,16742,4562,1988,915,1978,12180,15827,1.0,0.0,11,16.0,2,1,3892,28.0,0.35911986231803894,0.22616712749004364
11161696,8956099,4430403,16742,14292,2015,2959,1984,2450,13783,0.5,0.0,21,2.0,5,6,35,3276.0,0.33926406502723694,0.01214100606739521
11162211,7103989,10620121,16742,11212,2006,16175,2020,5530,567,0.25,0.2,6,2.0,8,6,2380,112.0,0.6745646595954895,0.2340652197599411
11160771,5738211,4660855,16742,8139,1998,4135,1987,8603,12607,0.0,0.0,23,16.0,4,2,91,147.0,0.08300741761922836,0.013613063842058182
11163387,9772722,4404753,16742,15244,2017,2819,1983,1498,13923,1.0,0.0,3,21.0,23,1,35,1890.0,0.34050339460372925,0.2928755581378937
11160551,7070597,7757766,16742,11142,2006,12619,2010,5600,4123,1.0,0.0,1360,4.0,130,38,7,1246.0,0.20136357843875885,0.0995011031627655
11170616,9858794,5203875,16749,15342,2018,6319,1993,1407,10430,0.3333333333333333,0.0,8,7.0,5,1,0,2156.0,0.4875350296497345,0.11394774913787842
11166759,7270660,4315044,16749,11583,2007,2231,1982,5166,14518,1.0,0.0,226,7.0,298,6,147,1862.0,0.6423850655555725,0.15234138071537018
11171790,7143288,4277349,16749,11289,2006,2014,1981,5460,14735,1.0,0.0,97,6.0,123,4,28,1491.0,0.5236284136772156,0.1618615984916687
11167126,8792993,6054028,16749,14089,2014,8881,2000,2660,7868,0.5,0.0,38,9.0,50,26,7,840.0,0.41810065507888794,0.13389094173908234
11169658,9589357,4037550,16749,15041,2017,572,1977,1708,16177,0.6666666666666666,0.0,58,26.0,4,1,7,350.0,0.34202203154563904,0.12513892352581024
11166727,7316655,4902072,16749,11695,2008,5164,1990,5054,11585,1.0,0.0,137,26.0,55,1,42,357.0,0.4783034026622772,0.4494752883911133
11168353,7267938,4082861,16749,11576,2007,824,1978,5173,15925,0.25,0.0,60,4.0,19,1,98,13601.0,0.25727686285972595,0.16977539658546448
11173021,5732432,4327810,16756,8125,1998,2315,1982,8631,14441,0.3333333333333333,0.0,52,6.0,3,1,525,2506.0,0.5072654485702515,0.10944010317325592
11173003,8220765,4293522,16756,13347,2012,2105,1981,3409,14651,0.0,0.0,3,32.0,26,6,357,1001.0,0.43577849864959717,0.09585709124803543
11173548,8310009,4585732,16756,13466,2012,3771,1986,3290,12985,0.0,0.0,29,7.0,7,3,182,9653.0,0.4822063744068146,0.30955132842063904
11173785,9672620,7678925,16756,15132,2017,12493,2010,1624,4263,0.2,0.0,1,6.0,2,6,1624,2772.0,0.49762922525405884,0.11705940216779709
11173272,4813280,9190808,16756,4828,1989,14565,2015,11928,2191,0.0,0.0,18,2.0,3,1,49,294.0,0.3234628438949585,0.27946460247039795
11173826,9725233,4231313,16756,15195,2017,1769,1980,1561,14987,0.3333333333333333,0.0,13,15.0,226,1,91,966.0,0.38354647159576416,0.2894324064254761
11179204,10180463,4449094,16763,15720,2019,3057,1984,1043,13706,0.16666666666666666,0.0,383,2.0,3806,2,0,12439.0,0.5751932263374329,0.12404337525367737
11179543,5647855,4130894,16763,7866,1997,1083,1978,8897,15680,1.0,0.0,108,8.0,12,4,7,10003.0,0.4228995144367218,0.17978061735630035
11183222,6208484,10522590,16763,9217,2001,16070,2019,7546,693,0.5,0.3333333333333333,64,1.0,9,6,735,693.0,0.42631644010543823,0.16383807361125946
11181879,8310272,6241659,16763,13466,2012,9287,2001,3297,7476,0.0,0.0,40,51.0,2,16,0,105.0,0.2578415870666504,0.24162761867046356
11183272,9862927,7890202,16763,15349,2018,12829,2011,1414,3934,0.5,0.0,1,2.0,2,8,1414,2765.0,0.2583238482475281,0.026401545852422714
11179155,4809695,10862417,16763,4814,1989,16413,2020,11949,350,0.5,0.0,1620,2.0,7,9,0,112.0,0.5016884803771973,0.17400038242340088
11179326,5610184,7078697,16763,7740,1997,11156,2006,9023,5607,1.0,0.0,72,21.0,1,7,14,665.0,0.17944878339767456,-0.011282019317150116
11184680,6999432,4753080,16763,11002,2006,4562,1988,5761,12201,1.0,0.0,186,19.0,7,4,105,763.0,0.3186773359775543,0.22485008835792542
11179180,10231768,4466890,16763,15783,2019,3155,1984,980,13608,1.0,0.0,1,18.0,321,3,980,1421.0,0.7238548994064331,0.18627654016017914
11185441,10363214,10477369,16770,15916,2019,16021,2019,854,749,0.5,0.0,1,2.0,5,1,854,266.0,0.38224074244499207,0.1357729583978653
11185837,9889423,4172449,16770,15384,2018,1398,1979,1386,15372,1.0,0.0,20,29.0,434,3,217,336.0,1.0,0.03424663469195366
11190597,10616347,6430802,16770,16168,2020,9721,2002,602,7049,1.0,0.0,2,11.0,15,11,56,287.0,0.5221540927886963,0.10211127251386642
11190139,9641141,4190300,16770,15097,2017,1517,1980,1673,15253,1.0,0.0,22,10.0,4,1,147,245.0,0.4739469587802887,0.1462130844593048
11187625,8985010,4545888,16770,14327,2015,3568,1985,2443,13202,0.0,0.5,1,13.0,8,2,2443,476.0,0.40717920660972595,0.3525046110153198
11185770,7169050,5756846,16770,11352,2007,8181,1998,5418,8589,0.5,0.0,127,5.0,2,8,7,7658.0,0.4496496319770813,0.10029418021440506
11187859,7341382,8841751,16770,11758,2008,14145,2014,5012,2625,1.0,0.0,9,5.0,13,79,42,616.0,0.5266345143318176,0.13581499457359314
11189286,7236773,9767284,16770,11499,2007,15237,2017,5271,1533,0.0,0.5,948,6.0,8,1126,0,448.0,0.3355443775653839,0.19561512768268585
11185703,7606621,6925636,16770,12346,2009,10806,2005,4424,5964,1.0,0.0,169,8.0,73,5,35,1855.0,0.2938562333583832,0.10997530817985535
11185592,10905768,8004538,16770,16469,2021,13018,2011,301,3752,1.0,0.0,1,3.0,9,3,301,2954.0,0.8484683036804199,0.15071523189544678
11191482,6083486,5702847,16777,8951,2000,8034,1997,7826,8743,0.3333333333333333,0.0,102,17.0,7,12,21,140.0,0.3057968020439148,0.32006675004959106
11191887,5344415,9850835,16777,6823,1994,15335,2017,9954,1442,1.0,0.0,812,1.0,2,5,7,1442.0,0.306751549243927,0.3992074429988861
11192030,7641549,10269433,16777,12423,2010,15818,2019,4354,959,0.6666666666666666,0.0,28,2.0,98,9,140,406.0,0.48929640650749207,0.12007517367601395
11192028,8131740,9527699,16777,13214,2012,14971,2016,3563,1806,0.0,0.0,61,8.0,6,30,7,63.0,0.2353590726852417,0.1995640993118286
11194680,9292327,10132991,16777,14691,2016,15664,2018,2086,1113,0.5,0.0,37,2.0,14,5,70,434.0,0.3980421721935272,0.1392672210931778
11193318,6378169,10005821,16777,9616,2002,15517,2018,7161,1260,1.0,0.0,21,2.0,10,1,63,161.0,0.5287790298461914,0.012437384575605392
11199929,8553333,5170129,16784,13795,2013,6186,1992,2989,10598,0.2,0.0,13,10.0,4,2,7,133.0,0.371345192193985,0.2869435250759125
11197415,5375398,4778165,16784,6935,1994,4674,1988,9849,12110,1.0,0.0,8,14.0,6,6,56,770.0,0.542443037033081,0.3473958373069763
11197670,7188758,7152828,16784,11394,2007,11317,2006,5390,5467,0.5,0.0,1290,9.0,135,13,7,420.0,0.38700270652770996,0.26826611161231995
11198604,5989317,10631716,16784,8727,1999,16189,2020,8057,595,0.0,0.0,10,3.0,2,20,833,259.0,0.31383657455444336,0.1081848293542862
11202247,8638228,4832537,16784,13907,2014,4891,1989,2877,11893,0.0,0.0,73,8.0,49,4,35,1204.0,0.16542913019657135,0.18355175852775574
11199835,6502042,5660541,16784,9861,2002,7908,1997,6923,8876,0.2,0.0,53,6.0,5,16,7,854.0,0.30419856309890747,0.16573625802993774
11200620,8468028,5862272,16784,13683,2013,8419,1999,3101,8365,1.0,1.0,16,8.0,4,3,49,2282.0,0.3344455361366272,0.21996046602725983
11201581,7797883,4515830,16784,12682,2010,3414,1985,4102,13370,0.25,0.0,35,2.0,19,10,91,12474.0,0.5026687979698181,0.24609237909317017
11200341,8474012,7329275,16784,13690,2013,11730,2008,3094,5054,1.0,0.0,103,4.0,3,29,7,266.0,0.6668389439582825,0.07731473445892334
11197613,7096070,5597213,16784,11191,2006,7698,1997,5593,9086,1.0,0.0,112,24.0,37,6,63,882.0,0.48071303963661194,0.19848796725273132
11202132,8489765,4915490,16784,13711,2013,5213,1990,3073,11571,0.5,0.0,110,13.0,13,2,56,714.0,0.4035712480545044,0.055941563099622726
11206309,6639584,4450316,16791,10162,2003,3064,1984,6629,13727,0.0,0.0,380,27.0,7,1,7,1162.0,0.35544994473457336,0.10562645643949509
11202707,7458981,4361817,16791,12024,2008,2525,1982,4767,14266,1.0,0.0,202,3.0,57,2,14,10437.0,0.3331679701805115,0.21940113604068756
11204769,6704860,4013929,16791,10295,2004,446,1977,6496,16345,1.0,0.0,71,35.0,2,2,49,2954.0,0.31515398621559143,0.24702420830726624
11203561,4966658,9926066,16791,5416,1990,15426,2018,11375,1365,1.0,0.0,27,2.0,4,11,910,343.0,0.48424232006073,0.060071125626564026
11202631,7631794,4941503,16791,12402,2009,5311,1990,4389,11480,1.0,0.0,1034,12.0,174,2,7,1540.0,0.44296786189079285,0.36047983169555664
11202570,9924941,9073134,16791,15426,2018,14432,2015,1365,2359,0.25,0.0,313,6.0,29,9,7,161.0,0.4196164906024933,0.10520659387111664
11202633,10463382,5680843,16791,16014,2019,7971,1997,777,8820,0.3333333333333333,0.0,185,5.0,7,6,0,2254.0,0.24962268769741058,0.1425010710954666
11202569,6694191,4021527,16791,10274,2004,488,1977,6517,16303,0.5,0.0,1089,14.0,17,1,14,1211.0,0.5646746754646301,0.0230387095361948
11203896,7930866,4683163,16791,12899,2011,4226,1987,3892,12565,0.0,0.0,13,5.0,145,9,105,4053.0,0.354194700717926,0.29304611682891846
11205585,5027746,6259470,16791,5661,1991,9322,2001,11130,7469,0.5,0.0,298,27.0,4,21,42,133.0,0.36823007464408875,0.21389172971248627
11207150,6377011,6011521,16798,9609,2002,8769,2000,7189,8029,0.25,0.0,745,5.0,13,4,0,1484.0,0.33715304732322693,0.2721717357635498
11208539,5275796,5380724,16798,6578,1994,6949,1995,10220,9849,0.6666666666666666,0.0,93,11.0,5,3,105,98.0,0.713132917881012,0.07098665833473206
11210420,7844640,5032593,16798,12752,2010,5675,1991,4046,11123,1.0,0.0,54,18.0,2,4,14,3045.0,0.3964962959289551,0.09129450470209122
11209543,7579954,6611053,16798,12290,2009,10099,2003,4508,6699,0.0,0.0,2,2.0,6,27,3199,3290.0,0.21385616064071655,0.36767736077308655
11207187,6979353,6901413,16798,10953,2005,10743,2005,5845,6055,1.0,0.0,169,10.0,38,9,70,861.0,0.6148667931556702,0.1063171848654747
11207168,5263974,7976402,16798,6536,1993,12976,2011,10262,3822,1.0,0.0,47,3.0,2,6,28,105.0,0.183004692196846,0.2234937995672226
11211161,8303505,4237346,16798,13459,2012,1797,1980,3339,15001,0.2,0.2,132,2.0,159,1,0,14210.0,0.485140860080719,0.21413446962833405
11212656,4749254,6146516,16798,4541,1988,9084,2000,12257,7714,0.0,0.0,42,2.0,8,3,105,6083.0,0.17449748516082764,-0.0005047377198934555
11206931,6704949,5533480,16798,10302,2004,7495,1996,6496,9303,1.0,0.0,38,5.0,33,27,287,7175.0,0.6881426572799683,0.10053899139165878
11207118,6228081,5295639,16798,9259,2001,6655,1994,7539,10143,1.0,0.0,1209,7.0,8,14,0,6020.0,0.3645438253879547,0.16735470294952393
11207547,10532230,5595029,16798,16084,2020,7691,1997,714,9107,0.5,0.0,4,12.0,676,7,35,490.0,0.653863251209259,0.18405605852603912
11207064,10542974,5495275,16798,16098,2020,7362,1996,700,9436,0.5,0.0,131,10.0,4523,2,7,469.0,0.6731829643249512,0.1708907186985016
11208159,7942470,5355096,16798,12920,2011,6858,1994,3878,9940,0.6666666666666666,0.0,42,17.0,44,5,280,1519.0,0.31572920083999634,0.2528972327709198
11213302,5674184,6215012,16805,7950,1997,9231,2001,8855,7574,0.5,0.0,313,7.0,23,3,0,1218.0,0.3140905201435089,0.15525195002555847
11214479,7597220,5131967,16805,12332,2009,6046,1992,4473,10759,0.0,0.0,4,10.0,1,10,224,77.0,0.4448082447052002,0.16548173129558563
11216063,9694155,8730149,16805,15160,2017,14019,2014,1645,2786,0.5,0.25,7,2.0,5,1,133,154.0,0.6754929423332214,0.21579819917678833
11218012,5363031,4468938,16805,6886,1994,3169,1984,9919,13636,0.5,0.0,57,15.0,18,4,1232,56.0,0.514514684677124,0.0885201096534729
11215360,4745868,7511580,16805,4527,1988,12143,2009,12278,4662,0.5,0.0,22,2.0,28,15,1183,4165.0,0.4828837513923645,0.16121569275856018
11213410,7241308,4541478,16805,11513,2007,3547,1985,5292,13258,1.0,0.0,96,4.0,62,2,98,8652.0,0.4145987033843994,0.20354445278644562
11218035,6483221,5684182,16805,9819,2002,7978,1997,6986,8827,1.0,0.0,35,4.0,4,3,210,6146.0,0.4253290593624115,0.11706068366765976
11218461,6295530,6839185,16805,9399,2001,10596,2005,7406,6209,0.5,0.0,1758,23.0,23,13,0,504.0,0.3331836462020874,0.06576826423406601
11217704,9006803,6845373,16805,14348,2015,10610,2005,2457,6195,1.0,0.0,9,7.0,29,10,126,2219.0,0.7403647303581238,0.2067319005727768
11217444,6207936,4482693,16805,9217,2001,3239,1984,7588,13566,0.0,0.0,159,2.0,26,7,14,6489.0,-0.015165764838457108,0.18800130486488342
11216742,7365455,4104185,16805,11807,2008,943,1978,4998,15862,0.0,0.0,50,19.0,12,1,28,287.0,0.3655795156955719,0.18531009554862976
11217251,9101279,7105044,16805,14467,2015,11212,2006,2338,5593,0.16666666666666666,0.0,163,15.0,2,9,0,672.0,0.43080848455429077,0.2543276846408844
11219455,5221036,4366905,16812,6382,1993,2560,1983,10430,14252,1.0,0.0,1489,32.0,4,3,7,322.0,0.5900595784187317,0.24830330908298492
11219527,8062378,4640816,16812,13109,2011,4051,1987,3703,12761,1.0,0.0,22,3.0,47,9,231,63.0,0.5778781771659851,0.13438855111598969
11219746,8840663,7187790,16812,14145,2014,11387,2007,2667,5425,1.0,0.0,289,28.0,421,8,0,63.0,0.2604478895664215,0.31648561358451843
11223372,10168938,5598070,16812,15706,2019,7698,1997,1106,9114,0.25,0.0,1,14.0,1,17,1106,1827.0,0.37218618392944336,0.3308908939361572
11221262,7182362,7934447,16812,11380,2007,12906,2011,5432,3906,0.0,0.0,15,18.0,18,21,98,567.0,0.33242321014404297,0.13602536916732788
11220541,7491391,6509028,16812,12101,2009,9882,2003,4711,6930,0.6666666666666666,0.3333333333333333,47,8.0,14,54,161,28.0,0.4565775990486145,0.21490800380706787
11219745,8608754,5143756,16812,13865,2013,6088,1992,2947,10724,1.0,0.0,28,3.0,27,12,0,3437.0,0.5043215751647949,0.04024882987141609
11221191,10458743,8562300,16812,16007,2019,13809,2013,805,3003,1.0,0.0,5,2.0,27,39,49,896.0,0.621986448764801,0.20542649924755096
11223105,9977460,7432432,16812,15482,2018,11968,2008,1330,4844,0.25,0.0,8,6.0,12,5,21,532.0,0.554746150970459,0.08696070313453674
11219631,6969521,9259834,16812,10925,2005,14656,2016,5887,2156,0.5,0.25,86,3.0,26,46,133,1435.0,0.2650369107723236,0.14374926686286926
11220698,9556102,4558943,16812,15006,2017,3638,1985,1806,13174,0.2,0.0,24,10.0,133,3,350,616.0,0.7339707016944885,0.13916613161563873
11219391,5854706,7364032,16812,8398,1998,11807,2008,8414,5005,0.0,0.0,14,7.0,3,12,266,1022.0,0.04831745848059654,0.171469047665596
11224423,5738474,6937972,16819,8139,1998,10834,2005,8680,5985,0.3333333333333333,0.0,1049,6.0,13,10,7,154.0,0.2556871473789215,0.29996752738952637
11228551,6167435,4768944,16819,9126,2000,4632,1988,7693,12187,0.0,0.0,392,3.0,3,2,14,9807.0,0.3374682366847992,0.20252078771591187
11224895,5735280,9959168,16819,8132,1998,15461,2018,8687,1358,0.0,0.0,420,5.0,6,9,21,322.0,0.30891740322113037,0.2296319305896759
11227589,9755605,9547696,16819,15223,2017,14992,2017,1596,1827,0.0,0.5,51,5.0,4,8,14,35.0,0.2524455189704895,0.38039371371269226
11224497,7467740,5618214,16819,12045,2008,7768,1997,4774,9051,0.3333333333333333,0.0,1331,8.0,357,9,0,217.0,0.49387502670288086,0.30765801668167114
11228520,7127633,7938635,16819,11254,2006,12913,2011,5565,3906,0.5,0.0,179,3.0,12,67,49,714.0,0.27419233322143555,0.024281715974211693
11224427,8851354,7442631,16819,14159,2014,11989,2008,2660,4830,1.0,0.0,1080,6.0,315,25,0,1841.0,0.5686079859733582,0.17042440176010132
11224367,4762603,5800465,16819,4604,1988,8279,1998,12215,8540,0.0,1.0,24,13.0,6,37,91,7.0,0.34796378016471863,0.3849508762359619
11224428,9463040,4671257,16819,14894,2016,4177,1987,1925,12642,0.5,1.0,501,25.0,4,14,0,245.0,0.21419104933738708,0.20963463187217712
11229147,7623360,4782345,16819,12381,2009,4688,1988,4438,12131,0.5,0.0,24,18.0,90,1,28,476.0,0.5619608163833618,0.183900386095047
11224693,6653091,7411628,16819,10190,2003,11912,2008,6629,4907,0.0,0.0,432,9.0,10,17,77,1015.0,0.33102384209632874,0.1923966109752655
11228620,9215076,4212248,16819,14593,2015,1657,1980,2226,15162,0.5,0.0,147,8.0,54,1,0,7602.0,0.34275200963020325,0.34525060653686523
11226106,7614877,9370768,16819,12367,2009,14782,2016,4452,2037,0.0,0.0,16,2.0,17,1,105,1666.0,0.4847763180732727,0.09628966450691223
11229140,8817460,4185882,16819,14117,2014,1489,1980,2702,15330,0.3333333333333333,0.0,6,22.0,3,2,735,7504.0,0.35075145959854126,0.37642642855644226
11226179,9335137,6426248,16819,14740,2016,9707,2002,2079,7112,0.25,0.0,109,12.0,93,8,14,469.0,0.523809015750885,0.1375800520181656
11229437,8967446,9903262,16826,14306,2015,15398,2018,2520,1428,0.5,0.0,843,1.0,92,2,7,1428.0,0.3803187906742096,0.11875541508197784
11233821,7444404,6018347,16826,11989,2008,8790,2000,4837,8036,0.5,0.0,312,26.0,5,3,42,483.0,0.4153083562850952,0.1562933325767517
11232916,7531921,6798604,16826,12185,2009,10498,2004,4641,6328,0.25,0.0,45,4.0,4,3,476,644.0,0.48634642362594604,0.31722158193588257
11231258,10591260,6547919,16826,16147,2020,9966,2003,679,6860,0.25,0.0,21,5.0,119,4,0,910.0,0.7392702102661133,0.24401892721652985
11229209,5367018,4704175,16826,6900,1994,4324,1987,9926,12502,0.0,0.0,2,4.0,4,2,8260,2184.0,0.27820923924446106,0.29579371213912964
11229725,8071135,9536275,16826,13123,2011,14978,2017,3703,1848,0.5,0.0,85,3.0,79,4,7,630.0,0.5355510711669922,0.1272767186164856
11232659,6008726,5225850,16826,8762,1999,6396,1993,8064,10430,0.0,0.0,5,12.0,6,6,1932,3549.0,0.47194474935531616,0.40445566177368164
11233055,7791074,4787691,16826,12668,2010,4716,1988,4158,12110,0.5,0.3333333333333333,464,37.0,10,10,14,945.0,0.440981388092041,0.13885566592216492
11231382,8094023,6830474,16826,13158,2012,10575,2004,3668,6251,0.0,0.25,34,14.0,6,14,147,1764.0,0.31139886379241943,0.12270856648683548
11232427,5615110,9136782,16826,7754,1997,14502,2015,9072,2324,0.5,0.0,189,2.0,7,5,21,1715.0,0.5245126485824585,0.23987407982349396
11231755,9030446,7371896,16826,14376,2015,11821,2008,2450,5005,1.0,0.0,61,4.0,17,5,14,2856.0,0.14915046095848083,0.022731399163603783
11229328,5313676,7272503,16826,6718,1994,11583,2007,10108,5243,1.0,0.0,16,9.0,1,2,567,910.0,0.4083094000816345,0.2503206133842468
11229525,6764491,10330504,16826,10428,2004,15881,2019,6398,945,1.0,0.0,353,2.0,88,18,7,63.0,0.4700288772583008,0.27891185879707336
11235159,8515559,4411008,16833,13746,2013,2847,1983,3087,13986,1.0,0.0,86,24.0,8,10,14,259.0,0.4427902400493622,0.2966327667236328
11235294,6748332,10367850,16833,10386,2004,15916,2019,6447,917,0.3333333333333333,0.0,41,1.0,55,12,14,917.0,0.4224734306335449,0.15929828584194183
11236811,8641575,6656347,16833,13914,2014,10197,2003,2919,6636,1.0,0.0,4,2.0,11,28,126,238.0,0.4317169785499573,0.017502475529909134
11239372,5731856,8443931,16833,8118,1998,13655,2013,8715,3178,0.0,0.0,3620,2.0,3,23,0,2317.0,0.3506975769996643,0.16867373883724213
11237738,11093317,6424733,16833,16665,2021,9700,2002,168,7133,1.0,1.0,2,12.0,5,9,14,168.0,0.5913127064704895,0.27157971262931824
11238777,9312284,5623992,16833,14712,2016,7789,1997,2121,9044,1.0,0.0,9,11.0,13,5,203,6286.0,0.4518212378025055,0.15914709866046906
11240275,9838411,4425771,16833,15314,2017,2938,1984,1519,13895,0.3333333333333333,0.0,101,14.0,264,3,0,679.0,0.6228208541870117,0.22192196547985077
11234760,6656175,9111435,16833,10197,2003,14474,2015,6636,2359,1.0,0.0,299,4.0,16,2,35,322.0,0.4336857497692108,0.2854977548122406
11235125,6346120,10684346,16833,9539,2002,16238,2020,7294,595,1.0,0.0,183,1.0,6,2,7,595.0,0.20853349566459656,0.1471019983291626
11234521,6848746,4141876,16833,10624,2005,1153,1979,6209,15680,1.0,0.0,48,24.0,26,3,343,1939.0,0.38771477341651917,0.15338574349880219
11242393,6521404,5632234,16840,9910,2003,7817,1997,6930,9023,0.6666666666666666,0.0,137,10.0,19,3,0,756.0,0.3772643804550171,0.10625610500574112
11241754,7358458,9196983,16840,11793,2008,14572,2015,5047,2268,0.5,0.0,86,12.0,17,2,91,112.0,0.35815444588661194,0.20770546793937683
11246224,7129158,6167299,16840,11261,2006,9126,2000,5579,7714,0.0,0.0,49,32.0,6,3,231,35.0,0.6614784598350525,0.0762711614370346
11242983,9062866,5332663,16840,14418,2015,6781,1994,2422,10059,1.0,0.0,33,4.0,25,3,14,6657.0,0.5586851239204407,0.0993763655424118
11243091,9778054,5432788,16840,15251,2017,7131,1995,1589,9709,0.5,0.0,2,4.0,5,3,336,4305.0,0.5697471499443054,0.27040940523147583
11244334,10853831,4150580,16840,16406,2020,1209,1979,434,15631,1.0,0.0,5,33.0,95,1,42,259.0,0.6562131643295288,0.21589389443397522
11246590,8652155,9476642,16847,13928,2014,14908,2016,2919,1939,1.0,0.0,396,6.0,242,10,7,623.0,0.41998291015625,0.14443616569042206
11246590,6010513,7567167,16847,8769,2000,12262,2009,8078,4585,1.0,0.0,954,5.0,24,16,0,1750.0,0.3003963828086853,0.10494717955589294
11251035,8741062,10520527,16847,14033,2014,16070,2019,2814,777,0.5,0.5,115,2.0,4,1,7,182.0,0.5317398309707642,0.17984439432621002
11246656,8790341,4738028,16847,14089,2014,4492,1988,2758,12355,1.0,0.0,31,10.0,41,1,35,56.0,0.5584559440612793,0.15861594676971436
11246641,6716252,5260133,16847,10323,2004,6522,1993,6524,10325,1.0,0.0,61,3.0,94,7,0,791.0,0.38067108392715454,0.17711755633354187
11250391,8577336,4503183,16847,13823,2013,3351,1985,3024,13496,0.0,0.0,192,11.0,2,6,14,3724.0,0.46186718344688416,0.041744790971279144
11249270,7006748,7417684,16847,11016,2006,11926,2008,5831,4921,1.0,0.0,148,3.0,21,31,42,1792.0,0.6001678109169006,0.2988014817237854
11246587,6047861,9855369,16847,8867,2000,15342,2018,7980,1505,0.0,0.14285714285714285,973,2.0,19,31,7,98.0,0.2458726018667221,0.3790416419506073
11250286,9350714,8324095,16847,14754,2016,13487,2012,2093,3360,0.0,0.0,16,9.0,9,8,14,238.0,0.38830792903900146,0.29643264412879944
11246672,10376672,4611834,16847,15930,2019,3911,1986,917,12936,0.5,0.0,5,10.0,99,8,42,637.0,0.510310709476471,0.2071104645729065
11250383,6801916,7550929,16847,10505,2004,12227,2009,6342,4620,0.25,0.0,83,4.0,26,7,0,3269.0,0.15092474222183228,0.2574087977409363
11246592,7840253,6566095,16847,12745,2010,10001,2003,4102,6846,1.0,0.5,346,5.0,522,9,0,1176.0,0.4886663258075714,0.07248187810182571
11248219,7709228,3987216,16847,12542,2010,292,1976,4305,16555,0.6666666666666666,0.0,24,6.0,8,1,196,11221.0,0.43888118863105774,0.14115716516971588
11246704,10231837,5051879,16847,15783,2019,5745,1991,1064,11102,1.0,0.0,79,6.0,118,1,14,749.0,0.2364046424627304,0.3401718735694885
11251149,7495473,5930065,16847,12108,2009,8608,1999,4739,8239,0.0,0.0,160,8.0,6,5,28,1302.0,0.3489755094051361,0.241547092795372
11246688,8738165,5311554,16847,14026,2014,6704,1994,2821,10143,0.5,0.0,28,19.0,29,7,91,2156.0,0.575376570224762,0.21341589093208313
11246592,6527782,8514743,16847,9924,2003,13746,2013,6923,3101,1.0,0.0,938,3.0,12,2,0,2198.0,0.4046519994735718,0.22016207873821259
11255147,5316087,4305060,16854,6725,1994,2168,1981,10129,14686,1.0,0.0,61,25.0,2,4,63,161.0,0.602946937084198,0.31905463337898254
11253256,10321907,4161538,16854,15874,2019,1293,1979,980,15561,0.2,0.5,363,8.0,2670,2,0,3220.0,0.4473796486854553,0.1274682879447937
11253256,9962158,6814748,16854,15468,2018,10540,2004,1386,6314,1.0,1.0,524,9.0,2629,59,0,21.0,0.675386369228363,0.4984644055366516
11257504,6469712,4677407,16854,9791,2002,4198,1987,7063,12656,0.25,0.0,238,11.0,8,3,35,10255.0,0.4289877116680145,0.1615770161151886
11254481,5125529,7636759,16854,6025,1992,12409,2009,10829,4445,1.0,0.0,69,16.0,5,8,154,1393.0,0.3229597210884094,0.024233579635620117
11253591,7202346,9123520,16854,11422,2007,14488,2015,5432,2366,0.5,0.0,30,4.0,6,1,140,245.0,0.4076954126358032,0.04191013425588608
11255649,10571230,4158284,16854,16126,2020,1265,1979,728,15589,1.0,0.0,27,8.0,143,3,0,861.0,0.8990013003349304,0.03186103329062462
11253254,5810846,re39778,16854,8300,1998,11555,2007,8554,5299,1.0,0.0,1068,2.0,81,21,7,3682.0,0.39104554057121277,0.21125702559947968
11255147,7193527,5073516,16854,11401,2007,5829,1991,5453,11025,0.0,0.0,32,18.0,24,1,7,518.0,0.4421156942844391,0.29006919264793396
11256075,5550672,10131901,16854,7544,1996,15664,2018,9310,1190,1.0,0.0,28,3.0,17,61,7,560.0,0.4837223291397095,0.00822111964225769
11253705,8359102,5541410,16854,13536,2013,7516,1996,3318,9338,1.0,0.0,128,3.0,82,3,7,3087.0,0.5169651508331299,0.05918239802122116
11253661,9361772,9527568,16854,14768,2016,14971,2016,2086,1883,0.0,0.0,15,2.0,8,7,182,938.0,0.5983977913856506,0.04603535309433937
11255760,6275290,5270287,16854,9357,2001,6557,1993,7497,10297,1.0,0.0,33,2.0,18,3,7,7252.0,0.5144718885421753,0.09856133162975311
11258449,9673795,4853449,16854,15132,2017,4961,1989,1722,11893,0.5,0.0,1,22.0,5,2,1722,560.0,0.6689748167991638,0.03435772284865379
11255160,5517024,5649045,16854,7439,1996,7866,1997,9415,8988,0.0,0.0,46,27.0,6,18,77,819.0,0.2687739133834839,0.193232923746109
11255596,9920517,9794233,16854,15419,2018,15265,2017,1435,1589,0.0,0.0,55,2.0,34,10,7,966.0,0.1321338266134262,0.251773476600647
11259792,5733306,4212695,16861,8125,1998,1657,1980,8736,15204,1.0,0.0,392,2.0,3,2,7,12271.0,0.5796833038330078,0.22510471940040588
11259799,8359174,7463673,16861,13536,2013,12031,2008,3325,4830,0.0,0.0,332,19.0,2,2,7,1036.0,0.06382503360509872,0.1654239147901535
11259805,5275322,5505618,16861,6578,1994,7404,1996,10283,9457,1.0,1.0,1032,11.0,1,3,0,3577.0,0.571754515171051,0.31082743406295776
11261424,5972710,8428546,16861,8699,1999,13627,2013,8162,3234,0.0,0.0,268,2.0,27,6,28,56.0,0.2720937132835388,0.12208258360624313
11263077,5705956,7732436,16861,8041,1998,12577,2010,8820,4284,0.3333333333333333,0.0,15,2.0,3,10,28,553.0,0.30304738879203796,0.05370020121335983
11263382,8302855,4787390,16861,13459,2012,4716,1988,3402,12145,0.5,0.0,230,8.0,3,4,14,1631.0,0.3914485275745392,0.28417301177978516
11260212,5843158,7161965,16861,8370,1998,11331,2007,8491,5530,1.0,0.0,666,2.0,29,9,0,28.0,0.40743565559387207,0.15981678664684296
11259805,6729119,5498751,16861,10351,2004,7376,1996,6510,9485,0.3333333333333333,0.0,872,14.0,9,14,0,532.0,0.4219443202018738,0.2683337926864624
11259830,9055870,4231557,16861,14411,2015,1769,1980,2450,15092,0.3333333333333333,0.0,10,16.0,37,2,0,406.0,0.2938229739665985,0.17340022325515747
11259787,5269794,7614827,16861,6557,1993,12367,2009,10304,4494,1.0,0.0,95,6.0,7,10,7,126.0,0.292166143655777,0.24218694865703583
11268075,5854033,5168642,16868,8398,1998,6186,1992,8470,10682,1.0,0.0,723,5.0,5,2,7,21.0,0.3654080331325531,-0.023425202816724777
11268048,9902922,9185547,16868,15398,2018,14558,2015,1470,2310,1.0,0.0,1,4.0,4,1,1470,1071.0,0.5874951481819153,0.17230010032653809
11266381,6592529,5384079,16868,10057,2003,6963,1995,6811,9905,1.0,0.0,22,17.0,9,9,14,224.0,0.47955700755119324,0.2093876451253891
11270699,6225776,9788893,16868,9252,2001,15265,2017,7616,1603,0.0,0.0,163,3.0,8,20,77,455.0,0.22333469986915588,0.09052181988954544
11266459,7631689,4960640,16868,12402,2009,5388,1990,4466,11480,0.0,0.0,156,7.0,616,3,168,4991.0,0.22980108857154846,0.3026820123195648
11266554,6112867,4922534,16868,9014,2000,5234,1990,7854,11634,0.0,0.0,8,26.0,4,19,147,2674.0,0.2955767810344696,0.12001202255487442
11268633,4835823,4202681,16868,4905,1989,1594,1980,11963,15274,0.0,0.0,18,28.0,3,3,931,182.0,0.3886048197746277,0.15003395080566406
11269149,7805029,6042439,16868,12689,2010,8853,2000,4179,8015,0.25,0.0,226,8.0,22,4,7,1435.0,0.4669351279735565,0.22260750830173492
11266468,8239066,5928283,16868,13368,2012,8608,1999,3500,8260,0.0,0.5,145,10.0,610,12,7,217.0,0.24061936140060425,0.2674066722393036
11270161,9904995,4217580,16868,15398,2018,1685,1980,1470,15183,1.0,0.0,2,2.0,1,6,553,847.0,0.25512707233428955,0.11452978849411011
11266335,4633878,6341166,16868,4023,1987,9518,2002,12845,7350,1.0,0.0,512,9.0,5,4,7,14.0,0.41363653540611267,0.13278207182884216
11271508,8217533,6760527,16868,13340,2012,10414,2004,3528,6454,1.0,0.0,27,8.0,16,13,112,2310.0,0.39311662316322327,-0.057879507541656494
11273064,7087032,5655499,16875,11177,2006,7894,1997,5698,8981,1.0,0.0,61,7.0,2,3,14,651.0,0.3801620602607727,0.2741035521030426
11272927,7517356,5238392,16875,12157,2009,6445,1993,4718,10430,1.0,0.0,1218,3.0,47,8,7,5327.0,0.5235504508018494,0.23187944293022156
11274189,6281296,5289284,16875,9371,2001,6627,1994,7504,10248,1.0,0.0,65,8.0,11,10,63,868.0,0.49588125944137573,0.15302921831607819
11272872,8560046,6605830,16875,13802,2013,10085,2003,3073,6790,0.5,0.0,91,20.0,54,1,21,49.0,0.4577169120311737,0.3607177138328552
11272938,5292053,7873572,16875,6641,1994,12801,2011,10234,4074,0.5,0.0,1412,9.0,4,65,0,434.0,0.5900092720985413,0.25633159279823303
11275144,7613580,4657372,16875,12360,2009,4121,1987,4515,12754,0.0,0.0,14,39.0,1,13,21,1050.0,0.6990764737129211,0.12867435812950134
11273421,8668430,9658773,16875,13949,2014,15118,2017,2926,1757,0.0,0.0,117,3.0,4,3,7,1085.0,0.389021635055542,0.26944437623023987
11274530,10138713,9471802,16875,15671,2018,14901,2016,1204,1974,1.0,0.0,10,1.0,12,5,21,1974.0,0.36835750937461853,0.08117008954286575
11277465,6198479,4662100,16875,9196,2001,4142,1987,7679,12733,0.25,0.0,352,7.0,4,1,21,2870.0,0.46102479100227356,0.1491965502500534
11275204,10802196,4316339,16875,16357,2020,2245,1982,518,14630,1.0,0.0,2,21.0,13,1,21,1071.0,0.8614640235900879,0.34662580490112305
11276408,6424946,7939101,16875,9700,2002,12913,2011,7175,3962,1.0,0.0,53,3.0,2,3,126,189.0,0.5907688140869141,-0.04785900563001633
11276058,7350230,4207186,16875,11772,2008,1622,1980,5103,15253,0.6666666666666666,0.0,270,4.0,3,2,7,1841.0,0.41184350848197937,0.12630365788936615
11274821,6474846,5767635,16875,9805,2002,8202,1998,7070,8673,1.0,0.0,70,19.0,5,2,21,35.0,0.4538325369358063,0.030620239675045013
11280162,5839508,5611247,16882,8363,1998,7747,1997,8519,9135,0.5,0.0,260,2.0,37,6,21,6811.0,0.6648707985877991,0.2913864850997925
11278702,5297546,6072346,16882,6662,1994,8923,2000,10220,7959,1.0,0.0,64,18.0,19,1,70,2520.0,0.41385477781295776,0.12214282900094986
11278718,6002964,8285215,16882,8748,1999,13431,2012,8134,3451,1.0,0.0,322,2.0,10,4,21,2583.0,0.36108484864234924,0.14374446868896484
11278884,6537503,8135543,16882,9945,2003,13221,2012,6937,3661,0.25,0.25,35,3.0,21,61,7,1372.0,0.6430383324623108,0.22073373198509216
11278360,8876866,5552479,16882,14187,2014,7551,1996,2695,9331,0.5,0.0,62,13.0,45,2,14,1547.0,0.23488004505634308,0.24813726544380188
11280621,8620532,7785661,16882,13879,2013,12661,2010,3003,4221,0.5,0.0,59,9.0,134,84,42,469.0,0.32472431659698486,0.12977334856987
11278280,9351726,4679763,16882,14761,2016,4212,1987,2121,12670,1.0,0.0,913,20.0,2309,1,0,2646.0,0.6529772877693176,0.297708123922348
11279617,6605304,5392088,16882,10085,2003,6991,1995,6797,9891,0.0,0.0,25,20.0,40,2,63,553.0,0.28292256593704224,0.12613525986671448
11283885,6647257,4421475,16882,10176,2003,2910,1983,6706,13972,0.5,0.0,694,6.0,25,8,7,1323.0,0.4356271028518677,0.08744543045759201
11284161,6128009,8283561,16882,9042,2000,13431,2012,7840,3451,1.0,0.0,130,2.0,11,11,259,2695.0,0.6023234724998474,0.14481855928897858
re48981,8201381,4708405,16882,13319,2012,4345,1987,3563,12537,0.0,0.0,14,12.0,36,2,315,1267.0,0.3432934582233429,0.13864733278751373
11285879,5650929,6814510,16889,7873,1997,10540,2004,9016,6349,0.0,0.0,219,14.0,15,14,189,105.0,0.38480064272880554,0.25191545486450195
11284890,6216698,6901262,16889,9238,2001,10743,2005,7651,6146,1.0,0.0,71,14.0,10,2,252,329.0,0.3710075914859772,0.13921192288398743
11290418,6665706,10935816,16889,10211,2003,16497,2021,6678,392,0.0,0.0,318,2.0,8,6,7,245.0,0.42009150981903076,0.030381016433238983
11288724,6446273,6948008,16889,9749,2002,10855,2005,7140,6034,0.0,0.3333333333333333,24,11.0,9,15,952,574.0,0.2668667435646057,0.13365888595581055
11288280,10042636,4227429,16889,15559,2018,1748,1980,1330,15141,0.5,0.0,13,14.0,2,1,35,840.0,0.2667612135410309,0.06594299525022507
11289169,9311970,9073950,16889,14712,2016,14432,2015,2177,2457,0.5,0.0,19,8.0,69,41,56,1099.0,0.49135109782218933,0.08320975303649902
11284891,5829662,4582449,16889,8342,1998,3757,1986,8547,13132,1.0,0.0,1612,15.0,37,4,0,602.0,0.37458497285842896,0.229257270693779
11285421,6860916,4557544,16889,10652,2005,3631,1985,6237,13258,0.5,0.0,23,30.0,49,2,1008,2198.0,0.3595811724662781,0.1596810519695282
11286619,6290813,4030801,16889,9392,2001,537,1977,7497,16352,1.0,0.0,7,21.0,8,1,63,259.0,0.36713606119155884,0.20063011348247528
11285013,7172784,6344235,16889,11359,2007,9532,2002,5530,7357,0.0,0.0,2,2.0,8,3,2527,1813.0,0.1446174830198288,0.15362656116485596
11290763,6100883,9492720,16889,8986,2000,14929,2016,7903,1960,1.0,0.0,268,2.0,96,20,14,658.0,0.469875305891037,0.04685886576771736
11291760,5437622,4558943,16896,7152,1995,3638,1985,9744,13258,1.0,0.0,809,10.0,5,3,0,700.0,0.21599507331848145,0.28436702489852905
11291445,10582931,7623935,16896,16140,2020,12381,2009,756,4515,1.0,0.0,72,13.0,604,13,0,98.0,0.48187053203582764,0.16099034249782562
11291441,5354250,8280943,16896,6858,1994,13424,2012,10038,3472,0.0,0.0,557,3.0,2,1,0,7.0,0.3435380458831787,0.2027418315410614
11294936,8745132,6530474,16896,14033,2014,9931,2003,2863,6965,0.5,0.0,200,5.0,50,8,7,4963.0,0.2718362808227539,0.2481304258108139
11291522,5738678,5388972,16896,8139,1998,6984,1995,8757,9912,1.0,0.0,63,29.0,11,12,203,1078.0,0.5874590277671814,0.2858249545097351
11294055,7276960,6159399,16896,11597,2007,9112,2000,5299,7784,0.0,0.0,77,5.0,9,6,63,504.0,0.3367939591407776,0.11507781594991684
11291472,6527736,9466113,16896,9924,2003,14894,2016,6972,2002,1.0,0.0,386,7.0,15,3,21,266.0,0.32829219102859497,0.08136603981256485
11291451,4669647,8329341,16896,4170,1987,13494,2012,12726,3402,1.0,0.0,934,3.0,6,8,0,1141.0,0.4380546808242798,0.2709716856479645
11294113,9121999,6385777,16896,14488,2015,9630,2002,2408,7266,1.0,0.0,4,6.0,1,1,28,798.0,0.41859766840934753,0.09177495539188385
11295316,9892443,8107325,16896,15384,2018,13179,2012,1512,3717,0.5,0.0,197,29.0,58,3,0,154.0,0.49807047843933105,0.1564657837152481
11291751,6595949,8148956,16896,10064,2003,13242,2012,6832,3654,1.0,0.0,59,6.0,11,5,497,1519.0,0.44642704725265503,0.13832588493824005
11296557,7375492,7321180,16896,11828,2008,11709,2008,5068,5187,1.0,1.0,353,2.0,14,44,35,308.0,0.525538444519043,0.25271496176719666
11294862,6389427,4918228,16896,9630,2002,5220,1990,7266,11676,1.0,0.0,198,3.0,21,1,56,1799.0,0.5425673127174377,0.20485830307006836
11297005,8437645,8762177,16896,13641,2013,14054,2014,3255,2842,0.5,0.0,28,4.0,7,2,0,595.0,0.48672717809677124,0.18951411545276642
11295204,6389404,4438747,16896,9630,2002,3008,1984,7266,13888,1.0,0.0,36,4.0,5,7,28,8001.0,0.48580509424209595,0.09390992671251297
11291447,4652820,5095486,16896,4100,1987,5913,1992,12796,10983,0.0,0.0,650,8.0,2,1,0,2954.0,0.27621060609817505,0.20857791602611542
11292058,9962767,4264540,16896,15468,2018,1944,1981,1428,14952,0.42857142857142855,0.0,59,3.0,223,1,0,385.0,0.22059746086597443,0.2542383670806885
11297216,5894320,5759308,16896,8503,1999,8188,1998,8393,8708,0.25,0.0,330,11.0,12,2,56,1631.0,0.37854984402656555,0.02153373882174492
11298134,5413268,4225437,16903,7068,1995,1734,1980,9835,15169,0.5,0.0,1400,14.0,61,1,0,224.0,0.2641183137893677,0.14909803867340088
11300531,5410199,4962315,16903,7054,1995,5395,1990,9849,11508,0.0,0.5,12,4.0,11,2,1008,4753.0,0.07849682122468948,0.239113911986351
11297943,4553523,6385869,16903,3610,1985,9630,2002,13293,7273,0.0,0.0,61,2.0,2,9,224,6034.0,0.3983684182167053,0.37194833159446716
11301477,7996769,6301869,16903,13004,2011,9420,2001,3899,7483,1.0,0.0,192,5.0,5,13,14,273.0,0.4662659466266632,0.19881203770637512
11300558,5130661,5320861,16903,6039,1992,6739,1994,10864,10164,0.3333333333333333,0.0,34,24.0,1,18,238,1386.0,0.45823585987091064,0.1645365208387375
11304308,5579574,7167926,16903,7642,1996,11345,2007,9261,5558,0.25,0.0,20,20.0,13,126,42,224.0,0.5874240398406982,0.26316967606544495
11301589,9977904,4214395,16903,15482,2018,1671,1980,1421,15232,1.0,0.0,85,28.0,1,2,7,763.0,0.09497492015361786,0.07959869503974915
11299839,10590499,4029184,16903,16147,2020,530,1977,756,16373,0.0,0.0,3,3.0,29,1,539,6895.0,0.44565752148628235,0.2855716049671173
11298041,8236495,5260133,16903,13368,2012,6522,1993,3535,10381,0.0,0.0,10,3.0,28,7,119,847.0,0.14345379173755646,-0.028915558010339737
11298865,4846645,10084013,16903,4940,1989,15608,2018,11963,1295,1.0,0.0,11,2.0,11,2,7,469.0,0.5774571895599365,0.22665837407112122
11298135,9089334,3990090,16903,14453,2015,306,1976,2450,16597,1.0,0.0,112,3.0,504,1,21,14035.0,0.5511276125907898,0.11942441761493683
11298760,7040844,8436217,16903,11086,2006,13641,2013,5817,3262,1.0,0.0,33,9.0,11,4,14,14.0,0.5678669810295105,0.10395048558712006
11297777,10144595,5459123,16903,15678,2018,7229,1995,1225,9674,0.5,0.0,2,25.0,10,1,707,56.0,0.19884301722049713,0.07165022194385529
11300561,7583990,10794118,16903,12297,2009,16350,2020,4606,553,0.3333333333333333,0.0,763,2.0,219,6,0,49.0,0.5429986715316772,0.12690578401088715
11310596,9489948,5232661,16910,14922,2016,6424,1993,1988,10486,0.5,0.0,225,17.0,5,3,0,2583.0,0.5980156660079956,0.08674925565719604
11309986,8977121,4813759,16910,14313,2015,4828,1989,2597,12082,1.0,0.0,11,5.0,4,3,126,5019.0,0.6054064035415649,0.4396992027759552
11304359,6860997,6175856,16910,10652,2005,9147,2001,6258,7763,0.25,0.0,9,16.0,20,8,0,98.0,0.5158688426017761,0.2078179121017456
11307047,8653961,9862719,16910,13928,2014,15349,2018,2982,1561,0.25,0.0,5,2.0,2,15,28,84.0,0.5516676306724548,0.1425282508134842
11304695,6131789,4353799,16910,9056,2000,2476,1982,7854,14434,1.0,0.0,1369,26.0,50,1,7,2821.0,0.2746720314025879,-0.08571789413690567
11304696,10463383,9697475,16910,16014,2019,15160,2017,896,1750,1.0,0.0,239,6.0,4051,3,0,189.0,0.43653604388237,0.06857714056968689
11306658,6516603,4929048,16910,9903,2003,5262,1990,7007,11648,1.0,0.0,43,12.0,7,14,553,3234.0,0.6644182205200195,0.18647648394107819
11304831,7226558,7536139,16910,11478,2007,12192,2009,5432,4718,0.0,0.0,90,5.0,29,19,7,1281.0,0.32011905312538147,0.08331571519374847
11306395,5837058,6237077,16910,8356,1998,9273,2001,8554,7637,1.0,0.0,217,25.0,12,12,14,840.0,0.29784131050109863,0.27678361535072327
11307227,7436687,7927202,16910,11975,2008,12892,2011,4935,4018,0.0,0.0,50,4.0,12,4,28,280.0,0.246254563331604,0.18661510944366455
11309075,6282531,5160424,16910,9371,2001,6151,1992,7539,10759,0.5,0.0,63,3.0,47,4,49,35.0,0.11996261775493622,0.09886429458856583
11310201,9185127,10381067,16910,14558,2015,15930,2019,2352,980,1.0,0.25,67,5.0,11,202,28,371.0,0.5043827891349792,0.2094055861234665
11316958,6587046,8471421,16917,10043,2003,13690,2013,6874,3227,0.5,0.0,191,7.0,159,4,0,35.0,0.4055720865726471,0.22957324981689453
11311294,10426468,4601394,16917,15979,2019,3855,1986,938,13062,0.25,0.2,379,6.0,340,2,0,3948.0,0.5640516877174377,0.2416508048772812
11313123,4474920,6410664,16917,3197,1984,9672,2002,13720,7245,0.0,0.0,53,19.0,1,6,84,2821.0,0.48435306549072266,0.12057419121265411
11311292,8852185,6218367,16917,14159,2014,9238,2001,2758,7679,1.0,0.0,613,20.0,51,3,0,630.0,0.1436757892370224,0.09248793125152588
11313120,8893417,4171902,16917,14208,2014,1391,1979,2709,15526,0.0,0.0,7,20.0,27,2,364,6279.0,0.4179185628890991,0.19632813334465027
11311956,4909430,4368614,16917,5192,1990,2574,1983,11725,14343,0.5,0.0,32,4.0,2,1,567,924.0,0.6495077013969421,0.35105979442596436
11315386,10403090,9817752,16917,15951,2019,15293,2017,966,1624,0.6666666666666666,0.3333333333333333,21,4.0,3,27,42,364.0,0.558961808681488,0.23359031975269318
11312567,5351442,7068464,16917,6851,1994,11135,2006,10066,5782,0.0,0.0,28,4.0,13,11,259,203.0,0.1505022943019867,0.01945863477885723
11312100,6846089,4838733,16917,10617,2005,4912,1989,6300,12005,0.0,0.0,148,17.0,7,5,91,3395.0,0.48320314288139343,0.25492796301841736
11311377,4345340,7165218,16917,2427,1982,11338,2007,14490,5579,1.0,0.0,542,3.0,6,9,0,2359.0,0.6376823782920837,0.11527016758918762
11314838,9514248,4375204,16917,14950,2016,2616,1983,1967,14301,0.5,0.0,31,4.0,1,3,14,483.0,0.4809914827346802,0.2246290147304535
11312684,10485967,7940554,16917,16035,2019,12913,2011,882,4004,0.5,0.0,1,19.0,7,17,882,35.0,0.29269739985466003,0.029612500220537186
11311773,7563216,7321180,16917,12255,2009,11709,2008,4662,5208,1.0,0.0,15,2.0,19,44,308,329.0,0.5852077603340149,0.22945363819599152
11320307,7649627,4445368,16924,12437,2010,3043,1984,4487,13881,1.0,1.0,19,3.0,2,1,91,5985.0,0.42545419931411743,0.21101051568984985
11321678,7116446,9693394,16924,11233,2006,15153,2017,5691,1771,1.0,0.0,57,2.0,14,3,28,399.0,0.31551170349121094,0.11825860291719437
11317907,6358270,7303468,16924,9574,2002,11660,2007,7350,5264,1.0,0.0,141,17.0,12,40,7,1561.0,0.33424612879753113,0.030800940468907356
11319055,4247061,8171961,16924,1853,1981,13277,2012,15071,3647,1.0,0.0,12,5.0,1,2,217,1309.0,0.5400804281234741,0.2804400324821472
11317947,5244459,6926136,16924,6466,1993,10813,2005,10458,6111,1.0,0.0,82,14.0,6,11,98,35.0,0.4588708281517029,0.17135019600391388
11321174,6175571,4448842,16924,9147,2001,3057,1984,7777,13867,0.5,0.0,1323,14.0,15,3,0,11214.0,0.40377986431121826,0.19935792684555054
11317913,6221023,9010273,16924,9245,2001,14355,2015,7679,2569,1.0,0.0,672,7.0,5,9,0,259.0,0.3471968173980713,0.07891759276390076
11317978,7062006,4976600,16924,11121,2006,5458,1990,5803,11466,0.0,0.0,117,10.0,15,4,0,3360.0,0.1658291071653366,0.30615800619125366
11317917,5571100,4129052,16924,7614,1996,1076,1978,9310,15848,1.0,0.0,1416,9.0,11,1,0,280.0,0.4354073405265808,0.24871771037578583
11317911,9517066,7385377,16924,14957,2016,11849,2008,1967,5075,1.0,0.0,42,18.0,68,6,35,1519.0,0.49917587637901306,-0.041340507566928864
11322480,7276786,9306805,16924,11597,2007,14705,2016,5327,2219,0.25,0.2,23,2.0,6,5,91,1575.0,0.5189840793609619,0.3868258595466614
11321046,7130616,5333522,16924,11261,2006,6788,1994,5663,10136,0.5,0.0,1148,2.0,32,3,7,6594.0,0.5371145009994507,0.18376575410366058
11319157,5489017,4007785,16924,7341,1996,411,1977,9583,16513,1.0,0.0,35,25.0,19,1,700,63.0,0.5710771679878235,0.15114037692546844
11319113,5416279,8590530,16924,7075,1995,13844,2013,9849,3080,0.3333333333333333,0.0,22,11.0,2,20,399,28.0,0.5128851532936096,0.22610439360141754
11324522,5342368,5532343,16931,6816,1994,7488,1996,10115,9443,1.0,0.0,166,4.0,8,5,21,4599.0,0.5197203159332275,-0.004095216281712055
11326005,9181370,5177569,16931,14558,2015,6214,1993,2373,10717,1.0,0.0,30,28.0,67,2,63,3738.0,0.6326249241828918,0.05886860191822052
11324506,8403832,5041247,16931,13599,2013,5710,1991,3332,11221,1.0,0.0,736,33.0,18,14,0,203.0,0.550648033618927,0.18650636076927185
11327599,8325159,9251331,16931,13487,2012,14642,2016,3444,2289,0.0,0.5,51,2.0,71,5,70,903.0,0.5148715376853943,0.30705133080482483
11328092,8533746,6814097,16931,13767,2013,10540,2004,3164,6391,1.0,0.0,131,18.0,39,44,21,259.0,0.40123018622398376,0.2292099893093109
11324642,9238089,4577110,16931,14628,2016,3729,1986,2303,13202,1.0,0.0,4,31.0,9,7,371,945.0,0.5933494567871094,0.13007144629955292
11324407,4850962,10672740,16931,4954,1989,16224,2020,11977,707,0.3333333333333333,0.0,87,2.0,3,4,56,42.0,0.30171191692352295,0.04503434896469116
11324614,7163555,4225976,16931,11338,2007,1734,1980,5593,15197,0.3333333333333333,0.0,111,4.0,7,1,42,1491.0,0.5376799702644348,0.010469578206539154
11324503,10314580,4264897,16931,15867,2019,1944,1981,1064,14987,1.0,0.0,44,17.0,46,3,0,4466.0,0.34425386786460876,0.03253389894962311
11330652,8583138,10945675,16931,13830,2013,16511,2021,3101,420,1.0,0.0,1,2.0,1,9,3101,161.0,0.6738593578338623,0.19493231177330017
11331013,8118620,8740176,16938,13200,2012,14033,2014,3738,2905,0.0,0.0,457,3.0,203,1,0,1330.0,0.28208795189857483,0.13802756369113922
11331100,10194907,4027593,16938,15741,2019,523,1977,1197,16415,1.0,0.0,387,9.0,25,2,0,2380.0,0.400250643491745,0.14391538500785828
11331100,5878938,6329905,16938,8468,1999,9476,2001,8470,7462,1.0,0.0,1421,14.0,12,6,0,245.0,0.5840385556221008,0.12854759395122528
11331463,8556866,7558441,16938,13802,2013,12241,2009,3136,4697,1.0,0.0,29,2.0,41,9,49,2499.0,0.38805145025253296,0.1719731092453003
11330996,7039449,5297803,16938,11079,2006,6662,1994,5859,10276,1.0,0.0,755,21.0,95,2,14,1372.0,0.4434347450733185,0.09589330106973648
11331100,5749893,10997809,16938,8167,1998,16560,2021,8771,378,1.0,0.0,1690,2.0,55,5,0,84.0,0.38617584109306335,0.19470404088497162
11336712,6459909,5368099,16938,9770,2002,6907,1994,7168,10031,0.5,0.0,183,9.0,5,12,7,1393.0,0.2593127489089966,0.17105017602443695
11331690,4890807,5156011,16938,5115,1990,6137,1992,11823,10801,0.0,0.0,17,2.0,3,1,1456,9534.0,0.3298567235469818,0.20769989490509033
11334040,10412169,5550327,16938,15958,2019,7544,1996,980,9394,0.4,0.16666666666666666,3,3.0,3,7,70,3514.0,0.3141801655292511,0.17451085150241852
11332919,10352034,7234913,16938,15902,2019,11499,2007,1036,5439,1.0,0.0,3,7.0,6,5,462,693.0,0.3121924102306366,0.19744081795215607
11336523,8646093,7037116,16938,13914,2014,11079,2006,3024,5859,0.5,0.0,218,6.0,6,6,7,1267.0,0.13670819997787476,0.11977273970842361
11341538,6068552,7496784,16945,8916,2000,12108,2009,8029,4837,0.0,0.5,864,3.0,14,5,21,2065.0,0.3358064889907837,0.10067129135131836
11339476,9576952,5132262,16945,15027,2017,6046,1992,1918,10899,0.5,0.0,126,5.0,5,5,28,336.0,0.43168437480926514,0.09756508469581604
11342991,7006769,9926066,16945,11016,2006,15426,2018,5929,1519,0.5,0.0,14,2.0,9,11,70,497.0,0.35546544194221497,0.04857925325632095
11340803,7908380,4755857,16945,12857,2011,4569,1988,4088,12376,1.0,0.0,32,8.0,4,5,56,10101.0,0.25777608156204224,0.20558615028858185
11337728,5207697,6242890,16945,6333,1993,9287,2001,10612,7658,1.0,0.0,1370,17.0,8,7,0,77.0,0.43029361963272095,0.16287973523139954
11337790,6712834,6453933,16945,10316,2004,9763,2002,6629,7182,1.0,0.0,199,7.0,12,6,28,700.0,0.5209639072418213,0.24765163660049438
11340672,7620710,4444198,16945,12374,2009,3036,1984,4571,13909,1.0,0.0,455,11.0,126,3,7,63.0,0.3798850178718567,0.26917827129364014
11337698,9690362,9160731,16945,15153,2017,14530,2015,1792,2415,0.5,0.0,759,8.0,2569,1,0,238.0,0.3478317856788635,0.3236241638660431
11342495,8198692,4179128,16945,13312,2012,1447,1979,3633,15498,0.5,0.0,8,6.0,6,2,1078,6510.0,0.5172758102416992,0.07241297513246536
11342033,7768844,4193910,16945,12633,2010,1538,1980,4312,15407,1.0,0.0,9,10.0,4,2,1197,4088.0,0.6225324869155884,0.09234099090099335
11350253,7949752,5926375,16952,12927,2011,8601,1999,4025,8351,0.5,0.0,133,15.0,71,6,0,3682.0,0.23380954563617706,0.18259164690971375
11344299,8701959,4150708,16952,13991,2014,1209,1979,2961,15743,0.5,0.0,1027,2.0,478,1,0,11998.0,0.35876205563545227,0.13362249732017517
11348924,10121793,4486303,16952,15650,2018,3260,1984,1302,13692,0.5,0.0,4,25.0,2,1,224,42.0,0.6396757960319519,0.07744067907333374
11348082,6415156,9721417,16952,9679,2002,15188,2017,7273,1764,0.3333333333333333,0.25,101,2.0,17,1,56,1421.0,0.6434279084205627,0.18326720595359802
11348054,7151982,4254795,16952,11310,2006,1895,1981,5642,15057,0.3333333333333333,0.0,217,3.0,144,1,7,7875.0,0.6657521724700928,0.13841159641742706
11344561,4664910,4682588,16952,4149,1987,4226,1987,12803,12726,1.0,1.0,30,59.0,10,4,189,189.0,0.45132237672805786,0.2564188838005066
11349656,7334184,5079735,16952,11737,2008,5850,1992,5215,11102,0.0,0.3333333333333333,119,19.0,43,12,119,812.0,0.36220723390579224,0.13887831568717957
11347960,7751662,6957445,16952,12605,2010,10883,2005,4347,6069,0.2,0.2,56,2.0,8,32,21,2828.0,0.5959997773170471,0.29838696122169495
11344303,5446646,5698055,16952,7180,1995,8020,1997,9772,8932,0.0,0.0,316,14.0,6,9,0,518.0,0.20951294898986816,0.16994544863700867
11344301,9433420,4708405,16952,14859,2016,4345,1987,2093,12607,1.0,0.0,681,12.0,239,2,0,1337.0,0.688857913017273,0.1056416928768158
11347775,7035851,10738270,16952,11072,2006,16294,2020,5880,658,1.0,0.0,29,2.0,10,4,133,308.0,0.39867156744003296,0.12390949577093124
11345999,7661299,7706390,16952,12465,2010,12535,2010,4487,4417,0.0,0.0,182,6.0,11,6,7,798.0,0.26614856719970703,0.15214481949806213
11350238,9245426,7854056,16952,14635,2016,12773,2010,2317,4179,0.25,0.0,23,15.0,3,2,28,210.0,0.5191166400909424,0.07275968790054321
11345625,5475197,7925513,16952,7285,1995,12885,2011,9667,4067,0.5,0.0,11,23.0,5,68,224,476.0,0.4146304726600647,0.20254218578338623
11348582,7809610,9588342,16952,12696,2010,15041,2017,4256,1911,0.5,0.25,315,7.0,2,9,0,7.0,0.24691157042980194,0.42693591117858887
11349432,6587051,4116011,16952,10043,2003,999,1978,6909,15953,0.0,0.0,131,22.0,6,1,14,112.0,0.4247175455093384,0.2749027609825134
11349235,9793660,7588213,16952,15265,2017,12311,2009,1687,4641,1.0,0.0,4,5.0,29,4,119,63.0,0.44022032618522644,0.05593873932957649
11344362,8152801,4523454,16952,13249,2012,3456,1985,3703,13496,1.0,0.0,208,7.0,8,1,7,448.0,0.45455238223075867,0.0025748107582330704
11356588,4719698,3982840,16959,4401,1988,271,1976,12558,16688,0.25,0.0,48,24.0,2,1,21,98.0,0.5673404932022095,0.024470362812280655
11350864,7907956,4569256,16959,12857,2011,3694,1986,4102,13265,0.0,0.0,21,5.0,9,2,14,2821.0,0.0630212128162384,0.30224472284317017
11353892,10545500,9913446,16959,16098,2020,15412,2018,861,1547,0.5,0.0,2,1.0,15,3,266,1547.0,0.5911903977394104,0.23902297019958496
11350843,9204923,5595556,16959,14586,2015,7691,1997,2373,9268,1.0,0.0,726,27.0,9,51,7,14.0,0.4274769425392151,0.27574899792671204
11350929,10258330,6873297,16959,15811,2019,10680,2005,1148,6279,1.0,0.0,365,11.0,3835,2,0,742.0,0.3602083921432495,0.13337752223014832
11350843,5718359,4895220,16959,8083,1998,5136,1990,8876,11823,1.0,0.0,1425,4.0,35,1,7,3647.0,0.49969515204429626,0.199783593416214
11351330,6827084,5064775,16959,10568,2004,5794,1991,6391,11165,0.0,0.0,30,56.0,16,10,28,3227.0,0.368936151266098,0.04606229439377785
11350934,7000911,4890714,16959,11009,2006,5115,1990,5950,11844,0.0,0.0,558,9.0,3,3,0,2233.0,0.2922293543815613,0.3089209198951721
11351353,4325368,4609614,16959,2301,1982,3897,1986,14658,13062,1.0,0.0,20,36.0,6,6,1869,861.0,0.24972936511039734,0.3323122560977936
11350928,5456917,8967517,16959,7222,1995,14306,2015,9737,2653,0.5,0.0,550,2.0,27,8,0,1617.0,0.27713727951049805,0.13633759319782257
11351018,5836030,4427840,16959,8356,1998,2945,1984,8603,14014,1.0,0.0,122,8.0,1,6,70,4319.0,0.5770663619041443,0.04004229977726936
11357918,8551056,4890575,16966,13795,2013,5115,1990,3171,11851,1.0,0.0,7,18.0,4,3,161,231.0,0.45315518975257874,0.20310398936271667
11358167,6679908,5244735,16966,10246,2004,6466,1993,6720,10500,0.0,0.0,14,23.0,4,5,903,518.0,0.42213496565818787,0.19906894862651825
11358747,5813197,4644983,16966,8307,1998,4072,1987,8659,12894,1.0,0.5,29,2.0,4,2,28,8736.0,0.2541363537311554,0.2953513264656067
11357510,6086577,4285320,16966,8958,2000,2063,1981,8008,14903,1.0,0.0,234,2.0,12,5,21,9289.0,0.3193434774875641,0.15455816686153412
11361990,6325858,7712230,16966,9469,2001,12549,2010,7497,4417,0.0,0.0,256,2.0,18,29,7,3976.0,0.3600614666938782,0.18213188648223877
11368327,7890612,4487858,16973,12829,2011,3267,1984,4144,13706,0.3333333333333333,0.0,341,9.0,2,2,0,3584.0,0.38143929839134216,0.145541250705719
11367340,5886894,7590563,16973,8482,1999,12311,2009,8491,4662,0.0,0.3333333333333333,153,3.0,7,4,14,147.0,0.5506754517555237,0.2824077308177948
11367425,7242638,8788855,16973,11513,2007,14082,2014,5460,2891,0.5,0.0,16,8.0,20,4,539,21.0,0.42592814564704895,0.0449160598218441
11364372,8439880,6893364,16973,13648,2013,10729,2005,3325,6244,1.0,0.0,38,11.0,22,16,28,266.0,0.442786306142807,0.2261752486228943
11364132,4601718,7586415,16973,3855,1986,12304,2009,13118,4669,1.0,0.0,141,8.0,6,1,28,413.0,0.5385514497756958,0.10642676800489426
11364328,5141493,6219089,16973,6081,1992,9238,2001,10892,7735,0.5,0.0,194,14.0,4,88,77,84.0,0.6454634666442871,0.20487454533576965
11366634,11175889,4168196,16973,16756,2021,1356,1979,217,15617,1.0,0.0,1,5.0,2,3,217,7308.0,0.9497044086456299,0.1774235963821411
11366971,9154739,4691130,16973,14523,2015,4261,1987,2450,12712,0.5,0.0,56,6.0,3,1,28,5656.0,0.2523152232170105,0.22649799287319183
11372487,8717508,5730327,16980,14005,2014,8118,1998,2975,8862,0.0,0.0,7,30.0,1,14,406,147.0,0.5693893432617188,0.15089160203933716
11369765,6029665,5650376,16980,8825,2000,7873,1997,8155,9107,0.3333333333333333,0.0,141,11.0,140,1,42,210.0,0.27557429671287537,0.06852198392152786
11373313,10290135,5691397,16980,15839,2019,7999,1997,1141,8981,1.0,0.0,6,34.0,11,2,14,259.0,0.6473366618156433,0.07933651655912399
11373517,4779839,9904965,16980,4681,1988,15398,2018,12299,1582,0.5,0.0,16,2.0,4,2,1498,287.0,0.30686429142951965,0.36293455958366394
11373007,9553918,5452957,16980,14999,2017,7208,1995,1981,9772,1.0,0.0,177,32.0,15,4,7,413.0,0.5619150400161743,0.1761617660522461
11374112,10322384,9232737,16980,15874,2019,14621,2016,1106,2359,0.3333333333333333,0.0,127,2.0,1110,7,14,1806.0,0.1663494110107422,0.1846301555633545
11370283,6006815,4260666,16980,8762,1999,1923,1981,8218,15057,0.0,0.0,5,11.0,11,2,28,2394.0,0.285127729177475,0.1792249232530594
11370613,6231284,4415517,16980,9266,2001,2875,1983,7714,14105,0.0,0.0,56,10.0,9,1,182,5124.0,0.5398091673851013,0.17825298011302948
11371756,7827807,5750722,16980,12731,2010,8167,1998,4249,8813,1.0,0.0,9,9.0,35,1,1078,1141.0,0.4599466919898987,0.004394459072500467
11369835,5538489,5163192,16980,7509,1996,6165,1992,9471,10815,0.5,0.0,88,42.0,11,4,217,630.0,0.3841378390789032,0.22761639952659607
11369439,6591130,8976117,16980,10050,2003,14313,2015,6930,2667,1.0,0.0,178,6.0,50,2,63,98.0,0.6659413576126099,0.17418406903743744
11370724,4554395,6971446,16980,3610,1985,10932,2005,13370,6048,0.3333333333333333,0.0,60,8.0,3,4,126,581.0,0.4704957902431488,0.17900778353214264
11374921,8924715,9715939,16980,14243,2014,15181,2017,2737,1799,1.0,0.0,34,9.0,5,27,98,273.0,0.4104156494140625,0.21744273602962494
11369271,5382164,6673469,16980,6956,1995,10232,2004,10024,6748,0.25,0.0,432,11.0,4,11,28,770.0,0.448178231716156,0.06898093223571777
11370651,8973623,8663104,16980,14313,2015,13942,2014,2667,3038,0.5,0.0,5,12.0,6,229,560,196.0,0.5177515745162964,0.2433188408613205
11369892,7621235,8091269,16980,12381,2009,13158,2012,4599,3822,0.0,0.0,12,3.0,41,19,434,2485.0,0.4380517899990082,0.028632553294301033
11380361,7468729,4158982,16987,12045,2008,1272,1979,4942,15715,0.3333333333333333,0.0,192,7.0,42,1,21,826.0,0.21709121763706207,0.27410823106765747
11376101,5583977,8243543,16987,7649,1996,13375,2012,9338,3612,0.0,0.0,144,4.0,18,4,49,56.0,0.34516608715057373,0.14259454607963562
11376168,5338766,7030002,16987,6802,1994,11065,2006,10185,5922,0.0,0.0,96,6.0,53,2,70,2121.0,0.4180987477302551,0.15655918419361115
11380310,7920682,7046072,16987,12878,2011,11093,2006,4109,5894,0.0,0.0,342,2.0,43,6,21,3024.0,0.49737709760665894,0.1985107958316803
11376001,9522003,6780286,16987,14964,2016,10463,2004,2023,6524,0.16666666666666666,0.0,365,3.0,11,25,7,1190.0,0.3583420515060425,0.3764655590057373
11376001,7845536,5965962,16987,12759,2010,8685,1999,4228,8302,0.16666666666666666,0.16666666666666666,1321,12.0,90,3,7,735.0,0.4735589921474457,0.2914072573184967
11376098,10561422,4264072,16987,16119,2020,1944,1981,868,15043,0.5,0.0,279,4.0,4470,6,0,3402.0,0.39457181096076965,0.24079813063144684
11376543,4726815,10637197,16987,4436,1988,16189,2020,12551,798,0.5,0.0,24,2.0,2,1,259,133.0,0.7342917323112488,0.049361832439899445
11381118,9923386,5443128,16987,15419,2018,7173,1995,1568,9814,1.0,0.0,45,24.0,175,7,28,679.0,0.49613508582115173,0.18767432868480682
11381973,10903999,11039048,16987,16462,2021,16602,2021,525,385,1.0,0.3333333333333333,2,1.0,10,3,217,385.0,0.4406092166900635,0.29822981357574463
11378337,8309173,8916286,16987,13466,2012,14236,2014,3521,2751,0.0,0.0,260,2.0,90,1,7,2422.0,0.1481463462114334,0.16657093167304993
11376098,9402627,8369422,16987,14824,2016,13550,2013,2163,3437,0.5,0.0,612,2.0,239,23,0,1057.0,0.5921469330787659,0.04664850980043411
11376249,9708322,4555585,16987,15174,2017,3617,1985,1813,13370,0.5,0.0,23,12.0,17,2,49,693.0,0.8543974757194519,0.14450819790363312
11382699,7726171,4197845,16994,12570,2010,1566,1980,4424,15428,0.0,0.25,608,21.0,2,2,0,630.0,0.30290043354034424,0.22210250794887543
11382447,10426287,4284562,16994,15979,2019,2056,1981,1015,14938,0.5,0.0,6,3.0,4,4,70,8008.0,0.5236858129501343,0.038113370537757874
11385916,7170864,4055423,16994,11352,2007,663,1977,5642,16331,0.5,0.0,199,8.0,10,1,7,2919.0,0.22420649230480194,0.05954243242740631
11382544,5879310,4714193,16994,8468,1999,4373,1987,8526,12621,0.5,0.0,234,6.0,1,2,35,2555.0,0.5957176089286804,0.24756599962711334
11382549,6879880,7119771,16994,10694,2005,11240,2006,6300,5754,0.0,0.0,396,3.0,37,19,7,3661.0,0.3878094553947449,0.265265554189682
11382628,9788851,8403582,16994,15265,2017,13599,2013,1729,3395,1.0,0.0,781,5.0,19,12,0,21.0,0.4602542817592621,0.15536916255950928
11382626,6565560,7321465,16994,10001,2003,11709,2008,6993,5285,1.0,0.0,1063,2.0,10,3,0,2786.0,0.42668575048446655,0.04990144446492195
11382625,7686201,7777955,16994,12507,2010,12647,2010,4487,4347,0.5,0.0,1123,16.0,19,32,0,252.0,0.2965182065963745,0.16517843306064606
11382638,7778004,4337646,16994,12647,2010,2378,1982,4347,14616,0.0,0.0,937,8.0,10,1,0,2541.0,0.49129584431648254,0.3680136203765869
11382626,10716568,6342815,16994,16273,2020,9525,2002,721,7469,1.0,0.0,131,39.0,4811,5,0,826.0,0.5452765822410583,0.1855330914258957
11382628,6261679,5067453,16994,9329,2001,5808,1991,7665,11186,0.0,0.0,665,8.0,62,2,0,959.0,0.18552999198436737,0.377938449382782
11389162,10456137,9487358,17001,16007,2019,14922,2016,994,2079,0.25,0.0,365,15.0,4092,90,0,63.0,0.5754437446594238,0.4085351526737213
11393477,9495129,4024390,17001,14929,2016,502,1977,2072,16499,0.0,0.0,137,13.0,1895,2,0,6846.0,0.4223936200141907,0.11579614877700806
11389228,5935144,4517141,17001,8622,1999,3421,1985,8379,13580,0.0,0.0,407,11.0,8,1,7,791.0,0.4847998023033142,0.0778139978647232
11389192,8616431,7428683,17001,13879,2013,11954,2008,3122,5047,0.5,0.0,1475,12.0,1326,3,0,868.0,0.4187144339084625,-0.05611147731542587
11391342,4674356,8605531,17001,4191,1987,13858,2013,12810,3143,1.0,0.0,53,32.0,3,5,448,217.0,0.3995167911052704,0.2163894921541214
11393690,6143079,4499656,17001,9077,2000,3337,1985,7924,13664,0.5,0.5,135,21.0,13,5,0,3094.0,0.4423735439777374,0.14001676440238953
11391769,9239359,4029132,17001,14628,2016,530,1977,2373,16471,1.0,0.0,12,11.0,13,2,168,3703.0,0.5074958801269531,-0.00477138627320528
11388955,6324774,7716857,17001,9469,2001,12556,2010,7532,4445,1.0,0.0,27,6.0,21,26,105,105.0,0.46746039390563965,0.23156054317951202
11390681,7862813,5496437,17001,12787,2011,7369,1996,4214,9632,0.5,0.0,2,3.0,14,4,231,8267.0,0.39302870631217957,0.16896039247512817
11393251,9207760,5935618,17001,14586,2015,8622,1999,2415,8379,0.5,0.0,7,3.0,6,5,56,6839.0,0.5505986213684082,0.17519396543502808
11399206,7362178,6932101,17008,11800,2008,10827,2005,5208,6181,0.0,0.0,13,6.0,7,8,21,602.0,0.34579432010650635,0.13567203283309937
11395656,8387849,6120942,17008,13578,2013,9028,2000,3430,7980,1.0,0.0,134,12.0,18,5,0,238.0,0.5509956479072571,0.21745149791240692
11395880,5509905,10536070,17008,7418,1996,16084,2020,9590,924,1.0,0.0,99,3.0,11,3,84,434.0,0.4137403070926666,0.2186582088470459
11399029,7941365,4502393,17008,12913,2011,3351,1985,4095,13657,0.5,0.0,43,8.0,4,1,28,308.0,0.1831979900598526,0.2976762354373932
11397133,5109695,4223114,17008,5969,1992,1720,1980,11039,15288,0.5,0.0,60,9.0,11,5,63,3941.0,0.6766665577888489,0.06912890076637268
11402450,6791328,4465158,17015,10484,2004,3148,1984,6531,13867,0.5,0.0,17,18.0,16,5,238,371.0,0.5765971541404724,0.12326087802648544
11399954,7731751,7428305,17015,12577,2010,11954,2008,4438,5061,1.0,0.0,154,3.0,13,7,14,3696.0,0.5674616694450378,0.17381522059440613
11403503,4431911,8592613,17015,2966,1984,13844,2013,14049,3171,0.5,0.0,10,4.0,2,74,49,1127.0,0.4710939824581146,0.05323469266295433
11399826,6155473,5453677,17015,9105,2000,7208,1995,7910,9807,1.0,0.0,1473,5.0,2,3,7,2527.0,0.7045167684555054,0.18021337687969208
11404109,4380046,4304298,17015,2658,1983,2168,1981,14357,14847,0.0,0.0,579,62.0,6,4,7,441.0,0.46197509765625,0.18450435996055603
11400350,6743118,5224204,17015,10379,2004,6389,1993,6636,10626,1.0,0.0,151,10.0,58,3,35,5285.0,0.6425901651382446,0.12555178999900818
11400570,5526460,8998578,17015,7467,1996,14341,2015,9548,2674,0.0,0.0,64,5.0,15,10,7,182.0,0.31638890504837036,0.29043471813201904
11405431,7013389,4742103,17015,11030,2006,4506,1988,5985,12509,0.5,0.0,274,12.0,47,3,7,973.0,0.2935832738876343,-0.043327465653419495
11405784,9408147,9482760,17015,14824,2016,14915,2016,2191,2100,0.3333333333333333,0.0,7,8.0,1,4,637,63.0,0.275719553232193,0.2863064408302307
11405224,8401968,8245703,17015,13592,2013,13382,2012,3423,3633,0.0,0.0,77,5.0,4,11,49,63.0,0.2956021726131439,0.12035524100065231
11404338,5802699,5730323,17015,8286,1998,8118,1998,8729,8897,0.0,0.0,312,2.0,51,3,35,315.0,0.6998774409294128,0.4372716546058655
11400478,6595675,6495347,17015,10064,2003,9847,2002,6951,7168,0.0,0.0,25,5.0,13,36,322,245.0,0.6557104587554932,0.10669028759002686
11399837,7094916,4749403,17015,11191,2006,4541,1988,5824,12474,0.5,0.0,574,30.0,13,1,0,273.0,0.01777331531047821,0.0913914144039154
11401534,7858350,4244270,17015,12780,2010,1839,1981,4235,15176,0.5,0.0,51,14.0,88,1,35,532.0,0.99696946144104,0.15617451071739197
11401476,4823739,5645565,17015,4863,1989,7859,1997,12152,9156,0.0,0.0,11,32.0,3,21,7679,63.0,0.5244316458702087,0.27151861786842346
11402801,8736802,6117951,17015,14026,2014,9021,2000,2989,7994,0.25,0.0,74,7.0,6,5,28,4410.0,0.34386977553367615,0.17208078503608704
11399828,8852199,9335497,17015,14159,2014,14740,2016,2856,2275,1.0,0.0,794,2.0,8,1,7,1176.0,0.24681109189987183,0.11413389444351196
11400287,5531778,10177031,17015,7488,1996,15713,2019,9527,1302,1.0,0.0,466,12.0,6,17,21,7.0,0.5612072348594666,0.2912399470806122
11399837,4773420,10641025,17015,4653,1988,16196,2020,12362,819,0.0,0.0,1167,2.0,3,8,0,147.0,0.3550255596637726,0.3624144494533539
11406381,7344533,3981810,17022,11765,2008,264,1976,5257,16758,1.0,0.0,944,4.0,37,1,0,9527.0,0.34778741002082825,-0.0018720529042184353
11409039,7531395,6877164,17022,12185,2009,10687,2005,4837,6335,0.0,0.0,20,4.0,54,8,56,2898.0,0.3656778335571289,0.2223067432641983
11406565,8409141,4083270,17022,13606,2013,831,1978,3416,16191,1.0,0.0,34,7.0,3,1,7,6216.0,0.49444594979286194,0.09202797710895538
11406702,7341841,10090317,17022,11758,2008,15615,2018,5264,1407,0.0,0.0,58,4.0,42,2,238,413.0,0.33355584740638733,0.14630979299545288
11410535,8155630,8424624,17022,13249,2012,13627,2013,3773,3395,0.5,0.0,13,4.0,6,2,735,1232.0,0.38478395342826843,0.0987461507320404
11409417,6039688,4266950,17022,8846,2000,1958,1981,8176,15064,0.5,0.0,327,24.0,46,1,14,329.0,0.4360796809196472,0.16783808171749115
11406416,8784441,7586415,17022,14082,2014,12304,2009,2940,4718,1.0,0.0,122,9.0,38,1,7,21.0,0.29533565044403076,0.2662543058395386
11408812,8140300,8023216,17022,13228,2012,13046,2011,3794,3976,0.0,0.0,16,12.0,18,16,70,42.0,0.2748852074146271,0.09358643740415573
11409136,10921612,5366921,17022,16483,2021,6900,1994,539,10122,0.5,0.0,12,10.0,50,10,7,840.0,0.41938793659210205,0.3428908586502075
11409722,6304873,4200494,17022,9420,2001,1580,1980,7602,15442,1.0,0.0,99,7.0,10,2,14,679.0,0.2932739555835724,0.12079260498285294
11406465,5350355,7502481,17022,6844,1994,12122,2009,10178,4900,0.5,0.0,925,5.0,42,3,0,112.0,0.5472779273986816,0.18760186433792114
11411262,5718835,8580895,17022,8083,1998,13830,2013,8939,3192,0.3333333333333333,0.3333333333333333,30,9.0,3,3,637,70.0,0.4398041367530823,0.31907862424850464
11411922,9313100,10654506,17022,14712,2016,16210,2020,2310,812,1.0,0.0,51,2.0,134,5,28,406.0,0.4587286412715912,0.17256881296634674
11406381,8161977,4766156,17022,13263,2012,4618,1988,3759,12404,1.0,0.0,1400,4.0,1048,6,0,7476.0,0.48699602484703064,0.0972420945763588
11412366,7610328,5355877,17022,12353,2009,6865,1994,4669,10157,0.0,0.0,226,7.0,8,10,7,5089.0,0.5706450343132019,0.09833960235118866
11406384,8181837,5308593,17022,13291,2012,6697,1994,3731,10325,1.0,0.0,167,3.0,22,2,0,7098.0,0.49655941128730774,0.14363420009613037
11408705,9453699,4668452,17022,14880,2016,4163,1987,2142,12859,0.5,0.0,20,21.0,11,3,364,350.0,0.6342509388923645,0.1258285790681839
11409619,10044558,6322007,17022,15559,2018,9462,2001,1463,7560,0.5,0.0,3,3.0,3,5,224,1106.0,0.055959347635507584,-0.056819282472133636
11408566,8725434,10823285,17022,14012,2014,16378,2020,3010,644,0.0,0.0,11,1.0,13,6,161,644.0,0.4167684316635132,0.24023385345935822
11413539,10478730,4126992,17029,16028,2019,1062,1978,1001,15967,1.0,0.0,16,4.0,3,3,7,6293.0,0.39078289270401,0.26136523485183716
11414792,7743470,6952590,17029,12598,2010,10869,2005,4431,6160,0.3333333333333333,0.0,2,6.0,5,5,1134,2212.0,0.47301745414733887,0.14494842290878296
11417184,7193644,4071430,17029,11401,2007,761,1978,5628,16268,0.16666666666666666,0.14285714285714285,328,22.0,16,1,7,182.0,0.5999228954315186,0.3112102746963501
11412964,10123729,5365713,17029,15657,2018,6900,1994,1372,10129,0.2,0.0,99,26.0,29,4,0,266.0,0.39810410141944885,0.12412042915821075
11413042,8740840,4490536,17029,14033,2014,3281,1984,2996,13748,1.0,0.0,106,8.0,7,2,7,7371.0,0.45396316051483154,0.1934950053691864
11418483,8608083,10647022,17029,13865,2013,16203,2020,3164,826,0.0,0.0,75,3.0,147,1,7,35.0,0.44173121452331543,0.22163528203964233
11414892,9435141,9217190,17029,14859,2016,14600,2015,2170,2429,1.0,0.0,3,2.0,12,25,308,777.0,0.38828107714653015,0.03737711161375046
11413332,8008499,4221802,17029,13025,2011,1713,1980,4004,15316,0.0,1.0,2,3.0,1,2,2856,7840.0,0.27962952852249146,0.19910477101802826
11414760,5844683,8001141,17029,8370,1998,13011,2011,8659,4018,0.0,0.0,213,17.0,5,3,7,119.0,0.3745914697647095,0.0995633602142334
11416109,9798896,6441784,17029,15272,2017,9735,2002,1757,7294,1.0,0.0,56,8.0,3,2,7,1134.0,0.31335145235061646,0.18184657394886017
11414257,4399157,7150135,17029,2784,1983,11310,2006,14245,5719,1.0,0.0,25,11.0,3,4,35,147.0,0.48420456051826477,0.27089032530784607
11414146,5927801,5207352,17029,8608,1999,6333,1993,8421,10696,0.0,0.0,11,26.0,6,20,35,448.0,0.4685108959674835,0.14867471158504486
11423174,8594632,7961000,17036,13844,2013,12948,2011,3192,4088,0.5,0.0,59,6.0,2,9,112,1470.0,0.32990702986717224,0.029486818239092827
11419522,8381411,5503447,17036,13571,2013,7397,1996,3465,9639,0.3333333333333333,0.0,8,2.0,12,2,1498,7455.0,0.6042802929878235,0.3172590732574463
11424561,5752845,5931314,17036,8174,1998,8615,1999,8862,8421,1.0,0.0,37,8.0,6,19,105,2527.0,0.41322529315948486,0.24212980270385742
11419609,7735703,6366108,17036,12584,2010,9588,2002,4452,7448,1.0,0.0,1400,10.0,490,4,0,3276.0,0.6840674877166748,-0.054064132273197174
11422252,6421550,7497668,17036,9693,2002,12115,2009,7343,4921,0.0,0.0,22,2.0,6,5,490,2961.0,0.3908757269382477,0.16491754353046417
11419626,4641053,4428345,17036,4051,1987,2952,1984,12985,14084,0.5,0.0,298,14.0,2,5,7,4956.0,0.4929935038089752,0.17846034467220306
11419937,7492458,9794613,17036,12101,2009,15265,2017,4935,1771,0.0,0.0,6,21.0,1,8,791,77.0,0.5491523742675781,0.05561494082212448
11425563,9355231,8356286,17036,14761,2016,13529,2013,2275,3507,1.0,0.5,39,7.0,2,48,84,7.0,0.4449482262134552,0.3729904294013977
11419667,10675035,4490981,17036,16231,2020,3288,1985,805,13748,0.3333333333333333,0.0,236,34.0,1901,2,0,973.0,0.3344954252243042,0.33584392070770264
11425535,11047700,4668659,17036,16616,2021,4163,1987,420,12873,0.3333333333333333,0.0,1,3.0,20,2,420,616.0,0.4826298952102661,0.20122449100017548
11423393,8781955,10057556,17036,14075,2014,15573,2018,2961,1463,1.0,0.0,11,2.0,6,2,14,308.0,0.4516238272190094,0.13075605034828186
11425509,9402140,6970952,17036,14817,2016,10925,2005,2219,6111,0.3333333333333333,0.0,2,11.0,2,21,413,497.0,0.4404338300228119,0.15284326672554016
11423690,8787630,9133221,17036,14082,2014,14502,2015,2954,2534,0.5,0.25,10,4.0,277,12,189,602.0,0.47953563928604126,0.1551428735256195
11419702,7140877,6949181,17036,11289,2006,10862,2005,5747,6174,1.0,0.0,74,8.0,117,14,49,1057.0,0.4126860499382019,0.15353599190711975
11426239,9084651,10571046,17043,14446,2015,16126,2020,2597,917,1.0,0.0,18,2.0,18,26,84,427.0,0.6295430064201355,0.2169874757528305
11431735,9177145,9430600,17043,14551,2015,14852,2016,2492,2191,0.5,0.5,7,3.0,16,14,133,21.0,0.4696829617023468,0.07179104536771774
11431357,7496339,4359668,17043,12108,2009,2511,1982,4935,14532,1.0,0.0,14,39.0,6,4,49,2541.0,0.3319723606109619,0.3264542520046234
11426414,10485871,10890716,17043,16035,2019,16448,2021,1008,595,0.5,0.0,48,1.0,45,4,63,595.0,0.7174771428108215,0.042565952986478806
11428413,6098397,4246210,17043,8986,2000,1846,1981,8057,15197,0.0,0.0,67,4.0,5,8,63,10276.0,0.3139555752277374,0.16490067541599274
11432434,10735125,4603037,17043,16287,2020,3862,1986,756,13181,0.0,0.0,1,12.0,4,4,756,7133.0,0.32090863585472107,0.2549941837787628
11426216,5415661,4396937,17043,7075,1995,2770,1983,9968,14273,1.0,0.0,1046,12.0,4,2,7,2982.0,0.5143278241157532,0.1048053652048111
11435693,7319834,5442638,17050,11702,2008,7166,1995,5348,9884,1.0,0.0,50,6.0,12,7,63,252.0,0.6663656830787659,0.19947470724582672
11434750,9506326,7721347,17050,14943,2016,12556,2010,2107,4494,0.5,0.5,9,1.0,21,2,105,4494.0,0.3292335271835327,0.36732620000839233
11435233,7783337,6114335,17050,12654,2010,9014,2000,4396,8036,0.3333333333333333,0.25,100,10.0,19,2,7,1232.0,0.37791869044303894,0.1337815821170807
11434922,6719791,6457118,17050,10330,2004,9763,2002,6720,7287,1.0,0.0,104,4.0,12,61,14,1939.0,0.5530489087104797,0.16367918252944946
11436170,10678556,4012556,17050,16231,2020,439,1977,819,16611,1.0,0.0,2,4.0,14,1,70,10969.0,0.5083861947059631,0.10836033523082733
11436221,6081811,5832273,17050,8944,2000,8342,1998,8106,8708,1.0,1.0,23,19.0,3,7,154,539.0,0.4315668046474457,0.24876445531845093
11432816,7721931,4102264,17050,12563,2010,936,1978,4487,16114,1.0,0.0,1542,2.0,303,1,7,13874.0,0.6952093243598938,0.3154940605163574
11437798,8592681,9055157,17050,13844,2013,14404,2015,3206,2646,0.0,0.0,26,3.0,26,4,0,259.0,0.4851534366607666,0.3315775394439697
11434417,7482311,5262509,17050,12080,2009,6529,1993,4970,10521,0.5,0.0,39,5.0,7,26,805,8421.0,0.474589467048645,0.2222297191619873
11432891,10008017,7346870,17050,15517,2018,11765,2008,1533,5285,0.25,0.0,12,3.0,276,8,0,3605.0,0.3430197238922119,0.12341532856225967
11435756,8805110,5281878,17050,14103,2014,6599,1994,2947,10451,0.3333333333333333,0.0,155,6.0,4,6,21,420.0,0.3023974299430847,0.19681213796138763
11439602,4507279,4254784,17057,3372,1985,1895,1981,13685,15162,1.0,0.0,31,14.0,2,4,2310,7.0,0.33861270546913147,0.18415069580078125
11439829,9409020,7057691,17057,14831,2016,11114,2006,2226,5943,0.5,0.0,41,25.0,107,23,28,840.0,0.22203771770000458,0.1690569370985031
11439470,8631993,7866210,17057,13900,2014,12794,2011,3157,4263,1.0,0.0,752,3.0,9,60,7,1638.0,0.6011224985122681,0.3169396221637726
11442776,6061750,4687387,17057,8895,2000,4247,1987,8162,12810,0.5,0.0,137,21.0,16,2,84,1176.0,0.2813178598880768,0.25750458240509033
11441629,5325011,6490212,17057,6753,1994,9833,2002,10304,7224,0.0,0.0,9,19.0,10,6,77,2065.0,0.14617355167865753,0.12301807105541229
11443722,6028255,6457635,17057,8818,2000,9770,2002,8239,7287,1.0,0.0,28,21.0,8,3,42,105.0,0.6785525679588318,0.34885966777801514
11447311,6412636,8660041,17064,9679,2002,13935,2014,7385,3129,1.0,0.0,51,9.0,9,4,371,266.0,0.4842381775379181,0.07955964654684067
11447861,7582555,4741932,17064,12297,2009,4506,1988,4767,12558,0.5,0.0,299,14.0,31,8,7,1645.0,0.37370166182518005,0.2560334801673889
11446770,6787731,5953915,17064,10477,2004,8664,1999,6587,8400,1.0,0.0,5,3.0,4,1,308,966.0,0.5513364672660828,0.456380158662796
11446034,9956677,6628824,17064,15461,2018,10134,2003,1603,6930,0.0,0.0,182,13.0,124,8,0,42.0,0.3920823633670807,0.186115100979805
11446028,7296722,8643315,17064,11646,2007,13914,2014,5418,3150,1.0,0.0,1187,3.0,171,30,0,763.0,0.42675185203552246,0.19420374929904938
11445961,6993377,8286646,17064,10988,2006,13438,2012,6076,3626,1.0,0.0,130,4.0,1,7,0,266.0,0.3077385723590851,0.2093200534582138
11446316,6080787,5819343,17064,8944,2000,8321,1998,8120,8743,0.5,0.0,42,19.0,9,20,119,77.0,0.35669711232185364,0.11088131368160248
11446034,10368863,7647586,17064,15923,2019,12430,2010,1141,4634,1.0,0.0,346,5.0,4077,8,0,1071.0,0.640654981136322,0.08200375735759735
11446019,5545178,5525037,17064,7530,1996,7467,1996,9534,9597,1.0,0.0,915,22.0,18,5,7,133.0,0.52719646692276,0.08567643165588379
11446382,8529939,4230711,17064,13767,2013,1762,1980,3297,15302,1.0,0.5,58,2.0,91,1,175,8918.0,0.34390488266944885,0.24455615878105164
11446029,6079606,3982840,17064,8944,2000,271,1976,8120,16793,1.0,0.0,1787,24.0,58,1,0,203.0,0.35567378997802734,0.21861182153224945
11449538,6882747,6268598,17064,10701,2005,9343,2001,6363,7721,1.0,0.0,171,5.0,5,9,28,2506.0,0.44954198598861694,0.19028909504413605
11447120,10921145,8168409,17064,16483,2021,13270,2012,581,3794,0.5,0.0,1,4.0,1,10,581,1085.0,0.6077728271484375,-0.05251866579055786
11447226,5149015,4123596,17064,6109,1992,1034,1978,10955,16030,1.0,0.0,14,11.0,4,4,511,840.0,0.38833966851234436,0.06933282315731049
11446034,10064639,4908952,17064,15587,2018,5192,1990,1477,11872,0.5,0.0,537,8.0,3,1,0,882.0,0.4040790796279907,0.3396183252334595
11452844,8827947,4420900,17071,14131,2014,2910,1983,2940,14161,1.0,0.0,31,22.0,5,4,35,196.0,0.3101098835468292,0.18549850583076477
11452839,re45336,5259015,17071,14257,2015,6515,1993,2814,10556,0.5,0.0,5,2.0,31,1,98,2226.0,0.22759447991847992,0.0035321125760674477
11456704,9007126,6350684,17071,14348,2015,9553,2002,2723,7518,0.5,0.0,6,7.0,5,6,126,609.0,0.6264410018920898,0.17764869332313538
11452528,6231565,6624233,17071,9266,2001,10127,2003,7805,6944,1.0,0.0,1835,7.0,21,12,0,861.0,0.48003125190734863,0.11830873042345047
11456771,9768833,6284977,17071,15237,2017,9378,2001,1834,7693,0.3333333333333333,0.0,461,5.0,1549,2,28,973.0,0.7455281615257263,0.1386745125055313
11452528,9707005,5352614,17071,15174,2017,6851,1994,1897,10220,1.0,0.0,439,4.0,254,7,0,2737.0,0.459147572517395,0.19252794981002808
11452607,8936641,7720820,17071,14264,2015,12556,2010,2807,4515,1.0,0.0,97,16.0,6,4,7,1057.0,0.6474810242652893,0.06717745214700699
11453943,7718930,11144009,17071,12556,2010,16721,2021,4515,350,0.0,0.0,105,2.0,17,1,7,203.0,0.26913419365882874,0.19643642008304596
11453946,5252133,6452782,17071,6494,1993,9756,2002,10577,7315,0.3333333333333333,0.3333333333333333,58,8.0,2,5,0,28.0,0.23191511631011963,0.00996840838342905
11463179,7196663,6771827,17078,11408,2007,10442,2004,5670,6636,0.0,0.0,250,5.0,5,19,0,168.0,0.3232133090496063,0.21761161088943481
11460993,6946976,5991882,17078,10855,2005,8727,1999,6223,8351,0.0,0.25,45,22.0,16,12,1449,21.0,0.5952634811401367,0.2340519279241562
11458300,8280528,8553639,17078,13424,2012,13795,2013,3654,3283,0.2,0.0,5,5.0,1,4,238,308.0,0.5081179738044739,0.09818525612354279
11458365,7108635,4873754,17078,11219,2006,5038,1989,5859,12040,0.5,0.0,39,7.0,3,1,21,3304.0,0.3339991569519043,0.16504311561584473
11457869,5735285,5870740,17078,8132,1998,8440,1999,8946,8638,0.5,0.0,532,10.0,17,19,56,56.0,0.4205387532711029,0.3088795244693756
11457944,10517595,4175759,17078,16070,2019,1426,1979,1008,15652,1.0,0.0,369,14.0,4298,1,0,826.0,0.2517574429512024,0.20994623005390167
11462215,8296124,9772387,17078,13445,2012,15244,2017,3633,1834,0.5,0.0,166,2.0,1,12,35,630.0,0.3689918518066406,0.000695146678481251
11460420,4885540,5197594,17078,5087,1989,6298,1993,11991,10780,1.0,0.0,36,6.0,6,2,1344,1288.0,0.6353425979614258,0.15641941130161285
11464601,8714430,4044239,17085,14005,2014,600,1977,3080,16485,0.5,0.0,592,38.0,76,1,0,2254.0,0.6436201930046082,0.18483659625053406
11464559,10045704,5480080,17085,15566,2018,7306,1996,1519,9779,0.5,0.0,77,10.0,2,1,0,889.0,0.3196691870689392,0.21483829617500305
11470037,10305985,6692190,17085,15853,2019,10274,2004,1232,6811,1.0,0.0,4,6.0,12,32,77,133.0,0.4334312081336975,0.2604254484176636
11464514,6766957,8095892,17085,10435,2004,13158,2012,6650,3927,0.0,0.0,581,10.0,7,17,0,756.0,0.2589587867259979,0.24526889622211456
11468747,6563816,6592961,17085,9994,2003,10057,2003,7091,7028,0.0,0.0,198,3.0,24,5,392,1155.0,0.3146933615207672,-0.06119038164615631
11470572,7725110,5716744,17085,12563,2010,8076,1998,4522,9009,1.0,0.0,77,7.0,25,3,7,3787.0,0.33980026841163635,0.3090793192386627
11464514,8066168,7362312,17085,13116,2011,11800,2008,3969,5285,1.0,0.0,1008,7.0,129,4,0,7.0,0.5018602609634399,0.29952138662338257
11464601,8806973,6624543,17085,14110,2014,10127,2003,2975,6958,0.3333333333333333,0.0,1037,8.0,7,7,0,588.0,0.39899367094039917,0.19343572854995728
11464514,9574644,8004159,17085,15027,2017,13018,2011,2058,4067,0.5,0.0,757,4.0,2530,12,0,210.0,0.5547657012939453,0.14747774600982666
11469226,9922979,4477507,17085,15419,2018,3211,1984,1666,13874,0.5,0.0,5,30.0,3,2,161,756.0,0.6207042932510376,0.12618504464626312
11464601,10959722,6260976,17085,16525,2021,9329,2001,560,7756,0.5,0.0,84,11.0,4483,3,0,154.0,0.6130532026290894,0.23191413283348083
11472100,7220112,5215570,17092,11464,2007,6361,1993,5628,10731,0.3333333333333333,0.0,16,36.0,12,3,175,1806.0,0.3904748260974884,0.04345162585377693
11474360,9105261,5068138,17092,14467,2015,5808,1991,2625,11284,0.5,0.0,30,9.0,10,8,14,4648.0,0.3789803385734558,0.2287561446428299
11474649,10697919,8116817,17092,16252,2020,13193,2012,840,3899,0.0,0.0,2,4.0,1,8,567,301.0,0.600846529006958,0.17648884654045105
11471155,5816471,3995255,17092,8314,1998,334,1976,8778,16758,1.0,0.0,1533,4.0,50,1,7,5957.0,0.41706758737564087,0.036112669855356216
11471610,8616413,9497156,17092,13879,2013,14929,2016,3213,2163,0.3333333333333333,0.0,30,2.0,8,3,49,1183.0,0.41333991289138794,0.2504577338695526
11471147,5480403,6079633,17092,7306,1996,8944,2000,9786,8148,1.0,0.0,634,8.0,46,7,7,1204.0,0.4862789809703827,0.14751605689525604
11476109,4455193,4261727,17092,3092,1984,1930,1981,14000,15162,0.3333333333333333,0.0,210,5.0,3,5,0,3402.0,0.422722190618515,0.07974914461374283
11473138,7608451,9610901,17092,12353,2009,15069,2017,4739,2023,0.3333333333333333,0.0,77,3.0,69,20,0,476.0,0.35464635491371155,0.056028395891189575
11476145,10217933,8047983,17092,15762,2019,13088,2011,1330,4004,1.0,0.0,5,2.0,1,189,0,854.0,0.48778682947158813,0.14678265154361725
11473919,10255639,4174080,17092,15804,2019,1412,1979,1288,15680,0.25,0.0,11,7.0,99,2,84,9296.0,0.6556307673454285,0.2076064497232437
11473970,9435891,9389641,17092,14859,2016,14803,2016,2233,2289,0.5,0.0,55,5.0,6,37,0,147.0,0.4617464542388916,0.12904757261276245
11473887,11105597,10359501,17092,16679,2021,15909,2019,413,1183,1.0,0.0,2,3.0,14,2,56,413.0,1.0000001192092896,0.16077743470668793
11478242,10932806,5649605,17099,16497,2021,7873,1997,602,9226,0.2,0.0,148,8.0,1004,4,0,84.0,0.4608043432235718,0.3867865204811096
11478242,9693774,9436199,17099,15160,2017,14859,2016,1939,2240,1.0,0.0,590,2.0,44,7,0,385.0,0.48537343740463257,0.06023513898253441
11482412,6503365,5562892,17099,9868,2003,7586,1996,7231,9513,0.3333333333333333,0.0,226,15.0,18,7,7,2821.0,0.3668542206287384,0.10519098490476608
11478247,6485667,5108078,17099,9826,2002,5962,1992,7273,11137,0.3333333333333333,0.0,950,13.0,93,9,0,140.0,0.19888439774513245,0.359853059053421
11478603,8475506,7477426,17099,13697,2013,12066,2009,3402,5033,0.3333333333333333,0.0,18,20.0,168,7,28,2191.0,0.3624538779258728,0.13536375761032104
11483252,8155587,6997164,17099,13249,2012,11002,2006,3850,6097,0.5,0.0,8,2.0,12,5,448,4466.0,0.44068795442581177,0.17474058270454407
11478594,8261742,11142528,17099,13403,2012,16721,2021,3696,378,0.25,0.3333333333333333,10,1.0,163,8,63,378.0,0.6683683395385742,0.12496379762887955
11483056,5729825,8904675,17099,8111,1998,14222,2014,8988,2877,0.5,0.0,104,3.0,29,17,154,840.0,0.5327800512313843,0.16780252754688263
11483301,7929486,4742103,17099,12892,2011,4506,1988,4207,12593,1.0,0.0,6,12.0,2,3,490,1057.0,0.6831263303756714,0.12679913640022278
11478079,6042321,8646963,17099,8853,2000,13921,2014,8246,3178,0.3333333333333333,0.0,31,2.0,14,2,126,2919.0,0.3312745988368988,0.13423608243465424
11480038,9605937,6408819,17099,15062,2017,9672,2002,2037,7427,1.0,0.0,42,11.0,23,8,63,1295.0,0.5220293998718262,0.21765628457069397
11480889,8494419,5169420,17099,13718,2013,6186,1992,3381,10913,1.0,0.0,30,4.0,2,3,189,1288.0,0.5376297831535339,0.2492174506187439
11478662,6405072,9842949,17099,9658,2002,15321,2017,7441,1778,0.3333333333333333,0.0,509,2.0,102,1,7,952.0,0.5345730185508728,0.0037753209471702576
11482531,8349681,10052386,17099,13522,2013,15573,2018,3577,1526,1.0,0.0,214,8.0,15,540,7,140.0,0.5964845418930054,0.2044886350631714
11482058,4398515,4648388,17099,2784,1983,4086,1987,14315,13013,0.0,0.0,29,8.0,9,2,364,224.0,0.35384681820869446,0.24789321422576904
11478706,6009190,4965431,17099,8762,1999,5409,1990,8337,11690,0.0,0.0,121,10.0,3,10,35,917.0,0.13629651069641113,0.13199853897094727
11480392,10145581,4370322,17099,15678,2018,2581,1983,1421,14518,0.25,0.0,1,10.0,33,1,1421,294.0,0.21292531490325928,0.04092808812856674
11480509,4735504,4328943,17099,4478,1988,2322,1982,12621,14777,1.0,0.0,79,9.0,4,2,322,350.0,0.5105237364768982,0.19364801049232483
11478238,9332974,4678981,17099,14740,2016,4205,1987,2359,12894,1.0,0.0,838,8.0,2260,1,7,4522.0,0.3047146797180176,0.16514883935451508
11481435,7313384,4309809,17099,11681,2007,2203,1982,5418,14896,0.3333333333333333,0.0,101,17.0,19,1,0,483.0,0.32529962062835693,0.21792501211166382
11484310,10172619,9115781,17106,15713,2019,14481,2015,1393,2625,1.0,0.0,454,3.0,2794,61,0,1288.0,0.4169035851955414,0.251604825258255
11484358,9295514,10478925,17106,14698,2016,16028,2019,2408,1078,1.0,0.0,889,3.0,393,6,0,812.0,0.4644371271133423,0.07716138660907745
11484312,9119898,5494229,17106,14488,2015,7362,1996,2618,9744,1.0,0.0,626,7.0,2,4,0,973.0,0.2693757712841034,0.33311834931373596
11484310,8220468,7054704,17106,13347,2012,11107,2006,3759,5999,1.0,0.0,1100,12.0,5,147,0,448.0,0.6158660054206848,0.24780480563640594
11484312,6171316,7814076,17106,9140,2001,12703,2010,7966,4403,1.0,0.0,1280,6.0,97,12,0,147.0,0.48626238107681274,0.22549223899841309
11493621,10952254,6907462,17113,16511,2021,10757,2005,602,6356,0.5,0.0,2,12.0,36,14,280,3094.0,0.3205300569534302,0.2313327193260193
11494118,5916309,6740447,17113,8580,1999,10372,2004,8533,6741,1.0,0.0,97,8.0,34,7,84,1120.0,0.45811209082603455,0.34085506200790405
11496415,6965930,10728615,17113,10911,2005,16280,2020,6202,833,0.5,0.5,130,2.0,55,3,0,280.0,0.4796886146068573,0.37325358390808105
11495470,9960763,4072198,17113,15461,2018,768,1978,1652,16345,0.0,0.0,38,5.0,7,1,21,1197.0,0.3528032600879669,0.15016524493694305
11493299,9733036,5536942,17113,15202,2017,7502,1996,1911,9611,0.5,0.0,4,10.0,25,3,497,4767.0,0.4083517789840698,0.17882558703422546
11494515,8571909,4350485,17113,13816,2013,2455,1982,3297,14658,1.0,0.0,186,10.0,16,2,0,1414.0,0.48455166816711426,0.15569527447223663
11496415,7778234,7818336,17113,12647,2010,12710,2010,4466,4403,0.5,0.5,18,32.0,5,1,0,21.0,0.5584163069725037,0.30170440673828125
11497576,9498575,6789078,17120,14936,2016,10477,2004,2184,6643,0.5,0.0,5,26.0,11,4,217,56.0,0.24697856605052948,0.04826504737138748
11501773,9632748,8387266,17120,15090,2017,13578,2013,2030,3542,1.0,0.0,118,9.0,4,6,0,238.0,0.4595887064933777,0.1449015885591507
11500483,6369795,7116015,17120,9595,2002,11233,2006,7525,5887,0.0,0.0,8,2.0,12,10,1190,3213.0,0.6630100011825562,0.28977006673812866
11497657,8343123,9761231,17120,13515,2013,15230,2017,3605,1890,1.0,0.0,72,2.0,3,5,21,371.0,0.7420091032981873,0.19853559136390686
11500526,7680770,4673798,17120,12493,2010,4184,1987,4627,12936,0.25,0.0,118,20.0,14,5,91,3304.0,0.10864903032779694,0.2032756507396698
11498180,9737969,5964688,17120,15209,2017,8685,1999,1911,8435,0.4,0.0,13,8.0,5,9,147,637.0,0.5233526825904846,0.42710617184638977
11500672,9578173,4023570,17120,15027,2017,502,1977,2093,16618,0.3333333333333333,0.0,244,33.0,2,1,7,2674.0,0.6808142066001892,0.2397964745759964
11497651,8075552,4170039,17120,13130,2011,1370,1979,3990,15750,1.0,0.0,2,23.0,2,5,812,3262.0,0.4875299036502838,0.2168198525905609
11497886,4026296,5695770,17120,516,1977,8013,1997,16604,9107,0.5,0.5,117,23.0,1,1,119,399.0,0.4336980879306793,0.1760755330324173
11500672,7212827,7468698,17120,11443,2007,12045,2008,5677,5075,0.3333333333333333,0.0,129,10.0,12,3,7,245.0,0.33977505564689636,0.07630030065774918
11497492,5222976,9864430,17120,6389,1993,15349,2018,10731,1771,1.0,0.0,1417,3.0,20,9,0,623.0,0.44424328207969666,0.2384692281484604
11504116,4788485,4553374,17127,4716,1988,3610,1985,12411,13517,0.0,0.0,444,19.0,9,2,7,175.0,0.11206333339214325,0.2934039235115051
11504119,6187003,6991544,17127,9175,2001,10988,2006,7952,6139,0.16666666666666666,0.0,1458,9.0,51,308,0,7.0,0.5178452730178833,0.21166671812534332
11507771,10816637,4131886,17127,16371,2020,1090,1978,756,16037,0.0,0.0,4,3.0,30,3,280,7224.0,0.22855918109416962,0.244492307305336
11504521,8388561,4394623,17127,13578,2013,2756,1983,3549,14371,1.0,0.0,13,27.0,25,4,91,133.0,0.45210516452789307,0.2410496026277542
11504568,7850583,6024871,17127,12766,2010,8811,2000,4361,8316,0.5,0.0,10,27.0,26,12,714,392.0,0.6435397267341614,0.14856965839862823
11506795,7630737,11198697,17127,12395,2009,16784,2021,4732,343,0.0,0.0,23,1.0,14,47,721,343.0,0.4125995635986328,-0.022162972018122673
11504116,9463260,6769580,17127,14894,2016,10442,2004,2233,6685,1.0,0.0,688,17.0,9,7,7,105.0,0.5444583296775818,0.14437149465084076
11507248,8194938,7147899,17127,13305,2012,11303,2006,3822,5824,1.0,0.0,68,10.0,4,11,7,336.0,0.3731313943862915,0.14825329184532166
11504121,6063097,4101470,17127,8902,2000,929,1978,8225,16198,1.0,0.0,1620,30.0,13,1,0,329.0,0.5577035546302795,0.19680839776992798
11505062,10267390,8131522,17127,15818,2019,13214,2012,1309,3913,0.25,0.0,20,9.0,112,2,7,1211.0,0.524846076965332,0.12345053255558014
11515047,6216134,5779576,17134,9231,2001,8230,1998,7903,8904,0.5,0.0,162,34.0,22,5,0,224.0,0.275178462266922,0.020001119002699852
11512423,9169595,10889279,17134,14544,2015,16448,2021,2590,686,0.5,0.0,1,2.0,2,6,2590,56.0,0.5190116167068481,0.18936598300933838
11510691,6126635,8655858,17134,9042,2000,13928,2014,8092,3206,1.0,0.0,138,3.0,34,22,0,1337.0,0.4098435640335083,0.3191555142402649
11511047,6246322,7240384,17134,9294,2001,11513,2007,7840,5621,0.0,0.5,16,23.0,9,39,77,217.0,0.18700164556503296,0.19216151535511017
11512619,5865864,6299387,17134,8433,1999,9413,2001,8701,7721,0.5,0.0,21,3.0,14,6,483,2751.0,0.3399803936481476,0.18226462602615356
11514519,7965275,4164547,17134,12955,2011,1321,1979,4179,15813,0.5,0.0,27,13.0,11,1,56,28.0,0.19703415036201477,0.0421171635389328
11514943,6994925,4797828,17134,10995,2006,4758,1989,6139,12376,1.0,0.0,93,22.0,5,4,14,2051.0,0.6010088920593262,0.10159812867641449
11511035,5522807,5902437,17134,7460,1996,8531,1999,9674,8603,1.0,0.0,89,3.0,58,79,56,1379.0,0.5271064639091492,0.225880965590477
11512449,7726125,4475961,17134,12570,2010,3204,1984,4564,13930,0.0,0.0,8,9.0,10,1,777,7091.0,0.4341827630996704,0.1279490441083908
11510671,5997528,5511483,17134,8741,1999,7425,1996,8393,9709,1.0,0.0,1186,14.0,81,2,7,1260.0,0.4759165346622467,0.25516220927238464
11510806,6048073,8912822,17134,8867,2000,14229,2014,8267,2905,0.0,0.0,15,7.0,3,10,455,133.0,0.1688307523727417,0.12423458695411682
11516603,6837857,8090179,17134,10596,2005,13151,2012,6538,3983,0.0,0.0,44,4.0,5,7,0,1547.0,0.46023494005203247,0.16510067880153656
11510690,7297131,4999443,17134,11646,2007,5549,1991,5488,11585,1.0,0.0,185,10.0,13,6,91,1316.0,0.6320882439613342,0.0659368634223938
11513160,6534992,9374060,17134,9938,2003,14782,2016,7196,2352,0.0,0.0,77,3.0,2,1,28,1064.0,0.4322701692581177,0.2659575641155243
11518480,8006345,4162449,17141,13025,2011,1300,1979,4116,15841,0.0,0.0,9,27.0,8,1,49,2702.0,0.17542487382888794,0.16492724418640137
11519327,6302046,4613757,17141,9420,2001,3918,1986,7721,13223,0.5,0.0,1,3.0,6,3,7721,7833.0,0.5112746953964233,0.14298173785209656
11517304,6994708,7509544,17141,10995,2006,12136,2009,6146,5005,0.5,0.0,1517,3.0,16,7,0,1869.0,0.6420257687568665,0.15180864930152893
11517304,6450391,10541644,17141,9756,2002,16091,2020,7385,1050,0.5,0.0,1308,4.0,22,1,7,238.0,0.372673362493515,0.18396659195423126
11517304,10433844,5133162,17141,15986,2019,6053,1992,1155,11088,0.5,0.0,458,5.0,4166,2,7,2597.0,0.5744850039482117,0.06785690784454346
11518245,6416209,4571935,17141,9686,2002,3708,1986,7455,13433,0.14285714285714285,0.0,127,52.0,11,4,49,140.0,0.35079705715179443,0.24040989577770233
11517222,6749792,5597213,17141,10393,2004,7698,1997,6748,9443,0.0,0.0,174,24.0,14,6,175,105.0,0.43229901790618896,0.18522468209266663
11517443,11179234,4158660,17141,16763,2021,1265,1979,378,15876,1.0,0.0,5,6.0,26,1,0,2184.0,0.5426563024520874,0.1768033802509308
11520468,6324693,6351032,17141,9462,2001,9553,2002,7679,7588,0.5,0.0,1952,9.0,16,9,7,1414.0,0.4055247902870178,0.1143055334687233
11517309,10716489,5156319,17141,16273,2020,6137,1992,868,11004,1.0,0.0,78,16.0,2,2,7,5509.0,0.06822434812784195,0.23469291627407074
11517311,6049145,6127024,17141,8867,2000,9042,2000,8274,8099,0.0,0.0,766,12.0,3,19,0,2044.0,0.2157590538263321,0.14862412214279175
11520210,7561324,10152325,17141,12248,2009,15685,2018,4893,1456,0.5,0.0,166,2.0,122,9,0,105.0,0.26496490836143494,0.14740614593029022
11517325,4651734,5404603,17141,4100,1987,7040,1995,13041,10101,1.0,1.0,381,10.0,6,3,0,49.0,0.2897776663303375,0.3053305447101593
11523212,7013267,6681975,17141,11030,2006,10253,2004,6111,6888,0.5,0.0,45,4.0,13,7,49,3395.0,0.4438459277153015,0.1896297037601471
11517390,11224428,6293801,17141,16819,2022,9399,2001,322,7742,1.0,0.0,29,20.0,5446,52,0,1246.0,0.4001120924949646,0.17251214385032654
11517315,9289212,4123908,17141,14691,2016,1041,1978,2450,16100,0.25,0.0,1013,10.0,703,2,0,6916.0,0.26975589990615845,0.1628538966178894
11517412,6996870,9080595,17141,11002,2006,14439,2015,6139,2702,0.5,0.0,53,3.0,56,12,245,1001.0,0.5799268484115601,0.36563363671302795
11521851,8569184,4158133,17141,13816,2013,1258,1979,3325,15883,1.0,1.0,271,36.0,1,2,7,931.0,0.5013133883476257,0.17414258420467377
11520269,7860412,4323290,17141,12780,2010,2287,1982,4361,14854,1.0,0.0,3,8.0,16,1,259,966.0,0.7407696843147278,0.24325045943260193
11525138,10557139,8980344,17148,16112,2020,14320,2015,1036,2828,1.0,0.5,8,5.0,5,2,210,259.0,0.9999998807907104,0.20889897644519806
11528244,9231899,8883250,17148,14614,2016,14194,2014,2534,2954,1.0,0.0,2,7.0,4,151,1001,1890.0,0.9999999403953552,0.28709787130355835
11525274,10683675,7076283,17148,16238,2020,11149,2006,910,5999,1.0,0.0,2,4.0,2,26,455,21.0,1.0,0.11988488584756851
11525694,8558758,6814097,17148,13802,2013,10540,2004,3346,6608,0.0,0.0,5,20.0,1,44,672,28.0,0.5805832743644714,0.22999009490013123
11523823,10743873,5037715,17148,16301,2020,5696,1991,847,11452,1.0,0.0,169,17.0,4871,1,0,2352.0,0.7725376486778259,0.20554769039154053
11527774,5202201,4556853,17148,6312,1993,3624,1985,10836,13524,0.5,1.0,57,7.0,7,1,917,2254.0,0.3536691963672638,0.060402046889066696
11527519,5707745,5272099,17148,8048,1998,6564,1993,9100,10584,0.5,1.0,1484,30.0,20,7,0,4837.0,0.5661684274673462,0.283436119556427
11523823,10806450,5097974,17148,16364,2020,5927,1992,784,11221,1.0,0.0,151,19.0,4927,22,0,343.0,0.5633313059806824,0.35280677676200867
11523983,6419901,4149025,17148,9693,2002,1195,1979,7455,15953,1.0,0.0,60,38.0,48,1,35,525.0,0.5086728930473328,0.1261376291513443
re49334,5544220,10070853,17148,7523,1996,15594,2018,9625,1554,0.5,0.0,54,3.0,9,153,644,168.0,0.24122212827205658,0.10917605459690094
11529138,9861446,6426826,17155,15349,2018,9707,2002,1806,7448,1.0,0.0,418,5.0,18,7,0,3262.0,0.3643048107624054,0.3086666166782379
11533315,8069471,8000004,17155,13116,2011,13011,2011,4039,4144,0.3333333333333333,0.0,197,4.0,7,4,7,1008.0,0.3675934374332428,0.0755908340215683
11532627,9887267,10043685,17155,15377,2018,15559,2018,1778,1596,1.0,0.3333333333333333,1,3.0,4,8,1778,868.0,0.5802960395812988,0.4625878930091858
11531554,5918159,7788839,17155,8580,1999,12668,2010,8575,4487,0.0,0.0,1879,8.0,5,25,7,336.0,0.16266465187072754,0.07083705812692642
11532085,8280549,4464668,17155,13424,2012,3141,1984,3731,14014,0.25,0.25,35,9.0,105,2,21,4004.0,0.48056453466415405,0.2847951054573059
11529137,7806871,7658190,17155,12696,2010,12458,2010,4459,4697,1.0,0.0,776,10.0,8,23,7,175.0,0.4003804922103882,0.30014097690582275
11529360,5211952,4033473,17155,6347,1993,551,1977,10808,16604,0.5,0.0,215,16.0,2,2,21,2058.0,0.4966842532157898,0.08907903730869293
11532597,6084284,7391068,17155,8951,2000,11863,2008,8204,5292,1.0,1.0,271,22.0,8,1,14,14.0,0.34528371691703796,0.2809463143348694
11532228,7320289,8044274,17155,11709,2008,13081,2011,5446,4074,0.0,0.0,29,2.0,18,4,98,1288.0,0.12153808027505875,0.14102570712566376
11529461,4199307,7060414,17155,1573,1980,11121,2006,15582,6034,0.0,0.0,179,3.0,1,15,0,5495.0,0.5065780282020569,0.12571677565574646
11534646,9526635,10521411,17162,14971,2016,16070,2019,2191,1092,0.0,0.0,23,3.0,184,29,98,483.0,0.36526307463645935,0.16814567148685455
11538454,8522310,4617771,17162,13753,2013,3946,1986,3409,13216,0.0,0.0,5,16.0,2,1,903,826.0,0.29526272416114807,0.08262144774198532
11536373,4804290,8216162,17162,4793,1989,13340,2012,12369,3822,1.0,0.0,89,3.0,6,6,21,364.0,0.4699186682701111,0.24222183227539062
11534157,6540770,4199142,17162,9952,2003,1573,1980,7210,15589,1.0,0.0,292,34.0,16,1,14,385.0,0.46135571599006653,0.20292750000953674
11536632,5658531,5895140,17162,7901,1997,8510,1999,9261,8652,0.3333333333333333,0.0,43,9.0,4,3,140,336.0,0.6355269551277161,0.24207817018032074
11535591,9533933,5711899,17162,14978,2017,8062,1998,2184,9100,0.3333333333333333,0.0,4,30.0,4,7,182,119.0,0.47936078906059265,0.30290013551712036
11534008,5119942,4346618,17162,6004,1992,2434,1982,11158,14728,0.5,0.0,10,8.0,6,3,791,8344.0,0.5693409442901611,0.2522282302379608
11534329,5928249,10905415,17162,8608,1999,16469,2021,8554,693,1.0,1.0,21,5.0,9,21,231,7.0,0.46826380491256714,0.284689337015152
11536479,9285802,6787790,17162,14684,2016,10477,2004,2478,6685,0.3333333333333333,0.0,45,5.0,1147,1,287,4165.0,0.6417633295059204,0.25701725482940674
11538706,9463543,6921933,17162,14894,2016,10799,2005,2268,6363,0.6666666666666666,0.5,4,5.0,1,15,385,2982.0,0.39506661891937256,0.3125743865966797
11534313,5452407,4732818,17162,7201,1995,4464,1988,9961,12698,0.5,0.0,366,2.0,20,17,91,602.0,0.42418479919433594,0.011320240795612335
11534654,6422980,4308422,17162,9700,2002,2189,1981,7462,14973,0.0,0.0,49,7.0,3,1,0,1365.0,0.5827804207801819,0.27835196256637573
